"Year","Team","Win","Loss","Tie","Pct","PF","PA","Delta"
"1924","North Carolina St.","2","6","2","0.30000","43","147","-104"
"1925","Nevada","4","3","1","0.56250","107","115","-8"
"1926","Nevada","4","4","0","0.50000","116","119","-3"
"1927","Nevada","2","6","1","0.27778","54","209","-155"
"1928","Nevada","0","7","1","0.06250","31","170","-139"
"1936","Santa Clara (CA)","8","1","0","0.88889","139","36","103"
"1937","Santa Clara (CA)","9","0","0","1.00000","163","9","154"
"1938","Santa Clara (CA)","6","2","0","0.75000","97","26","71"
"1939","Santa Clara (CA)","5","1","3","0.72222","117","40","77"
"1940","Santa Clara (CA)","6","1","1","0.81250","154","46","108"
"1941","Santa Clara (CA)","6","3","0","0.66667","170","103","67"
"1942","Santa Clara (CA)","7","2","0","0.77778","101","52","49"
"1945","California","4","5","1","0.45000","93","107","-14"
"1956","Air Force (CO)","6","2","1","0.72222","293","101","192"
"1957","Air Force (CO)","3","6","1","0.35000","125","184","-59"
"1956","Virginia","4","6","0","0.40000","92","167","-75"
"1957","Virginia","3","6","1","0.35000","117","171","-54"
"1958","Air Force (CO)","9","0","2","0.90909","247","102","145"
"1959","Air Force (CO)","5","4","1","0.55000","160","124","36"
"1960","Air Force (CO)","4","6","0","0.40000","147","178","-31"
"1961","Air Force (CO)","3","7","0","0.30000","87","173","-86"
"1962","Air Force (CO)","5","5","0","0.50000","173","171","2"
"1963","Air Force (CO)","7","4","0","0.63636","249","150","99"
"1964","Air Force (CO)","4","5","1","0.45000","106","146","-40"
"1965","Air Force (CO)","3","6","1","0.35000","166","156","10"
"1966","Air Force (CO)","4","6","0","0.40000","154","161","-7"
"1967","Air Force (CO)","2","6","2","0.30000","86","173","-87"
"1968","Air Force (CO)","7","3","0","0.70000","251","156","95"
"1969","Air Force (CO)","6","4","0","0.60000","267","177","90"
"1970","Air Force (CO)","9","3","0","0.75000","356","239","117"
"1971","Air Force (CO)","6","4","0","0.60000","187","187","0"
"1972","Air Force (CO)","6","4","0","0.60000","303","183","120"
"1973","Air Force (CO)","6","4","0","0.60000","223","239","-16"
"1974","Air Force (CO)","2","9","0","0.18182","178","215","-37"
"1975","Air Force (CO)","2","8","1","0.22727","156","265","-109"
"1976","Air Force (CO)","4","7","0","0.36364","180","273","-93"
"1977","Air Force (CO)","2","8","1","0.22727","114","296","-182"
"1978","Air Force (CO)","3","8","0","0.27273","215","328","-113"
"1979","Air Force (CO)","2","9","0","0.18182","127","253","-126"
"1980","Air Force (CO)","2","9","1","0.20833","161","290","-129"
"1981","Air Force (CO)","4","7","0","0.36364","171","252","-81"
"1982","Air Force (CO)","8","5","0","0.61538","395","367","28"
"1983","Air Force (CO)","10","2","0","0.83333","367","221","146"
"1984","Arkansas","7","4","1","0.62500","268","159","109"
"1985","Arkansas","10","2","0","0.83333","323","146","177"
"1986","Arkansas","9","3","0","0.75000","311","184","127"
"1987","Arkansas","9","4","0","0.69231","300","219","81"
"1988","Arkansas","10","2","0","0.83333","349","190","159"
"1989","Arkansas","10","2","0","0.83333","385","230","155"
"1990","Clemson (SC)","10","2","0","0.83333","333","109","224"
"1991","Clemson (SC)","9","2","1","0.79167","317","185","132"
"1992","Clemson (SC)","5","6","0","0.45455","261","213","48"
"1993","Clemson (SC)","8","3","0","0.72727","184","179","5"
"1994","Rice (TX)","5","6","0","0.45455","206","203","3"
"1995","Rice (TX)","2","8","1","0.22727","215","284","-69"
"1996","Rice (TX)","7","4","0","0.63636","296","312","-16"
"1997","Rice (TX)","7","4","0","0.63636","306","285","21"
"1998","Rice (TX)","5","6","0","0.45455","235","257","-22"
"1999","Rice (TX)","5","6","0","0.45455","237","261","-24"
"2000","Rice (TX)","3","8","0","0.27273","237","322","-85"
"2001","Rice (TX)","8","4","0","0.66667","333","335","-2"
"2002","Rice (TX)","4","7","0","0.36364","253","296","-43"
"2003","Rice (TX)","5","7","0","0.41667","343","378","-35"
"2004","Rice (TX)","3","8","0","0.27273","279","377","-98"
"2005","Rice (TX)","1","10","0","0.09091","241","447","-206"
"1984","Air Force (CO)","8","4","0","0.66667","369","198","171"
"1985","Air Force (CO)","12","1","0","0.92308","470","179","291"
"1986","Air Force (CO)","6","5","0","0.54545","229","215","14"
"1987","Air Force (CO)","9","4","0","0.69231","405","269","136"
"1988","Air Force (CO)","5","7","0","0.41667","422","392","30"
"1989","Air Force (CO)","8","4","1","0.65385","474","358","116"
"1990","Air Force (CO)","7","5","0","0.58333","262","283","-21"
"1991","Air Force (CO)","10","3","0","0.76923","382","263","119"
"1992","Air Force (CO)","7","5","0","0.58333","229","238","-9"
"1993","Air Force (CO)","4","8","0","0.33333","296","291","5"
"1994","Air Force (CO)","8","4","0","0.66667","371","285","86"
"1995","Air Force (CO)","8","5","0","0.61538","401","358","43"
"1996","Air Force (CO)","6","5","0","0.54545","360","231","129"
"1997","Air Force (CO)","10","3","0","0.76923","279","190","89"
"1998","Air Force (CO)","12","1","0","0.92308","468","185","283"
"1999","Air Force (CO)","6","5","0","0.54545","264","218","46"
"2000","Air Force (CO)","9","3","0","0.75000","421","312","109"
"2001","Air Force (CO)","6","6","0","0.50000","337","386","-49"
"2002","Air Force (CO)","8","5","0","0.61538","440","303","137"
"2003","Air Force (CO)","7","5","0","0.58333","322","242","80"
"2004","Air Force (CO)","5","6","0","0.45455","326","342","-16"
"2005","Air Force (CO)","4","7","0","0.36364","330","349","-19"
"2006","Air Force (CO)","4","8","0","0.33333","279","302","-23"
"2007","Air Force (CO)","9","4","0","0.69231","389","274","115"
"2008","Air Force (CO)","8","5","0","0.61538","348","289","59"
"2009","Air Force (CO)","8","5","0","0.61538","386","204","182"
"2010","Air Force (CO)","9","4","0","0.69231","401","274","127"
"2011","Air Force (CO)","7","6","0","0.53846","454","369","85"
"2012","Air Force (CO)","6","7","0","0.46154","356","377","-21"
"2013","Air Force (CO)","2","10","0","0.16667","296","480","-184"
"1869","Rutgers (NJ)","2","2","0","0.50000","18","18","0"
"1870","Rutgers (NJ)","2","2","0","0.50000","17","17","0"
"1872","Columbia (NY)","5","4","0","0.55556","22","16","6"
"1873","Rutgers (NJ)","7","4","1","0.62500","31","26","5"
"1874","Harvard (MA)","9","7","0","0.56250","54","41","13"
"1875","Harvard (MA)","12","6","2","0.65000","52","29","23"
"1876","Harvard (MA)","13","8","1","0.61364","45","29","16"
"1877","Harvard (MA)","9","7","3","0.55263","31","21","10"
"1878","Pennsylvania","14","9","5","0.58929","42","24","18"
"1879","Harvard (MA)","13","9","12","0.55882","46","27","19"
"1880","Harvard (MA)","18","11","4","0.60606","75","53","22"
"1881","Rutgers (NJ)","22","18","8","0.54167","70","47","23"
"1882","Rutgers (NJ)","41","28","2","0.59155","176","111","65"
"1883","Rutgers (NJ)","38","32","1","0.54225","1288","965","323"
"1884","Pennsylvania","47","29","5","0.61111","1728","1184","544"
"1885","Michigan","34","17","4","0.65455","1437","612","825"
"1886","Lehigh (PA)","48","21","4","0.68493","1850","637","1213"
"1887","California","67","35","3","0.65238","2660","935","1725"
"1888","Princeton (NJ)","70","56","6","0.55303","2468","1899","569"
"1889","Brown (RI)","82","51","11","0.60764","2879","1796","1083"
"1890","Brown (RI)","77","76","9","0.50309","3002","2455","547"
"1891","Southern California","94","76","13","0.54918","2813","2189","624"
"1892","Minnesota","93","80","9","0.53571","2972","2394","578"
"1893","Duke (NC)","79","94","9","0.45879","2176","2912","-736"
"1894","Colorado St.","50","62","4","0.44828","1161","1518","-357"
"1895","Boston (MA)","31","44","11","0.42442","692","1031","-339"
"1896","Rhode Island","54","62","12","0.46875","1126","1201","-75"
"1897","Boston (MA)","32","40","6","0.44872","792","785","7"
"1898","Miami (OH)","47","23","4","0.66216","921","644","277"
"1899","New Hampshire","33","32","6","0.50704","571","522","49"
"1900","New Hampshire","22","35","11","0.40441","442","686","-244"
"1901","Marshall (WV)","18","34","3","0.35455","302","917","-615"
"1902","Saint John's (MN)","9","22","4","0.31429","148","460","-312"
"1903","Wichita St. (KS)","14","25","2","0.36585","376","546","-170"
"1904","Oklahoma St.","11","14","1","0.44231","194","394","-200"
"1905","Miami (OH)","7","25","5","0.25676","245","494","-249"
"1906","Rensselaer Tech (NY)","3","7","4","0.35714","92","107","-15"
"1907","Marshall (WV)","5","10","2","0.35294","71","238","-167"
"1908","Fort Hays St. (KS)","5","6","1","0.45833","56","91","-35"
"1909","Fort Hays St. (KS)","1","3","1","0.30000","12","68","-56"
"1910","Texas St.","0","1","0","0.00000","0","19","-19"
"1912","Fort Hays St. (KS)","1","2","0","0.33333","20","132","-112"
"1913","Eureka (IL)","1","6","0","0.14286","39","203","-164"
"1914","Eureka (IL)","3","4","0","0.42857","57","201","-144"
"1915","Texas St.","1","1","1","0.50000","13","20","-7"
"1916","Texas St.","0","2","1","0.16667","0","106","-106"
"1917","Boston (MA)","4","4","0","0.50000","73","136","-63"
"1918","Monmouth (IL)","1","7","0","0.12500","26","137","-111"
"1930","Troy (AL)","1","2","0","0.33333","7","73","-66"
"2013","Grambling St. (LA)","0","1","0","0.00000","0","0","0"
"1892","Akron (OH)","3","4","0","0.42857","69","180","-111"
"1893","Akron (OH)","5","2","0","0.71429","276","82","194"
"1894","Akron (OH)","1","0","0","1.00000","12","6","6"
"1895","Auburn (AL)","2","1","0","0.66667","70","15","55"
"1896","Auburn (AL)","3","1","0","0.75000","135","18","117"
"1897","Auburn (AL)","2","0","1","0.83333","40","4","36"
"1898","Auburn (AL)","2","1","0","0.66667","47","47","0"
"1899","Auburn (AL)","3","1","1","0.70000","148","11","137"
"1900","Clemson (SC)","6","0","0","1.00000","222","10","212"
"1901","Clemson (SC)","3","1","1","0.70000","190","38","152"
"1902","Clemson (SC)","6","1","0","0.85714","152","22","130"
"1903","Clemson (SC)","4","1","1","0.75000","167","22","145"
"1904","Georgia Tech","8","1","1","0.85000","287","34","253"
"1905","Georgia Tech","7","0","1","0.93750","233","33","200"
"1906","Georgia Tech","6","3","1","0.65000","140","69","71"
"1907","Georgia Tech","4","4","0","0.50000","148","100","48"
"1908","Georgia Tech","6","3","0","0.66667","147","74","73"
"1909","Georgia Tech","7","2","0","0.77778","217","44","173"
"1910","Georgia Tech","5","3","0","0.62500","197","50","147"
"1911","Georgia Tech","6","2","1","0.72222","150","21","129"
"1912","Georgia Tech","5","3","1","0.61111","100","86","14"
"1913","Georgia Tech","7","2","0","0.77778","250","43","207"
"1914","Georgia Tech","6","2","0","0.75000","206","40","166"
"1915","Georgia Tech","7","0","1","0.93750","233","24","209"
"1916","Georgia Tech","8","0","1","0.94444","421","20","401"
"1917","Georgia Tech","9","0","0","1.00000","491","17","474"
"1918","Georgia Tech","6","1","0","0.85714","466","32","434"
"1919","Georgia Tech","7","3","0","0.70000","256","33","223"
"1920","Pennsylvania","6","4","0","0.60000","167","133","34"
"1921","Pennsylvania","4","3","2","0.55556","164","135","29"
"1922","Pennsylvania","6","3","0","0.66667","100","44","56"
"1924","Rice (TX)","4","4","0","0.50000","85","70","15"
"1925","Rice (TX)","4","4","1","0.50000","85","79","6"
"1926","Rice (TX)","4","4","1","0.50000","84","81","3"
"1927","Rice (TX)","2","6","1","0.27778","64","160","-96"
"1896","Akron (OH)","0","1","0","0.00000","0","36","-36"
"1899","Akron (OH)","2","1","0","0.66667","26","11","15"
"1902","Akron (OH)","2","5","0","0.28571","34","163","-129"
"1903","Akron (OH)","1","2","0","0.33333","11","43","-32"
"1908","Akron (OH)","3","4","0","0.42857","32","80","-48"
"1909","Akron (OH)","3","4","1","0.43750","54","74","-20"
"1910","Akron (OH)","7","2","0","0.77778","136","83","53"
"1911","Akron (OH)","3","4","1","0.43750","80","24","56"
"1912","Akron (OH)","5","2","1","0.68750","105","36","69"
"1913","Akron (OH)","3","4","0","0.42857","87","103","-16"
"1914","Akron (OH)","4","4","1","0.50000","122","134","-12"
"1915","Akron (OH)","1","7","1","0.16667","20","239","-219"
"1916","Akron (OH)","2","7","0","0.22222","90","183","-93"
"1917","Akron (OH)","5","3","0","0.62500","143","84","59"
"1918","Akron (OH)","2","2","1","0.50000","69","47","22"
"1919","Akron (OH)","6","1","1","0.81250","139","38","101"
"1920","Akron (OH)","4","4","0","0.50000","99","93","6"
"1921","Akron (OH)","5","3","0","0.62500","117","69","48"
"1922","Akron (OH)","5","3","0","0.62500","141","53","88"
"1923","Akron (OH)","4","3","1","0.56250","92","37","55"
"1924","Akron (OH)","5","3","0","0.62500","89","75","14"
"1925","Akron (OH)","1","7","0","0.12500","17","150","-133"
"1926","Akron (OH)","5","2","2","0.66667","107","74","33"
"1927","Cincinnati (OH)","2","5","2","0.33333","81","105","-24"
"1928","Cincinnati (OH)","1","8","0","0.11111","32","241","-209"
"1929","Cincinnati (OH)","4","4","1","0.50000","75","133","-58"
"1930","Cincinnati (OH)","5","4","0","0.55556","91","138","-47"
"1927","Akron (OH)","5","3","0","0.62500","144","79","65"
"1928","Akron (OH)","5","4","0","0.55556","157","99","58"
"1929","Akron (OH)","9","1","0","0.90000","149","21","128"
"1930","Akron (OH)","7","1","0","0.87500","130","38","92"
"1931","Akron (OH)","1","7","0","0.12500","38","115","-77"
"1932","Akron (OH)","2","4","3","0.38889","37","92","-55"
"1933","Akron (OH)","5","3","1","0.61111","97","50","47"
"1934","Akron (OH)","3","4","1","0.43750","65","48","17"
"1935","Akron (OH)","6","3","0","0.66667","81","71","10"
"1938","Missouri St.","5","2","2","0.66667","91","54","37"
"1939","Missouri St.","7","1","1","0.83333","129","69","60"
"1940","Missouri St.","10","0","0","1.00000","279","20","259"
"1941","Missouri St.","8","3","0","0.72727","222","72","150"
"1942","Missouri St.","2","7","2","0.27273","105","153","-48"
"1945","Missouri St.","5","1","2","0.75000","114","63","51"
"1946","Missouri St.","2","6","0","0.25000","62","126","-64"
"1936","Akron (OH)","6","2","1","0.72222","150","87","63"
"1937","Akron (OH)","7","2","0","0.77778","139","53","86"
"1938","Akron (OH)","6","3","0","0.66667","117","94","23"
"1939","Nevada","5","4","0","0.55556","49","101","-52"
"1940","Nevada","4","4","1","0.50000","252","79","173"
"1941","Nevada","3","5","1","0.38889","100","114","-14"
"1942","Nevada","4","3","1","0.56250","81","80","1"
"1943","Nevada","4","1","1","0.75000","114","25","89"
"1944","Nevada","4","4","0","0.50000","92","93","-1"
"1945","Nevada","7","3","0","0.70000","240","147","93"
"1946","Nevada","7","2","0","0.77778","324","82","242"
"1947","Oregon","7","3","0","0.70000","174","121","53"
"1948","Oregon","9","2","0","0.81818","207","103","104"
"1949","Oregon","4","6","0","0.40000","250","219","31"
"1950","Oregon","1","9","0","0.10000","97","214","-117"
"1935","William & Mary (VA)","3","4","3","0.45000","86","110","-24"
"1939","Akron (OH)","5","4","0","0.55556","122","129","-7"
"1940","Akron (OH)","2","5","2","0.33333","90","106","-16"
"1941","Akron (OH)","5","3","1","0.61111","114","76","38"
"1942","Akron (OH)","0","7","2","0.11111","26","183","-157"
"1950","Arkansas","2","8","0","0.20000","156","163","-7"
"1951","Arkansas","5","5","0","0.50000","178","162","16"
"1952","Arkansas","2","8","0","0.20000","166","282","-116"
"1946","Akron (OH)","5","4","0","0.55556","122","135","-13"
"1947","Akron (OH)","2","6","0","0.25000","44","162","-118"
"1948","Akron (OH)","2","6","0","0.25000","46","146","-100"
"1949","Akron (OH)","2","6","1","0.27778","114","257","-143"
"1950","Akron (OH)","2","7","0","0.22222","131","185","-54"
"1951","Akron (OH)","1","8","0","0.11111","115","252","-137"
"1952","Akron (OH)","2","6","1","0.27778","121","156","-35"
"1953","Akron (OH)","6","3","0","0.66667","198","210","-12"
"1950","Stetson (FL)","8","2","0","0.80000","300","133","167"
"1951","Stetson (FL)","8","1","2","0.81818","340","122","218"
"1954","Akron (OH)","3","5","0","0.37500","169","233","-64"
"1955","Akron (OH)","6","2","0","0.75000","245","73","172"
"1956","Akron (OH)","3","5","1","0.38889","216","171","45"
"1957","Akron (OH)","7","1","1","0.83333","208","87","121"
"1958","Akron (OH)","6","2","1","0.72222","166","82","84"
"1959","Akron (OH)","4","5","0","0.44444","111","155","-44"
"1960","Akron (OH)","1","8","0","0.11111","70","269","-199"
"1969","San Jose St. (CA)","2","8","0","0.20000","152","346","-194"
"1970","San Jose St. (CA)","1","2","0","0.33333","60","78","-18"
"1961","Akron (OH)","6","2","0","0.75000","185","57","128"
"1962","Akron (OH)","7","2","0","0.77778","261","65","196"
"1963","Akron (OH)","6","3","0","0.66667","201","102","99"
"1964","Akron (OH)","6","3","0","0.66667","116","109","7"
"1965","Akron (OH)","5","3","1","0.61111","110","93","17"
"1966","Akron (OH)","6","3","0","0.66667","137","116","21"
"1967","Akron (OH)","4","4","1","0.50000","162","155","7"
"1968","Akron (OH)","7","3","1","0.68182","327","172","155"
"1969","Akron (OH)","9","1","0","0.90000","316","103","213"
"1970","Akron (OH)","7","3","0","0.70000","259","92","167"
"1971","Akron (OH)","8","2","0","0.80000","193","119","74"
"1972","Akron (OH)","3","4","2","0.44444","193","148","45"
"1973","Akron (OH)","6","5","0","0.54545","289","204","85"
"1974","Akron (OH)","5","5","0","0.50000","162","197","-35"
"1975","Akron (OH)","7","4","0","0.63636","189","166","23"
"1976","Akron (OH)","10","3","0","0.76923","282","144","138"
"1977","Akron (OH)","6","4","1","0.59091","234","170","64"
"1978","Akron (OH)","6","5","0","0.54545","221","232","-11"
"1979","Akron (OH)","6","5","0","0.54545","232","223","9"
"1980","Akron (OH)","3","7","1","0.31818","134","183","-49"
"1981","Akron (OH)","5","5","0","0.50000","132","183","-51"
"1982","Akron (OH)","6","5","0","0.54545","188","144","44"
"1983","Akron (OH)","8","3","0","0.72727","210","104","106"
"1984","Akron (OH)","4","7","0","0.36364","205","167","38"
"1985","Akron (OH)","8","4","0","0.66667","258","186","72"
"1981","Notre Dame (IN)","5","6","0","0.45455","232","160","72"
"1982","Notre Dame (IN)","6","4","1","0.59091","206","174","32"
"1983","Notre Dame (IN)","7","5","0","0.58333","316","177","139"
"1984","Notre Dame (IN)","7","5","0","0.58333","299","239","60"
"1985","Notre Dame (IN)","5","6","0","0.45455","230","234","-4"
"1986","Akron (OH)","7","4","0","0.63636","291","188","103"
"1987","Akron (OH)","4","7","0","0.36364","204","273","-69"
"1988","Akron (OH)","5","6","0","0.45455","233","214","19"
"1989","Akron (OH)","6","4","1","0.59091","296","241","55"
"1990","Akron (OH)","3","7","1","0.31818","233","263","-30"
"1991","Akron (OH)","5","6","0","0.45455","257","308","-51"
"1992","Akron (OH)","7","3","1","0.68182","218","186","32"
"1993","Akron (OH)","5","6","0","0.45455","192","222","-30"
"1994","Akron (OH)","1","10","0","0.09091","145","404","-259"
"1995","Akron (OH)","2","9","0","0.18182","141","428","-287"
"1996","Akron (OH)","4","7","0","0.36364","175","269","-94"
"1997","Akron (OH)","2","9","0","0.18182","218","435","-217"
"1998","Akron (OH)","4","7","0","0.36364","265","299","-34"
"1999","Akron (OH)","7","4","0","0.63636","315","314","1"
"2000","Akron (OH)","6","5","0","0.54545","333","295","38"
"2001","Akron (OH)","4","7","0","0.36364","281","360","-79"
"2002","Akron (OH)","4","8","0","0.33333","325","379","-54"
"2003","Akron (OH)","7","5","0","0.58333","435","353","82"
"2004","Ashland (OH)","5","6","0","0.45455","245","245","0"
"2005","Ashland (OH)","9","2","0","0.81818","252","107","145"
"2006","Ashland (OH)","4","6","0","0.40000","206","244","-38"
"2007","Ashland (OH)","8","2","0","0.80000","440","298","142"
"2008","Ashland (OH)","9","4","0","0.69231","452","383","69"
"2009","Ashland (OH)","6","5","0","0.54545","299","287","12"
"2010","Ashland (OH)","8","3","0","0.72727","415","196","219"
"2011","Ashland (OH)","6","5","0","0.54545","333","263","70"
"2012","Ashland (OH)","11","1","0","0.91667","490","183","307"
"2013","Ashland (OH)","5","5","0","0.50000","289","234","55"
"2004","Akron (OH)","6","5","0","0.54545","271","347","-76"
"2005","Akron (OH)","7","6","0","0.53846","307","318","-11"
"2006","Akron (OH)","5","7","0","0.41667","236","271","-35"
"2007","Akron (OH)","4","8","0","0.33333","254","350","-96"
"2008","Akron (OH)","5","7","0","0.41667","360","375","-15"
"2009","Akron (OH)","3","9","0","0.25000","231","345","-114"
"2010","Akron (OH)","1","11","0","0.08333","187","421","-234"
"2011","Akron (OH)","1","11","0","0.08333","170","462","-292"
"1987","Samford (AL)","9","1","0","0.90000","517","228","289"
"1988","Samford (AL)","5","6","0","0.45455","232","274","-42"
"1989","Samford (AL)","5","6","0","0.45455","249","330","-81"
"1990","Samford (AL)","6","4","1","0.59091","268","233","35"
"1991","Samford (AL)","12","2","0","0.85714","385","198","187"
"1992","Samford (AL)","9","3","0","0.75000","400","257","143"
"1993","Auburn (AL)","11","0","0","1.00000","353","192","161"
"1994","Auburn (AL)","9","1","1","0.86364","359","199","160"
"1995","Auburn (AL)","8","4","0","0.66667","438","283","155"
"1996","Auburn (AL)","8","4","0","0.66667","398","277","121"
"1997","Auburn (AL)","10","3","0","0.76923","340","250","90"
"1998","Auburn (AL)","1","5","0","0.16667","69","129","-60"
"2009","North Alabama","11","2","0","0.84615","513","223","290"
"2010","North Alabama","9","4","0","0.69231","378","191","187"
"2011","North Alabama","9","3","0","0.75000","381","248","133"
"2012","Akron (OH)","1","11","0","0.08333","313","428","-115"
"2013","Akron (OH)","5","7","0","0.41667","242","343","-101"
"1892","Alabama","2","2","0","0.50000","96","37","59"
"1893","Alabama","0","4","0","0.00000","24","74","-50"
"1894","Alabama","3","1","0","0.75000","60","16","44"
"1895","Alabama","0","4","0","0.00000","12","112","-100"
"1902","Alabama","4","4","0","0.50000","191","49","142"
"1946","Mississippi College","1","0","0","1.00000","26","6","20"
"1896","Alabama","2","1","0","0.66667","56","10","46"
"1897","Iowa","4","4","0","0.50000","76","110","-34"
"1897","Alabama","1","0","0","1.00000","6","0","6"
"1899","Alabama","3","1","0","0.75000","34","31","3"
"1900","Alabama","2","3","0","0.40000","52","99","-47"
"1901","Alabama","2","1","2","0.60000","92","23","69"
"1902","Auburn (AL)","0","2","0","0.00000","5","28","-23"
"1903","Mississippi","2","1","1","0.62500","34","39","-5"
"1904","Mississippi","4","3","0","0.57143","185","106","79"
"1903","Alabama","3","4","0","0.42857","60","114","-54"
"1904","Alabama","7","3","0","0.70000","104","67","37"
"1908","Samford (AL)","2","2","0","0.50000","33","85","-52"
"1905","Alabama","6","4","0","0.60000","178","113","65"
"1901","Lehigh (PA)","1","11","0","0.08333","26","278","-252"
"1906","Alabama","5","1","0","0.83333","97","82","15"
"1907","Alabama","5","1","2","0.75000","70","64","6"
"1908","Alabama","6","1","1","0.81250","108","31","77"
"1909","Alabama","5","1","2","0.75000","68","17","51"
"1910","Alabama","4","4","0","0.50000","65","107","-42"
"1911","Kansas St.","5","4","1","0.55000","47","87","-40"
"1912","Kansas St.","8","2","0","0.80000","204","103","101"
"1913","Kansas St.","3","4","1","0.43750","97","122","-25"
"1914","Kansas St.","1","5","1","0.21429","44","150","-106"
"1918","Wisconsin","3","3","0","0.50000","42","44","-2"
"1911","Alabama","5","2","2","0.66667","153","31","122"
"1912","Alabama","5","3","1","0.61111","156","55","101"
"1913","Alabama","6","3","0","0.66667","188","40","148"
"1914","Alabama","5","4","0","0.55556","211","64","147"
"1918","Texas A&M","6","1","0","0.85714","123","19","104"
"1920","Montana St.","4","1","1","0.75000","62","41","21"
"1921","Montana St.","2","4","0","0.33333","63","74","-11"
"1915","Alabama","6","2","0","0.75000","250","51","199"
"1916","Alabama","6","3","0","0.66667","156","62","94"
"1917","Alabama","5","2","1","0.68750","168","29","139"
"1920","Idaho","4","2","0","0.66667","75","48","27"
"1921","Idaho","4","3","1","0.56250","98","68","30"
"1922","Missouri","5","3","0","0.62500","98","90","8"
"1919","Alabama","8","1","0","0.88889","280","22","258"
"1920","Alabama","10","1","0","0.90909","377","35","342"
"1921","Alabama","5","4","2","0.54545","241","104","137"
"1922","Alabama","6","3","1","0.65000","300","81","219"
"1923","Alabama","7","2","1","0.75000","222","50","172"
"1924","Alabama","8","1","0","0.88889","290","24","266"
"1925","Alabama","10","0","0","1.00000","297","26","271"
"1926","Alabama","9","0","1","0.95000","249","27","222"
"1927","Alabama","5","4","1","0.55000","154","73","81"
"1928","Alabama","6","3","0","0.66667","187","75","112"
"1929","Alabama","6","3","0","0.66667","196","58","138"
"1930","Alabama","10","0","0","1.00000","271","13","258"
"1931","Duke (NC)","5","3","2","0.60000","74","46","28"
"1932","Duke (NC)","7","3","0","0.70000","153","40","113"
"1933","Duke (NC)","9","1","0","0.90000","181","42","139"
"1934","Duke (NC)","7","2","0","0.77778","185","40","145"
"1935","Duke (NC)","8","2","0","0.80000","214","45","169"
"1936","Duke (NC)","9","1","0","0.90000","208","28","180"
"1937","Duke (NC)","7","2","1","0.75000","228","56","172"
"1938","Duke (NC)","9","1","0","0.90000","117","7","110"
"1939","Duke (NC)","8","1","0","0.88889","183","42","141"
"1940","Duke (NC)","7","2","0","0.77778","203","52","151"
"1941","Duke (NC)","9","1","0","0.90000","327","61","266"
"1946","Duke (NC)","4","5","0","0.44444","134","86","48"
"1947","Duke (NC)","4","3","2","0.55556","79","90","-11"
"1948","Duke (NC)","4","3","2","0.55556","144","92","52"
"1949","Duke (NC)","6","3","0","0.66667","260","117","143"
"1950","Duke (NC)","7","3","0","0.70000","202","108","94"
"1925","Tennessee-Chattanooga","4","4","0","0.50000","73","57","16"
"1926","Tennessee-Chattanooga","6","2","2","0.70000","278","57","221"
"1927","Tennessee-Chattanooga","8","1","0","0.88889","240","98","142"
"1928","Tennessee-Chattanooga","8","2","0","0.80000","284","69","215"
"1931","Alabama","9","1","0","0.90000","360","57","303"
"1932","Alabama","8","2","0","0.80000","200","51","149"
"1933","Alabama","7","1","1","0.83333","130","17","113"
"1934","Alabama","10","0","0","1.00000","316","45","271"
"1935","Alabama","6","2","1","0.72222","185","55","130"
"1936","Alabama","8","0","1","0.94444","168","35","133"
"1937","Alabama","9","1","0","0.90000","225","33","192"
"1938","Alabama","7","1","1","0.83333","149","40","109"
"1939","Alabama","5","3","1","0.61111","101","53","48"
"1940","Alabama","7","2","0","0.77778","166","80","86"
"1941","Alabama","9","2","0","0.81818","263","85","178"
"1942","Alabama","8","3","0","0.72727","246","97","149"
"1944","Alabama","5","2","2","0.66667","272","83","189"
"1945","Alabama","10","0","0","1.00000","430","80","350"
"1946","Alabama","7","4","0","0.63636","186","110","76"
"1924","Birmingham-Southern (AL)","4","4","1","0.50000","75","141","-66"
"1925","Birmingham-Southern (AL)","7","3","1","0.68182","215","135","80"
"1926","Birmingham-Southern (AL)","5","3","2","0.60000","202","101","101"
"1927","Birmingham-Southern (AL)","3","6","0","0.33333","88","120","-32"
"1929","Tennessee-Chattanooga","8","2","0","0.80000","165","100","65"
"1930","Tennessee-Chattanooga","5","3","2","0.60000","109","88","21"
"1946","Mississippi","2","7","0","0.22222","76","144","-68"
"1947","Alabama","8","3","0","0.72727","210","101","109"
"1948","Alabama","6","4","1","0.59091","228","170","58"
"1949","Alabama","6","3","1","0.65000","227","130","97"
"1950","Alabama","9","2","0","0.81818","328","107","221"
"1951","Alabama","5","6","0","0.45455","263","188","75"
"1952","Alabama","10","2","0","0.83333","325","139","186"
"1953","Alabama","6","3","3","0.62500","178","152","26"
"1954","Alabama","4","5","2","0.45455","123","104","19"
"1950","Oklahoma St.","4","6","1","0.40909","159","259","-100"
"1951","Oklahoma St.","3","7","0","0.30000","168","251","-83"
"1952","Oklahoma St.","3","7","0","0.30000","146","178","-32"
"1953","Oklahoma St.","7","3","0","0.70000","178","149","29"
"1954","Oklahoma St.","5","4","1","0.55000","161","119","42"
"1955","Alabama","0","10","0","0.00000","48","256","-208"
"1956","Alabama","2","7","1","0.25000","85","208","-123"
"1957","Alabama","2","7","1","0.25000","69","173","-104"
"1945","Maryland","6","2","1","0.72222","219","105","114"
"1946","Kentucky","7","3","0","0.70000","233","97","136"
"1947","Kentucky","8","3","0","0.72727","175","73","102"
"1948","Kentucky","5","3","2","0.60000","199","128","71"
"1949","Kentucky","9","3","0","0.75000","317","74","243"
"1950","Kentucky","11","1","0","0.91667","393","69","324"
"1951","Kentucky","8","4","0","0.66667","314","121","193"
"1952","Kentucky","5","4","2","0.54545","161","173","-12"
"1953","Kentucky","7","2","1","0.75000","201","116","85"
"1954","Texas A&M","1","9","0","0.10000","97","177","-80"
"1955","Texas A&M","7","2","1","0.75000","160","89","71"
"1956","Texas A&M","9","0","1","0.95000","223","81","142"
"1957","Texas A&M","8","3","0","0.72727","158","50","108"
"1958","Alabama","5","4","1","0.55000","106","75","31"
"1959","Alabama","7","2","2","0.72727","95","59","36"
"1960","Alabama","8","1","2","0.81818","183","56","127"
"1961","Alabama","11","0","0","1.00000","297","25","272"
"1962","Alabama","10","1","0","0.90909","289","39","250"
"1963","Alabama","9","2","0","0.81818","227","95","132"
"1964","Alabama","10","1","0","0.90909","250","88","162"
"1965","Alabama","9","1","1","0.86364","256","107","149"
"1966","Alabama","11","0","0","1.00000","301","44","257"
"1967","Alabama","8","2","1","0.77273","204","131","73"
"1968","Alabama","8","3","0","0.72727","184","139","45"
"1969","Alabama","6","5","0","0.54545","314","268","46"
"1970","Alabama","6","5","1","0.54167","334","264","70"
"1971","Alabama","11","1","0","0.91667","368","122","246"
"1972","Alabama","10","2","0","0.83333","406","150","256"
"1973","Alabama","11","1","0","0.91667","477","113","364"
"1974","Alabama","11","1","0","0.91667","329","96","233"
"1975","Alabama","11","1","0","0.91667","374","72","302"
"1976","Alabama","9","3","0","0.75000","327","140","187"
"1977","Alabama","11","1","0","0.91667","380","139","241"
"1978","Alabama","11","1","0","0.91667","345","168","177"
"1979","Alabama","12","0","0","1.00000","383","67","316"
"1980","Alabama","10","2","0","0.83333","352","98","254"
"1981","Alabama","9","2","1","0.79167","296","151","145"
"1982","Alabama","8","4","0","0.66667","338","216","122"
"1983","Alabama","8","4","0","0.66667","366","229","137"
"1984","Alabama","5","6","0","0.45455","226","208","18"
"1985","Alabama","9","2","1","0.79167","318","181","137"
"1986","Alabama","10","3","0","0.76923","351","163","188"
"1992","Arkansas St.","2","9","0","0.18182","118","402","-284"
"1980","Georgia Tech","1","9","1","0.13636","113","260","-147"
"1981","Georgia Tech","1","10","0","0.09091","124","309","-185"
"1982","Georgia Tech","6","5","0","0.54545","239","286","-47"
"1983","Georgia Tech","3","8","0","0.27273","222","313","-91"
"1984","Georgia Tech","6","4","1","0.59091","296","201","95"
"1985","Georgia Tech","9","2","1","0.79167","252","132","120"
"1986","Georgia Tech","5","5","1","0.50000","282","211","71"
"1987","Alabama","7","5","0","0.58333","268","213","55"
"1988","Alabama","9","3","0","0.75000","317","188","129"
"1989","Alabama","10","2","0","0.83333","357","217","140"
"1990","Kentucky","4","7","0","0.36364","228","316","-88"
"1991","Kentucky","3","8","0","0.27273","190","268","-78"
"1992","Kentucky","4","7","0","0.36364","207","280","-73"
"1993","Kentucky","6","6","0","0.50000","220","209","11"
"1994","Kentucky","1","10","0","0.09091","149","405","-256"
"1995","Kentucky","4","7","0","0.36364","223","269","-46"
"1996","Kentucky","4","7","0","0.36364","138","322","-184"
"2010","Georgia St.","6","5","0","0.54545","302","286","16"
"2011","Georgia St.","3","8","0","0.27273","249","343","-94"
"2012","Georgia St.","1","10","0","0.09091","191","424","-233"
"1965","Texas A&M","3","7","0","0.30000","80","170","-90"
"1966","Texas A&M","4","5","1","0.45000","145","183","-38"
"1967","Texas A&M","7","4","0","0.63636","211","154","57"
"1968","Texas A&M","3","7","0","0.30000","196","184","12"
"1969","Texas A&M","3","7","0","0.30000","116","192","-76"
"1970","Texas A&M","2","9","0","0.18182","170","304","-134"
"1971","Texas A&M","5","6","0","0.45455","144","212","-68"
"1990","Alabama","7","5","0","0.58333","260","161","99"
"1991","Alabama","11","1","0","0.91667","324","143","181"
"1992","Alabama","13","0","0","1.00000","366","122","244"
"1993","Alabama","1","12","0","0.07692","340","168","172"
"1994","Alabama","12","1","0","0.92308","305","190","115"
"1995","Alabama","8","3","0","0.72727","260","188","72"
"1996","Alabama","10","3","0","0.76923","316","195","121"
"1997","Alabama","4","7","0","0.36364","246","248","-2"
"1998","Alabama","7","5","0","0.58333","251","287","-36"
"1999","Alabama","10","3","0","0.76923","378","265","113"
"2000","Alabama","3","8","0","0.27273","228","246","-18"
"1981","Southwestern (KS)","5","2","2","0.66667","300","174","126"
"1982","Southwestern (KS)","9","2","0","0.81818","261","130","131"
"1985","Pittsburg St. (KS)","8","2","0","0.80000","299","217","82"
"1986","Pittsburg St. (KS)","11","1","0","0.91667","499","199","300"
"1987","Pittsburg St. (KS)","11","1","0","0.91667","533","108","425"
"1988","Pittsburg St. (KS)","11","1","0","0.91667","423","126","297"
"1989","Pittsburg St. (KS)","12","1","0","0.92308","478","153","325"
"1990","Texas St.","6","5","0","0.54545","268","220","48"
"1991","Texas St.","7","4","0","0.63636","307","179","128"
"1992","New Mexico","3","8","0","0.27273","247","287","-40"
"1993","New Mexico","6","5","0","0.54545","335","256","79"
"1994","New Mexico","5","7","0","0.41667","401","386","15"
"1995","New Mexico","4","7","0","0.36364","256","303","-47"
"1996","New Mexico","6","5","0","0.54545","331","280","51"
"1997","New Mexico","9","4","0","0.69231","404","274","130"
"1998","Texas Christian","7","5","0","0.58333","267","235","32"
"1999","Texas Christian","8","4","0","0.66667","362","213","149"
"2000","Texas Christian","10","1","0","0.90909","410","106","304"
"2001","Alabama","7","5","0","0.58333","318","232","86"
"2002","Alabama","10","3","0","0.76923","367","200","167"
"2003","Texas A&M","4","8","0","0.33333","304","465","-161"
"2004","Texas A&M","7","5","0","0.58333","341","292","49"
"2005","Texas A&M","5","6","0","0.45455","352","343","9"
"2006","Texas A&M","9","4","0","0.69231","362","267","95"
"2007","Texas A&M","7","5","0","0.58333","346","313","33"
"2011","Texas St.","6","6","0","0.50000","306","342","-36"
"2012","Texas St.","4","8","0","0.33333","343","402","-59"
"2013","Texas St.","6","6","0","0.50000","287","328","-41"
"2003","Alabama","4","9","0","0.30769","331","333","-2"
"2004","Alabama","6","6","0","0.50000","295","189","106"
"2005","Alabama","0","2","0","0.00000","263","128","135"
"2006","Alabama","0","6","0","0.00000","267","216","51"
"1992","Arkansas","3","6","1","0.35000","169","199","-30"
"2006","Alabama","0","1","0","0.00000","31","34","-3"
"1990","Toledo (OH)","9","2","0","0.81818","284","178","106"
"1995","Michigan St.","6","5","1","0.54167","287","338","-51"
"1996","Michigan St.","6","6","0","0.50000","358","302","56"
"1997","Michigan St.","7","5","0","0.58333","342","237","105"
"1998","Michigan St.","6","6","0","0.50000","336","294","42"
"1999","Michigan St.","9","2","0","0.81818","341","211","130"
"2000","Louisiana St.","8","4","0","0.66667","320","235","85"
"2001","Louisiana St.","10","3","0","0.76923","418","302","116"
"2002","Louisiana St.","8","5","0","0.61538","323","238","85"
"2003","Louisiana St.","13","1","0","0.92857","475","154","321"
"2004","Louisiana St.","9","3","0","0.75000","344","205","139"
"2007","Alabama","2","6","0","0.25000","352","286","66"
"2008","Alabama","12","2","0","0.85714","422","200","222"
"2009","Alabama","14","0","0","1.00000","449","164","285"
"2010","Alabama","10","3","0","0.76923","464","176","288"
"2011","Alabama","12","1","0","0.92308","453","106","347"
"2012","Alabama","13","1","0","0.92857","542","153","389"
"2013","Alabama","11","2","0","0.84615","496","181","315"
"1991","Alabama-Birmingham","4","3","2","0.55556","170","196","-26"
"1992","Alabama-Birmingham","7","3","0","0.70000","270","163","107"
"1993","Alabama-Birmingham","9","2","0","0.81818","356","213","143"
"1994","Alabama-Birmingham","7","4","0","0.63636","301","258","43"
"1979","Austin Peay St. (TN)","7","4","0","0.63636","198","150","48"
"1980","Austin Peay St. (TN)","7","4","0","0.63636","217","148","69"
"1983","Cincinnati (OH)","4","6","1","0.40909","208","234","-26"
"1984","Rice (TX)","1","10","0","0.09091","213","382","-169"
"1985","Rice (TX)","3","8","0","0.27273","233","404","-171"
"1986","Vanderbilt (TN)","1","10","0","0.09091","193","347","-154"
"1987","Vanderbilt (TN)","4","7","0","0.36364","286","355","-69"
"1988","Vanderbilt (TN)","3","8","0","0.27273","202","277","-75"
"1989","Vanderbilt (TN)","1","10","0","0.09091","162","265","-103"
"1990","Vanderbilt (TN)","1","10","0","0.09091","227","457","-230"
"1995","Alabama-Birmingham","5","6","0","0.45455","273","261","12"
"1996","Alabama-Birmingham","5","6","0","0.45455","266","279","-13"
"1997","Alabama-Birmingham","5","6","0","0.45455","222","238","-16"
"1998","Alabama-Birmingham","4","7","0","0.36364","237","308","-71"
"1999","Alabama-Birmingham","5","6","0","0.45455","248","279","-31"
"2000","Alabama-Birmingham","7","4","0","0.63636","238","192","46"
"2001","Alabama-Birmingham","6","5","0","0.54545","265","206","59"
"2002","Alabama-Birmingham","5","7","0","0.41667","268","370","-102"
"2003","Alabama-Birmingham","5","7","0","0.41667","245","287","-42"
"2004","Alabama-Birmingham","7","5","0","0.58333","372","351","21"
"2005","Alabama-Birmingham","5","6","0","0.45455","307","264","43"
"2006","Alabama-Birmingham","3","9","0","0.25000","225","297","-72"
"2007","Tennessee Tech","4","7","0","0.36364","329","352","-23"
"2008","Tennessee Tech","3","9","0","0.25000","240","420","-180"
"2009","Tennessee Tech","6","5","0","0.54545","267","286","-19"
"2010","Tennessee Tech","5","6","0","0.45455","264","317","-53"
"2011","Tennessee Tech","7","4","0","0.63636","355","279","76"
"2012","Tennessee Tech","3","8","0","0.27273","347","433","-86"
"2013","Tennessee Tech","5","7","0","0.41667","313","353","-40"
"2007","Alabama-Birmingham","2","10","0","0.16667","235","421","-186"
"2008","Alabama-Birmingham","4","8","0","0.33333","273","375","-102"
"2009","Alabama-Birmingham","5","7","0","0.41667","333","388","-55"
"2010","Alabama-Birmingham","4","8","0","0.33333","316","379","-63"
"2011","Alabama-Birmingham","3","9","0","0.25000","242","441","-199"
"2012","Alabama-Birmingham","3","9","0","0.25000","339","450","-111"
"2013","Alabama-Birmingham","2","10","0","0.16667","315","525","-210"
"1899","Arizona","2","1","1","0.62500","29","16","13"
"1892","Maryland","0","3","0","0.00000","0","128","-128"
"1900","Arizona","3","1","0","0.75000","131","6","125"
"1901","Arizona","4","1","0","0.80000","115","19","96"
"1902","Arizona","5","0","0","1.00000","134","0","134"
"1903","Arizona","2","0","0","1.00000","41","10","31"
"1904","Arizona","3","1","2","0.66667","66","48","18"
"1905","Arizona","4","2","0","0.66667","84","96","-12"
"1908","Arizona","5","0","0","1.00000","136","6","130"
"1909","Arizona","3","1","0","0.75000","71","23","48"
"1910","Arizona","5","0","0","1.00000","87","8","79"
"1911","Arizona","3","1","1","0.70000","16","3","13"
"1912","Arizona","2","1","0","0.66667","55","30","25"
"1913","Arizona","2","2","0","0.50000","26","42","-16"
"1914","Arizona","5","1","0","0.83333","85","20","65"
"1915","Arizona","5","3","0","0.62500","133","34","99"
"1916","Arizona","5","3","0","0.62500","247","93","154"
"1917","Arizona","3","2","0","0.60000","118","41","77"
"1919","Arizona","7","1","0","0.87500","253","19","234"
"1920","Arizona","6","1","0","0.85714","381","65","316"
"1921","Arizona","7","2","0","0.77778","418","68","350"
"1922","Arizona","6","3","0","0.66667","109","53","56"
"1923","Arizona","5","3","0","0.62500","146","127","19"
"1924","Arizona","2","4","0","0.33333","40","93","-53"
"1925","Arizona","3","3","1","0.50000","70","88","-18"
"1926","Arizona","5","1","1","0.78571","143","18","125"
"1927","Arizona","4","2","1","0.64286","165","59","106"
"1928","Arizona","5","1","2","0.75000","152","110","42"
"1929","Arizona","7","1","0","0.87500","182","22","160"
"1930","Arizona","6","1","1","0.81250","122","33","89"
"1923","Louisville (KY)","5","3","0","0.62500","84","73","11"
"1924","Louisville (KY)","3","5","1","0.38889","43","95","-52"
"1931","Arizona","3","5","1","0.38889","72","149","-77"
"1932","Arizona","4","5","0","0.44444","82","106","-24"
"1933","Arizona","5","3","0","0.62500","113","35","78"
"1934","Arizona","7","2","1","0.75000","138","54","84"
"1935","Arizona","7","2","0","0.77778","218","45","173"
"1936","Arizona","5","2","3","0.65000","190","54","136"
"1937","Arizona","8","2","0","0.80000","194","88","106"
"1938","Oregon","4","5","0","0.44444","69","138","-69"
"1939","Oregon","3","4","1","0.43750","101","74","27"
"1940","Oregon","4","4","1","0.50000","100","58","42"
"1941","Oregon","5","5","0","0.50000","136","184","-48"
"1945","Oregon","3","6","0","0.33333","116","124","-8"
"1946","Oregon","4","4","1","0.50000","81","118","-37"
"1938","Arizona","3","6","0","0.33333","75","146","-71"
"1939","Arizona","6","4","0","0.60000","109","113","-4"
"1940","Arizona","7","2","0","0.77778","204","83","121"
"1941","Arizona","7","3","0","0.70000","253","146","107"
"1942","Arizona","6","4","0","0.60000","189","139","50"
"1945","Arizona","5","0","0","1.00000","193","12","181"
"1946","Arizona","4","4","2","0.50000","218","136","82"
"1947","Arizona","5","4","1","0.55000","233","241","-8"
"1948","Arizona","6","5","0","0.54545","167","246","-79"
"1949","Arizona","2","7","1","0.25000","118","298","-180"
"1950","Arizona","4","6","0","0.40000","214","257","-43"
"1951","Arizona","6","5","0","0.54545","246","270","-24"
"1935","Central Arkansas","4","3","0","0.57143","106","84","22"
"1936","Central Arkansas","8","0","0","1.00000","227","40","187"
"1937","Central Arkansas","8","1","0","0.88889","353","62","291"
"1938","Central Arkansas","7","1","0","0.87500","166","47","119"
"1939","Central Arkansas","5","2","2","0.66667","78","19","59"
"1940","Central Arkansas","8","1","1","0.85000","157","52","105"
"1941","Hardin-Simmons (TX)","7","3","1","0.68182","178","88","90"
"1942","Hardin-Simmons (TX)","8","0","1","0.94444","226","58","168"
"1946","Hardin-Simmons (TX)","11","0","0","1.00000","322","48","274"
"1947","Hardin-Simmons (TX)","8","3","0","0.72727","305","87","218"
"1948","Hardin-Simmons (TX)","6","2","3","0.68182","345","212","133"
"1949","Hardin-Simmons (TX)","6","4","1","0.59091","318","189","129"
"1950","Hardin-Simmons (TX)","5","5","0","0.50000","278","180","98"
"1951","Hardin-Simmons (TX)","6","6","0","0.50000","272","216","56"
"1952","Arizona","6","4","0","0.60000","285","155","130"
"1953","Arizona","4","5","1","0.45000","234","181","53"
"1954","Arizona","7","3","0","0.70000","385","215","170"
"1955","Arizona","5","4","1","0.55000","184","169","15"
"1956","Arizona","4","6","0","0.40000","180","182","-2"
"1958","New Mexico St.","4","6","0","0.40000","172","228","-56"
"1959","New Mexico St.","8","3","0","0.72727","360","158","202"
"1960","New Mexico St.","11","0","0","1.00000","394","113","281"
"1961","New Mexico St.","5","4","1","0.55000","341","195","146"
"1962","New Mexico St.","4","6","0","0.40000","191","259","-68"
"1963","New Mexico St.","3","6","1","0.35000","158","209","-51"
"1964","New Mexico St.","6","4","0","0.60000","131","171","-40"
"1965","New Mexico St.","8","2","0","0.80000","236","153","83"
"1966","New Mexico St.","7","3","0","0.70000","321","159","162"
"1967","New Mexico St.","7","2","1","0.75000","339","145","194"
"1947","Arizona St.","4","7","0","0.36364","168","234","-66"
"1948","Arizona St.","5","5","0","0.50000","276","192","84"
"1949","Arizona St.","7","3","0","0.70000","342","204","138"
"1950","Arizona St.","9","2","0","0.81818","404","154","250"
"1951","Rhode Island","3","5","0","0.37500","130","133","-3"
"1957","Arizona","1","8","1","0.15000","125","299","-174"
"1958","Arizona","3","7","0","0.30000","83","276","-193"
"1971","Holy Cross (MA)","4","6","0","0.40000","188","239","-51"
"1972","Holy Cross (MA)","5","4","1","0.55000","187","182","5"
"1973","Holy Cross (MA)","5","6","0","0.45455","221","221","0"
"1974","Holy Cross (MA)","5","5","1","0.50000","182","219","-37"
"1975","Holy Cross (MA)","1","10","0","0.09091","119","274","-155"
"1959","Arizona","4","6","0","0.40000","118","211","-93"
"1960","Arizona","7","3","0","0.70000","233","152","81"
"1961","Arizona","8","1","1","0.85000","288","131","157"
"1962","Arizona","5","5","0","0.50000","134","171","-37"
"1963","Arizona","5","5","0","0.50000","136","165","-29"
"1964","Arizona","6","3","1","0.65000","147","76","71"
"1965","Arizona","3","7","0","0.30000","77","172","-95"
"1966","Arizona","3","7","0","0.30000","192","250","-58"
"1959","Adams St. (CO)","8","1","0","0.88889","217","111","106"
"1960","Adams St. (CO)","7","0","1","0.93750","233","76","157"
"1961","Adams St. (CO)","8","2","0","0.80000","203","119","84"
"1962","Adams St. (CO)","9","1","0","0.90000","207","124","83"
"1963","North Dakota St.","3","5","0","0.37500","174","164","10"
"1964","North Dakota St.","10","1","0","0.90909","252","121","131"
"1965","North Dakota St.","11","0","0","1.00000","383","87","296"
"1967","Arizona","3","6","1","0.35000","162","231","-69"
"1968","Arizona","8","3","0","0.72727","186","149","37"
"1969","Western Illinois","8","2","0","0.80000","311","162","149"
"1970","Western Illinois","7","3","0","0.70000","308","183","125"
"1971","Western Illinois","8","2","0","0.80000","213","158","55"
"1972","Western Illinois","9","2","0","0.81818","272","191","81"
"1973","Western Illinois","7","4","0","0.63636","258","187","71"
"1974","Florida St.","1","10","0","0.09091","130","289","-159"
"1975","Florida St.","3","8","0","0.27273","187","213","-26"
"1978","Eastern Illinois","12","2","0","0.85714","454","253","201"
"1979","Eastern Illinois","7","4","0","0.63636","302","170","132"
"1980","Eastern Illinois","11","3","0","0.78571","441","238","203"
"1981","Eastern Illinois","6","5","0","0.54545","250","228","22"
"1982","Eastern Illinois","11","1","1","0.88462","338","130","208"
"1983","Northern Iowa","6","5","0","0.54545","228","248","-20"
"1984","Northern Iowa","9","2","0","0.81818","366","169","197"
"1985","Northern Iowa","11","2","0","0.84615","392","212","180"
"1986","Northern Iowa","7","3","1","0.68182","347","221","126"
"1987","Northern Iowa","10","4","0","0.71429","463","305","158"
"1969","Arizona","3","7","0","0.30000","210","276","-66"
"1970","Arizona","4","6","0","0.40000","168","213","-45"
"1971","Arizona","5","6","0","0.45455","191","232","-41"
"1972","Arizona","4","7","0","0.36364","226","271","-45"
"1980","Louisville (KY)","5","6","0","0.45455","162","203","-41"
"1981","Louisville (KY)","5","6","0","0.45455","180","212","-32"
"1982","Louisville (KY)","5","6","0","0.45455","220","355","-135"
"1983","Louisville (KY)","3","8","0","0.27273","157","351","-194"
"1984","Louisville (KY)","2","9","0","0.18182","237","360","-123"
"1973","Arizona","8","3","0","0.72727","286","213","73"
"1974","Arizona","9","2","0","0.81818","263","174","89"
"1975","Arizona","9","2","0","0.81818","330","169","161"
"1976","Arizona","5","6","0","0.45455","283","273","10"
"1977","Purdue (IN)","5","6","0","0.45455","231","247","-16"
"1978","Purdue (IN)","9","2","1","0.79167","261","130","131"
"1979","Purdue (IN)","10","2","0","0.83333","287","226","61"
"1980","Purdue (IN)","9","3","0","0.75000","328","233","95"
"1981","Purdue (IN)","5","6","0","0.45455","242","241","1"
"1983","Army (NY)","2","9","0","0.18182","140","304","-164"
"1984","Army (NY)","8","3","1","0.70833","320","218","102"
"1985","Army (NY)","9","3","0","0.75000","396","232","164"
"1986","Army (NY)","6","5","0","0.54545","276","292","-16"
"1987","Army (NY)","5","6","0","0.45455","277","223","54"
"1988","Army (NY)","9","3","0","0.75000","336","226","110"
"1989","Army (NY)","6","5","0","0.54545","316","212","104"
"1990","Army (NY)","6","5","0","0.54545","295","264","31"
"1973","Cincinnati (OH)","4","7","0","0.36364","210","109","101"
"1974","Cincinnati (OH)","7","4","0","0.63636","227","175","52"
"1975","Cincinnati (OH)","6","5","0","0.54545","209","182","27"
"1976","Cincinnati (OH)","9","2","0","0.81818","204","114","90"
"1977","Arizona","5","7","0","0.41667","256","250","6"
"1978","Arizona","5","6","0","0.45455","245","205","40"
"1979","Arizona","6","5","1","0.54167","244","243","1"
"1976","Tulane (LA)","2","9","0","0.18182","149","228","-79"
"1977","Tulane (LA)","3","8","0","0.27273","181","289","-108"
"1978","Tulane (LA)","4","7","0","0.36364","183","211","-28"
"1979","Tulane (LA)","9","3","0","0.75000","320","179","141"
"1980","Arizona","5","6","0","0.45455","215","275","-60"
"1981","Arizona","6","5","0","0.54545","253","205","48"
"1982","Arizona","6","4","1","0.59091","311","219","92"
"1983","Arizona","7","3","1","0.68182","343","188","155"
"1984","Arizona","7","4","0","0.63636","272","192","80"
"1985","Arizona","8","3","1","0.70833","252","146","106"
"1986","Arizona","9","3","0","0.75000","352","204","148"
"1987","Southern California","8","4","0","0.66667","321","229","92"
"1988","Southern California","10","2","0","0.83333","370","184","186"
"1989","Southern California","9","2","1","0.79167","336","132","204"
"1990","Southern California","8","4","1","0.65385","348","274","74"
"1991","Southern California","3","8","0","0.27273","229","276","-47"
"1992","Southern California","6","5","1","0.54167","264","249","15"
"1994","Missouri","3","8","1","0.29167","208","325","-117"
"1995","Missouri","3","8","0","0.27273","186","311","-125"
"1996","Missouri","5","6","0","0.45455","278","376","-98"
"1997","Missouri","7","5","0","0.58333","392","367","25"
"1998","Missouri","8","4","0","0.66667","334","236","98"
"1999","Missouri","4","7","0","0.36364","224","371","-147"
"2000","Missouri","3","8","0","0.27273","255","348","-93"
"1977","Hawaii","5","6","0","0.45455","250","233","17"
"1978","Hawaii","6","5","0","0.54545","251","280","-29"
"1979","Hawaii","6","5","0","0.54545","330","213","117"
"1980","Hawaii","8","3","0","0.72727","260","212","48"
"1981","Hawaii","9","2","0","0.81818","328","130","198"
"1982","Hawaii","6","5","0","0.54545","240","230","10"
"1983","Hawaii","5","5","1","0.50000","251","236","15"
"1984","Hawaii","7","4","0","0.63636","217","181","36"
"1985","Hawaii","4","6","2","0.41667","269","262","7"
"1986","Hawaii","7","5","0","0.58333","238","235","3"
"1987","Arizona","4","4","3","0.50000","263","220","43"
"1988","Arizona","7","4","0","0.63636","279","218","61"
"1989","Arizona","8","4","0","0.66667","248","178","70"
"1990","Arizona","7","5","0","0.58333","267","311","-44"
"1991","Arizona","4","7","0","0.36364","248","361","-113"
"1992","Arizona","6","5","1","0.54167","232","118","114"
"1993","Arizona","10","2","0","0.83333","294","161","133"
"1994","Arizona","8","4","0","0.66667","278","190","88"
"1995","Arizona","6","5","0","0.54545","207","199","8"
"1996","Arizona","5","6","0","0.45455","310","280","30"
"1997","Arizona","7","5","0","0.58333","317","312","5"
"1998","Arizona","12","1","0","0.92308","439","236","203"
"1999","Arizona","6","6","0","0.50000","339","364","-25"
"2000","Arizona","5","6","0","0.45455","254","237","17"
"2005","San Jose St. (CA)","3","8","0","0.27273","248","357","-109"
"2006","San Jose St. (CA)","9","4","0","0.69231","324","270","54"
"2007","San Jose St. (CA)","5","7","0","0.41667","245","352","-107"
"2008","San Jose St. (CA)","6","6","0","0.50000","224","259","-35"
"2009","San Jose St. (CA)","2","10","0","0.16667","165","414","-249"
"1978","Wake Forest (NC)","1","10","0","0.09091","104","274","-170"
"1979","Wake Forest (NC)","8","4","0","0.66667","240","283","-43"
"1980","Wake Forest (NC)","5","6","0","0.45455","251","213","38"
"1988","Illinois","6","5","1","0.54167","245","243","2"
"1989","Illinois","10","2","0","0.83333","332","182","150"
"1990","Illinois","8","4","0","0.66667","293","246","47"
"1991","Illinois","6","5","0","0.54545","261","182","79"
"1992","Texas","6","5","0","0.54545","292","282","10"
"1993","Texas","5","5","1","0.50000","281","269","12"
"1994","Texas","8","4","0","0.66667","366","291","75"
"1995","Texas","10","2","1","0.80769","390","255","135"
"1996","Texas","8","5","0","0.61538","447","305","142"
"1997","Texas","4","7","0","0.36364","283","366","-83"
"2001","Arizona","5","6","0","0.45455","320","377","-57"
"2002","Arizona","4","8","0","0.33333","227","310","-83"
"2003","Arizona","1","4","0","0.20000","82","186","-104"
"2003","Arizona","1","6","0","0.14286","99","243","-144"
"2005","Colorado","0","1","0","0.00000","10","19","-9"
"2004","Arizona","3","8","0","0.27273","164","275","-111"
"2005","Arizona","3","8","0","0.27273","252","290","-38"
"2006","Arizona","6","6","0","0.50000","199","235","-36"
"2007","Arizona","5","7","0","0.41667","336","322","14"
"2008","Arizona","8","5","0","0.61538","476","277","199"
"2009","Arizona","8","5","0","0.61538","356","311","45"
"2010","Arizona","7","6","0","0.53846","367","295","72"
"2011","Arizona","1","5","0","0.16667","164","225","-61"
"2011","Arizona","3","3","0","0.50000","205","200","5"
"1990","Glenville St. (WV)","1","7","1","0.16667","147","310","-163"
"1991","Glenville St. (WV)","4","5","1","0.45000","253","231","22"
"1992","Glenville St. (WV)","6","4","0","0.60000","334","199","135"
"1993","Glenville St. (WV)","10","3","0","0.76923","426","177","249"
"1994","Glenville St. (WV)","8","3","0","0.72727","416","291","125"
"1995","Glenville St. (WV)","8","2","0","0.80000","345","123","222"
"1996","Glenville St. (WV)","6","4","0","0.60000","348","309","39"
"2001","West Virginia","3","8","0","0.27273","235","268","-33"
"2002","West Virginia","9","4","0","0.69231","396","302","94"
"2003","West Virginia","8","5","0","0.61538","376","297","79"
"2004","West Virginia","8","4","0","0.66667","361","246","115"
"2005","West Virginia","11","1","0","0.91667","385","214","171"
"2006","West Virginia","11","2","0","0.84615","505","282","223"
"2007","West Virginia","10","2","0","0.83333","467","207","260"
"2008","Michigan","3","9","0","0.25000","243","347","-104"
"2009","Michigan","5","7","0","0.41667","354","330","24"
"2010","Michigan","7","6","0","0.53846","426","458","-32"
"2012","Arizona","8","5","0","0.61538","496","459","37"
"2013","Arizona","8","5","0","0.61538","435","315","120"
"1872","Stevens Tech (NJ)","0","1","0","0.00000","0","6","-6"
"1873","New York (NY)","3","3","0","0.50000","15","13","2"
"1874","Stevens Tech (NJ)","2","3","0","0.40000","10","20","-10"
"1875","Stevens Tech (NJ)","4","4","0","0.50000","21","20","1"
"1876","New York (NY)","2","3","1","0.41667","16","19","-3"
"1877","Stevens Tech (NJ)","3","1","2","0.66667","9","14","-5"
"1878","Stevens Tech (NJ)","3","3","3","0.50000","3","9","-6"
"1879","Stevens Tech (NJ)","2","3","5","0.45000","8","14","-6"
"1880","Stevens Tech (NJ)","1","5","0","0.16667","3","16","-13"
"1881","Stevens Tech (NJ)","3","8","3","0.32143","16","29","-13"
"1882","Lawrence (WI)","7","8","1","0.46875","17","25","-8"
"1883","Stevens Tech (NJ)","7","6","1","0.53571","187","128","59"
"1884","Fordham (NY)","9","10","0","0.47368","221","261","-40"
"1885","Georgetown (DC)","5","17","1","0.23913","359","612","-253"
"1886","New York (NY)","9","15","2","0.38462","180","565","-385"
"1887","Fordham (NY)","8","12","1","0.40476","157","445","-288"
"1888","Amherst (MA)","6","17","3","0.28846","192","791","-599"
"1889","New York (NY)","8","21","4","0.30303","278","647","-369"
"1890","New York (NY)","25","14","2","0.63415","727","538","189"
"1891","Delaware","32","30","7","0.51449","966","971","-5"
"1892","Beloit (WI)","29","31","3","0.48413","726","797","-71"
"1893","Marquette (WI)","39","34","3","0.53289","1091","885","206"
"1894","Manhattan (NY)","32","29","7","0.52206","853","692","161"
"1895","Delaware","44","35","6","0.55294","889","813","76"
"1896","Manhattan (NY)","51","49","6","0.50943","949","1164","-215"
"1897","Stevens Tech (NJ)","37","50","4","0.42857","661","1048","-387"
"1898","Manhattan (NY)","37","43","9","0.46629","781","1050","-269"
"1899","Manhattan (NY)","34","40","6","0.46250","594","1063","-469"
"1900","Manhattan (NY)","43","47","11","0.48020","991","1049","-58"
"1901","Ferris St. (MI)","51","44","7","0.53431","906","852","54"
"1902","Indiana St.","56","48","5","0.53670","1053","927","126"
"1903","Manhattan (NY)","30","49","7","0.38953","762","1319","-557"
"1904","Saint Francis (NY)","44","53","9","0.45755","787","1363","-576"
"1905","Bluffton (OH)","38","59","5","0.39706","850","1433","-583"
"1906","Ferris St. (MI)","32","43","12","0.43678","677","854","-177"
"1907","Ferris St. (MI)","32","48","10","0.41111","722","1208","-486"
"1908","Western Illinois","36","45","10","0.45055","760","1069","-309"
"1909","Delaware Valley (PA)","27","52","2","0.34568","682","1287","-605"
"1910","East Stroudsburg (PA)","23","31","3","0.42982","583","738","-155"
"1911","Western Illinois","32","44","7","0.42771","661","902","-241"
"1912","Indiana (PA)","36","56","7","0.39899","1134","1463","-329"
"1913","Saint Francis (NY)","52","67","8","0.44094","1672","2360","-688"
"1914","Delaware Valley (PA)","41","50","6","0.45361","1217","1585","-368"
"1915","Western Illinois","34","35","11","0.49375","932","1217","-285"
"1916","Morgan St. (MD)","44","43","7","0.50532","1493","1270","223"
"1917","Morgan St. (MD)","21","21","2","0.50000","408","883","-475"
"1918","Oklahoma Baptist University","7","16","2","0.32000","258","358","-100"
"1919","Western Illinois","53","41","8","0.55882","1478","1056","422"
"1920","Virginia Union","28","39","2","0.42029","506","893","-387"
"1921","Cooper Union (NY)","19","34","3","0.36607","441","1112","-671"
"1922","Cooper Union (NY)","27","34","6","0.44776","703","832","-129"
"1923","Cooper Union (NY)","31","45","2","0.41026","718","1112","-394"
"1924","East Stroudsburg (PA)","34","40","6","0.46250","946","1175","-229"
"1925","Saint Anselm (NH)","32","28","10","0.52857","847","802","45"
"1926","Saint Anselm (NH)","22","30","4","0.42857","515","702","-187"
"1927","Bethune-Cookman (FL)","20","29","8","0.42105","674","783","-109"
"1928","Saint Anselm (NH)","28","24","7","0.53390","564","1095","-531"
"1929","Saint Anselm (NH)","25","32","5","0.44355","616","843","-227"
"1930","Saint Anselm (NH)","31","27","10","0.52941","643","549","94"
"1931","Campbell (NC)","21","17","4","0.54762","465","428","37"
"1932","Campbell (NC)","7","30","3","0.21250","254","760","-506"
"1933","Campbell (NC)","11","13","3","0.46296","262","324","-62"
"1934","Bowie St. (MD)","4","7","2","0.38462","116","94","22"
"1935","Florida Southern","7","12","1","0.37500","170","162","8"
"1936","Bowie St. (MD)","5","2","1","0.68750","154","97","57"
"1937","Bowie St. (MD)","6","3","0","0.66667","98","87","11"
"1938","West Alabama","7","5","0","0.58333","151","88","63"
"1939","Elizabeth City St. (NC)","7","13","0","0.35000","150","307","-157"
"1940","Elizabeth City St. (NC)","6","5","4","0.53333","128","67","61"
"1941","Arkansas-Pine Bluff","3","9","5","0.32353","178","223","-45"
"1942","Brevard College (NC)","10","6","2","0.61111","225","189","36"
"1943","Clark Atlanta (GA)","6","8","0","0.42857","127","206","-79"
"1944","Abilene Christian (TX)","9","11","1","0.45238","158","255","-97"
"1945","Benedict (SC)","10","15","2","0.40741","299","296","3"
"1946","Elizabeth City St. (NC)","7","20","3","0.28333","144","540","-396"
"1947","Clark Atlanta (GA)","3","6","2","0.36364","49","230","-181"
"1948","Virginia-Lynchburg","4","6","1","0.40909","77","302","-225"
"1949","Virginia-Lynchburg","0","3","1","0.12500","7","70","-63"
"1950","Virginia-Lynchburg","2","3","0","0.40000","53","98","-45"
"1951","Lane (TN)","8","6","0","0.57143","295","234","61"
"1952","Lane (TN)","9","5","1","0.63333","220","206","14"
"1953","Lane (TN)","1","7","0","0.12500","58","215","-157"
"1954","Lane (TN)","2","6","0","0.25000","105","135","-30"
"1955","Lane (TN)","2","4","0","0.33333","83","129","-46"
"1957","Louisiana College","2","7","0","0.22222","106","179","-73"
"1959","Azusa Pacific (CA)","2","3","0","0.40000","117","90","27"
"1960","Azusa Pacific (CA)","4","3","1","0.56250","103","76","27"
"1961","Azusa Pacific (CA)","3","3","0","0.50000","123","147","-24"
"1963","San Francisco (CA)","2","5","0","0.28571","58","98","-40"
"1964","New York (NY)","0","2","0","0.00000","20","48","-28"
"1965","Adelphi (NY)","4","8","0","0.33333","198","216","-18"
"1966","Fairfield (CT)","18","22","2","0.45238","545","652","-107"
"1967","La Salle (PA)","25","31","0","0.44643","846","1080","-234"
"1968","Centenary (LA)","17","42","2","0.29508","726","1393","-667"
"1969","Bluffton (OH)","33","43","0","0.43421","1058","1548","-490"
"1970","Saint John's (NY)","35","54","1","0.39444","1379","1783","-404"
"1971","Bluffton (OH)","43","45","1","0.48876","1360","1384","-24"
"1972","Marquette (WI)","39","44","2","0.47059","1217","1351","-134"
"1973","Brooklyn (NY)","30","52","1","0.36747","1007","1611","-604"
"1974","Marquette (WI)","33","36","3","0.47917","959","1169","-210"
"1975","Marquette (WI)","31","22","4","0.57895","1042","932","110"
"1976","Bluffton (OH)","23","33","1","0.41228","862","1186","-324"
"1977","Manhattan (NY)","14","28","1","0.33721","568","923","-355"
"1978","Fairfield (CT)","5","7","1","0.42308","194","203","-9"
"1979","Fairfield (CT)","7","8","0","0.46667","247","260","-13"
"1980","Westfield St. (MA)","6","5","4","0.53333","184","196","-12"
"1981","San Francisco (CA)","17","14","0","0.54839","567","498","69"
"1982","Manhattan (NY)","18","16","0","0.52941","580","644","-64"
"1983","SUNY-Stony Brook (NY)","15","11","0","0.57692","474","453","21"
"1984","Stonehill (MA)","7","12","0","0.36842","231","439","-208"
"1985","Manhattan (NY)","10","10","0","0.50000","313","316","-3"
"1986","Marquette (WI)","13","17","0","0.43333","497","564","-67"
"1987","Marquette (WI)","10","17","0","0.37037","389","487","-98"
"1988","Marquette (WI)","1","5","0","0.16667","80","125","-45"
"1989","Marquette (WI)","4","4","0","0.50000","209","151","58"
"1990","Marquette (WI)","1","7","0","0.12500","80","180","-100"
"1991","Marquette (WI)","1","5","0","0.16667","106","182","-76"
"1992","Marquette (WI)","2","5","0","0.28571","81","129","-48"
"1993","Marquette (WI)","7","1","0","0.87500","212","126","86"
"1994","Marquette (WI)","1","6","0","0.14286","125","184","-59"
"1995","Marquette (WI)","3","4","0","0.42857","141","191","-50"
"1996","Marquette (WI)","3","5","0","0.37500","139","182","-43"
"1998","Madison College (WI)","2","15","0","0.11765","221","613","-392"
"1999","Marquette (WI)","0","7","0","0.00000","110","298","-188"
"2000","Marquette (WI)","1","5","0","0.16667","60","96","-36"
"2001","Marquette (WI)","2","6","0","0.25000","144","179","-35"
"2002","Marquette (WI)","3","4","0","0.42857","127","208","-81"
"2003","Marquette (WI)","1","6","0","0.14286","71","151","-80"
"2004","Marquette (WI)","0","6","0","0.00000","53","238","-185"
"2005","Marquette (WI)","2","5","0","0.28571","92","226","-134"
"2006","Marquette (WI)","1","6","0","0.14286","62","206","-144"
"2007","Marquette (WI)","2","5","0","0.28571","140","215","-75"
"2008","Marquette (WI)","0","7","0","0.00000","61","304","-243"
"2009","Marquette (WI)","0","1","0","0.00000","0","22","-22"
"1896","Arizona St.","0","1","0","0.00000","20","38","-18"
"1899","Arizona St.","3","0","0","1.00000","23","2","21"
"1900","Arizona St.","1","2","0","0.33333","10","11","-1"
"1902","Arizona St.","2","1","0","0.66667","73","12","61"
"1903","Arizona St.","2","0","0","1.00000","33","0","33"
"1904","Arizona St.","4","0","0","1.00000","116","0","116"
"1905","Arizona St.","0","3","0","0.00000","8","28","-20"
"1906","Arizona St.","0","2","0","0.00000","6","22","-16"
"1914","Arizona St.","4","3","0","0.57143","143","91","52"
"1915","Arizona St.","3","2","0","0.60000","125","36","89"
"1916","Arizona St.","0","3","0","0.00000","13","51","-38"
"1919","Arizona St.","0","2","0","0.00000","3","104","-101"
"1922","Northern Colorado","1","4","1","0.25000","24","58","-34"
"1923","Northern Colorado","2","3","1","0.41667","59","138","-79"
"1924","Northern Colorado","2","5","0","0.28571","56","162","-106"
"1925","Northern Colorado","2","6","1","0.27778","126","106","20"
"1926","Northern Colorado","6","4","0","0.60000","145","83","62"
"1927","Northern Colorado","2","7","0","0.22222","57","214","-157"
"1922","Arizona St.","0","3","1","0.12500","31","74","-43"
"1924","Chadron St. (NE)","8","1","0","0.88889","205","18","187"
"1923","Arizona St.","4","2","0","0.66667","152","102","50"
"1924","Arizona St.","6","1","1","0.81250","160","85","75"
"1925","Arizona St.","6","2","0","0.75000","154","59","95"
"1926","Arizona St.","4","1","1","0.75000","97","42","55"
"1927","Arizona St.","2","3","1","0.41667","63","50","13"
"1928","Arizona St.","3","2","1","0.58333","133","73","60"
"1929","Arizona St.","0","6","0","0.00000","13","143","-130"
"1930","Arizona St.","3","5","1","0.38889","111","94","17"
"1931","Arizona St.","6","2","0","0.75000","170","66","104"
"1932","Arizona St.","4","3","1","0.56250","182","92","90"
"1937","New Mexico","4","4","1","0.50000","69","93","-24"
"1938","New Mexico","8","3","0","0.72727","199","72","127"
"1939","New Mexico","8","2","0","0.80000","167","98","69"
"1940","New Mexico","5","4","0","0.55556","166","94","72"
"1941","New Mexico","5","4","1","0.55000","116","135","-19"
"1949","Montana","5","4","0","0.55556","179","200","-21"
"1950","Montana","5","5","0","0.50000","227","147","80"
"1951","Montana","2","7","0","0.22222","108","266","-158"
"1928","Northern Arizona","7","1","0","0.87500","275","37","238"
"1929","Northern Arizona","5","0","0","1.00000","129","13","116"
"1930","Northern Arizona","4","2","1","0.64286","113","68","45"
"1931","Northern Arizona","3","5","0","0.37500","83","126","-43"
"1932","Northern Arizona","3","2","2","0.57143","40","31","9"
"1933","Arizona St.","3","5","0","0.37500","73","125","-52"
"1934","Arizona St.","4","3","1","0.56250","91","113","-22"
"1935","Arizona St.","2","5","1","0.31250","29","66","-37"
"1936","Arizona St.","4","5","0","0.44444","83","109","-26"
"1937","Arizona St.","0","8","1","0.05556","32","140","-108"
"1938","Arizona St.","3","6","0","0.33333","89","98","-9"
"1939","Arizona St.","8","2","1","0.77273","212","56","156"
"1940","Arizona St.","7","2","2","0.72727","198","99","99"
"1941","Arizona St.","5","5","1","0.50000","111","137","-26"
"1947","Idaho","4","4","0","0.50000","92","138","-46"
"1948","Idaho","3","6","0","0.33333","154","156","-2"
"1949","Idaho","3","5","0","0.37500","220","270","-50"
"1950","Idaho","3","5","1","0.38889","180","212","-32"
"1942","Arizona St.","2","8","0","0.20000","53","235","-182"
"1946","Arizona St.","2","7","2","0.27273","93","313","-220"
"1947","Arizona St.","4","7","0","0.36364","168","234","-66"
"1948","Arizona St.","5","5","0","0.50000","276","192","84"
"1949","Arizona St.","7","3","0","0.70000","342","204","138"
"1950","Arizona St.","9","2","0","0.81818","404","154","250"
"1951","Rhode Island","3","5","0","0.37500","130","133","-3"
"1957","Arizona","1","8","1","0.15000","125","299","-174"
"1958","Arizona","3","7","0","0.30000","83","276","-193"
"1971","Holy Cross (MA)","4","6","0","0.40000","188","239","-51"
"1972","Holy Cross (MA)","5","4","1","0.55000","187","182","5"
"1973","Holy Cross (MA)","5","6","0","0.45455","221","221","0"
"1974","Holy Cross (MA)","5","5","1","0.50000","182","219","-37"
"1975","Holy Cross (MA)","1","10","0","0.09091","119","274","-155"
"1947","Pacific (CA)","10","1","0","0.90909","373","111","262"
"1948","Pacific (CA)","7","1","2","0.80000","356","147","209"
"1949","Pacific (CA)","11","0","0","1.00000","575","66","509"
"1950","Pacific (CA)","7","3","1","0.68182","348","131","217"
"1951","Arizona St.","6","3","1","0.65000","308","176","132"
"1948","Indiana","2","7","0","0.22222","75","217","-142"
"1949","Indiana","1","8","0","0.11111","117","254","-137"
"1950","Indiana","3","5","1","0.38889","99","155","-56"
"1951","Indiana","2","7","0","0.22222","118","191","-73"
"1952","Arizona St.","6","3","0","0.66667","247","121","126"
"1953","Arizona St.","4","5","1","0.45000","207","203","4"
"1954","Arizona St.","5","5","0","0.50000","178","228","-50"
"1955","Arizona St.","8","2","1","0.77273","343","107","236"
"1956","Arizona St.","9","1","0","0.90000","306","83","223"
"1957","Arizona St.","10","0","0","1.00000","397","66","331"
"1958","Missouri","5","4","1","0.55000","164","141","23"
"1959","Missouri","6","5","0","0.54545","125","124","1"
"1960","Missouri","11","0","0","1.00000","295","93","202"
"1961","Missouri","7","2","1","0.75000","124","57","67"
"1962","Missouri","8","1","2","0.81818","204","62","142"
"1963","Missouri","7","3","0","0.70000","151","86","65"
"1964","Missouri","6","3","1","0.65000","142","88","54"
"1965","Missouri","8","2","1","0.77273","223","101","122"
"1966","Missouri","6","3","1","0.65000","121","116","5"
"1967","Missouri","7","3","0","0.70000","134","76","58"
"1968","Missouri","8","3","0","0.72727","308","136","172"
"1969","Missouri","9","2","0","0.81818","365","191","174"
"1970","Missouri","5","6","0","0.45455","243","223","20"
"1975","Notre Dame (IN)","8","3","0","0.72727","244","144","100"
"1976","Notre Dame (IN)","9","3","0","0.75000","294","158","136"
"1977","Notre Dame (IN)","11","1","0","0.91667","420","139","281"
"1978","Notre Dame (IN)","9","3","0","0.75000","293","197","96"
"1979","Notre Dame (IN)","7","4","0","0.63636","243","197","46"
"1980","Notre Dame (IN)","9","2","1","0.79167","248","128","120"
"1958","Arizona St.","7","3","0","0.70000","271","131","140"
"1959","Arizona St.","10","1","0","0.90909","272","150","122"
"1960","Arizona St.","7","3","0","0.70000","223","120","103"
"1961","Arizona St.","7","3","0","0.70000","287","163","124"
"1962","Arizona St.","7","2","1","0.75000","304","126","178"
"1963","Arizona St.","8","1","0","0.88889","249","122","127"
"1964","Arizona St.","8","2","0","0.80000","230","125","105"
"1965","Arizona St.","6","4","0","0.60000","132","142","-10"
"1966","Arizona St.","5","5","0","0.50000","166","174","-8"
"1967","Arizona St.","8","2","0","0.80000","350","210","140"
"1968","Arizona St.","8","2","0","0.80000","414","163","251"
"1969","Arizona St.","8","2","0","0.80000","383","179","204"
"1970","Arizona St.","11","0","0","1.00000","405","148","257"
"1971","Arizona St.","11","1","0","0.91667","462","201","261"
"1972","Arizona St.","10","2","0","0.83333","562","296","266"
"1973","Arizona St.","11","1","0","0.91667","519","171","348"
"1974","Arizona St.","7","5","0","0.58333","267","163","104"
"1975","Arizona St.","12","0","0","1.00000","347","127","220"
"1976","Arizona St.","4","7","0","0.36364","223","241","-18"
"1977","Arizona St.","9","3","0","0.75000","399","196","203"
"1978","Arizona St.","9","3","0","0.75000","347","236","111"
"1979","Arizona St.","0","5","0","0.00000","118","55","63"
"1979","Arizona St.","1","6","0","0.14286","188","153","35"
"2013","Chapman (CA)","8","1","0","0.88889","405","183","222"
"1966","Fresno St. (CA)","7","3","0","0.70000","158","214","-56"
"1967","Fresno St. (CA)","3","8","0","0.27273","240","267","-27"
"1968","Fresno St. (CA)","7","4","0","0.63636","269","226","43"
"1969","Fresno St. (CA)","6","4","0","0.60000","237","227","10"
"1970","Fresno St. (CA)","8","4","0","0.66667","289","273","16"
"1971","Fresno St. (CA)","6","5","0","0.54545","215","165","50"
"1972","Fresno St. (CA)","6","4","1","0.59091","237","158","79"
"1973","San Jose St. (CA)","5","4","2","0.54545","193","173","20"
"1974","San Jose St. (CA)","8","3","1","0.70833","323","199","124"
"1975","San Jose St. (CA)","9","2","0","0.81818","291","152","139"
"1976","Michigan St.","4","6","1","0.40909","236","278","-42"
"1977","Michigan St.","7","3","1","0.68182","260","162","98"
"1978","Michigan St.","8","3","0","0.72727","411","170","241"
"1979","Michigan St.","5","6","0","0.45455","240","253","-13"
"1980","Arizona St.","7","4","0","0.63636","311","216","95"
"1981","Arizona St.","9","2","0","0.81818","394","193","201"
"1982","Arizona St.","10","2","0","0.83333","294","145","149"
"1983","Arizona St.","6","4","1","0.59091","320","200","120"
"1984","Arizona St.","5","6","0","0.45455","297","203","94"
"1977","Tulsa (OK)","3","8","0","0.27273","192","398","-206"
"1978","Tulsa (OK)","9","2","0","0.81818","289","203","86"
"1979","Tulsa (OK)","6","5","0","0.54545","195","221","-26"
"1980","Tulsa (OK)","8","3","0","0.72727","243","196","47"
"1981","Tulsa (OK)","6","5","0","0.54545","304","196","108"
"1982","Tulsa (OK)","10","1","0","0.90909","342","196","146"
"1983","Tulsa (OK)","8","3","0","0.72727","297","185","112"
"1984","Tulsa (OK)","6","5","0","0.54545","261","206","55"
"1985","Arizona St.","8","4","0","0.66667","285","168","117"
"1986","Arizona St.","10","1","1","0.87500","379","167","212"
"1987","Arizona St.","7","4","1","0.62500","334","263","71"
"1988","Ohio St.","4","6","1","0.40909","229","283","-54"
"1989","Ohio St.","8","4","0","0.66667","339","297","42"
"1990","Ohio St.","7","4","1","0.62500","349","220","129"
"1991","Ohio St.","8","4","0","0.66667","277","187","90"
"1992","Ohio St.","8","3","1","0.70833","271","158","113"
"1993","Ohio St.","10","1","1","0.87500","351","193","158"
"1994","Ohio St.","9","4","0","0.69231","336","211","125"
"1995","Ohio St.","11","2","0","0.84615","475","220","255"
"1996","Ohio St.","11","1","0","0.91667","455","131","324"
"1997","Ohio St.","10","3","0","0.76923","394","170","224"
"1998","Ohio St.","11","1","0","0.91667","430","144","286"
"1999","Ohio St.","6","6","0","0.50000","285","287","-2"
"2000","Ohio St.","8","4","0","0.66667","331","222","109"
"1988","Arizona St.","6","5","0","0.54545","192","277","-85"
"1989","Arizona St.","6","4","1","0.59091","241","258","-17"
"1990","Arizona St.","4","7","0","0.36364","272","294","-22"
"1991","Arizona St.","6","5","0","0.54545","218","210","8"
"1976","Utah St.","3","8","0","0.27273","170","263","-93"
"1977","Utah St.","4","7","0","0.36364","177","249","-72"
"1978","Utah St.","7","4","0","0.63636","269","214","55"
"1979","Utah St.","8","2","1","0.77273","347","270","77"
"1980","Utah St.","6","5","0","0.54545","290","255","35"
"1981","Utah St.","5","5","1","0.50000","204","210","-6"
"1982","Utah St.","5","6","0","0.45455","192","262","-70"
"1987","California","3","6","2","0.36364","239","267","-28"
"1988","California","5","5","1","0.50000","243","244","-1"
"1989","California","4","7","0","0.36364","200","288","-88"
"1990","California","7","4","1","0.62500","325","341","-16"
"1991","California","10","2","0","0.83333","443","239","204"
"1992","Arizona St.","6","5","0","0.54545","235","185","50"
"1993","Arizona St.","6","5","0","0.54545","282","248","34"
"1994","Arizona St.","3","8","0","0.27273","242","347","-105"
"1995","Arizona St.","6","5","0","0.54545","308","330","-22"
"1996","Arizona St.","11","1","0","0.91667","488","216","272"
"1997","Arizona St.","9","3","0","0.75000","324","210","114"
"1998","Arizona St.","5","6","0","0.45455","333","338","-5"
"1999","Arizona St.","7","5","0","0.58333","285","311","-26"
"2000","Arizona St.","6","6","0","0.50000","313","303","10"
"1998","Boise St. (ID)","6","5","0","0.54545","329","350","-21"
"1999","Boise St. (ID)","10","3","0","0.76923","430","277","153"
"2000","Boise St. (ID)","10","2","0","0.83333","532","274","258"
"2001","Arizona St.","4","7","0","0.36364","374","361","13"
"2002","Arizona St.","8","6","0","0.57143","452","407","45"
"2003","Arizona St.","5","7","0","0.41667","298","328","-30"
"2004","Arizona St.","9","3","0","0.75000","358","294","64"
"2005","Arizona St.","7","5","0","0.58333","442","359","83"
"2006","Arizona St.","7","6","0","0.53846","348","326","22"
"1982","Idaho","9","4","0","0.69231","397","299","98"
"1983","Idaho","8","3","0","0.72727","347","257","90"
"1984","Idaho","6","5","0","0.54545","363","283","80"
"1985","Idaho","9","3","0","0.75000","441","247","194"
"1986","Wyoming","6","6","0","0.50000","299","272","27"
"1987","Washington St.","3","7","1","0.31818","238","356","-118"
"1988","Washington St.","9","3","0","0.75000","415","303","112"
"1989","Miami (FL)","11","1","0","0.91667","426","127","299"
"1990","Miami (FL)","10","2","0","0.83333","447","184","263"
"1991","Miami (FL)","12","0","0","1.00000","386","100","286"
"1992","Miami (FL)","11","1","0","0.91667","369","161","208"
"1993","Miami (FL)","9","3","0","0.75000","331","167","164"
"1994","Miami (FL)","10","2","0","0.83333","365","143","222"
"1999","Oregon St.","7","5","0","0.58333","347","277","70"
"2000","Oregon St.","11","1","0","0.91667","400","212","188"
"2001","Oregon St.","5","6","0","0.45455","287","259","28"
"2002","Oregon St.","8","5","0","0.61538","414","267","147"
"2006","Idaho","4","8","0","0.33333","203","417","-214"
"2007","Arizona St.","10","3","0","0.76923","420","292","128"
"2008","Arizona St.","5","7","0","0.41667","274","272","2"
"2009","Arizona St.","4","8","0","0.33333","268","253","15"
"2010","Arizona St.","6","6","0","0.50000","387","300","87"
"2011","Arizona St.","6","7","0","0.46154","431","372","59"
"2006","Rice (TX)","7","6","0","0.53846","350","432","-82"
"2007","Tulsa (OK)","10","4","0","0.71429","576","467","109"
"2008","Tulsa (OK)","11","3","0","0.78571","661","391","270"
"2009","Tulsa (OK)","5","7","0","0.41667","351","328","23"
"2010","Tulsa (OK)","10","3","0","0.76923","538","394","144"
"2011","Pittsburgh (PA)","6","6","0","0.50000","309","269","40"
"2012","Arizona St.","8","5","0","0.61538","499","316","183"
"2013","Arizona St.","10","4","0","0.71429","556","373","183"
"1894","Arkansas","2","1","0","0.66667","80","54","26"
"1895","Arkansas","1","0","0","1.00000","30","0","30"
"1896","Arkansas","2","1","0","0.66667","16","36","-20"
"1897","Arkansas","2","0","1","0.83333","42","6","36"
"1898","Arkansas","2","1","0","0.66667","37","42","-5"
"1899","Arkansas","3","1","1","0.70000","37","21","16"
"1900","Arkansas","2","1","1","0.62500","36","23","13"
"1895","Nebraska","6","3","0","0.66667","138","62","76"
"1901","Arkansas","3","5","0","0.37500","98","52","46"
"1902","Arkansas","6","3","0","0.66667","148","73","75"
"1903","Arkansas","3","4","0","0.42857","50","63","-13"
"1904","Arkansas","4","5","0","0.44444","68","133","-65"
"1905","Arkansas","2","6","0","0.25000","32","50","-18"
"1906","Arkansas","2","4","2","0.37500","45","71","-26"
"1907","Arkansas","3","4","1","0.43750","73","110","-37"
"1909","Notre Dame (IN)","7","0","1","0.93750","236","14","222"
"1910","Notre Dame (IN)","4","1","1","0.75000","192","25","167"
"1906","Oregon","5","0","1","0.91667","50","10","40"
"1908","Arkansas","5","4","0","0.55556","213","120","93"
"1909","Arkansas","7","0","0","1.00000","186","18","168"
"1910","Arkansas","7","1","0","0.87500","221","19","202"
"1911","Arkansas","6","2","1","0.72222","268","23","245"
"1912","Arkansas","4","6","0","0.40000","149","179","-30"
"1913","Oregon","3","3","1","0.50000","132","54","78"
"1914","Oregon","4","2","1","0.64286","113","30","83"
"1915","Oregon","6","2","0","0.75000","169","53","116"
"1916","Oregon","7","0","1","0.93750","244","17","227"
"1917","Oregon","4","3","0","0.57143","73","74","-1"
"1918","Penn St.","1","2","1","0.37500","22","66","-44"
"1919","Penn St.","7","1","0","0.87500","173","33","140"
"1920","Penn St.","7","0","2","0.88889","259","35","224"
"1921","Penn St.","8","0","2","0.90000","251","56","195"
"1922","Penn St.","6","4","1","0.59091","185","62","123"
"1923","Penn St.","6","2","1","0.72222","159","46","113"
"1924","Penn St.","6","3","1","0.65000","202","65","137"
"1925","Penn St.","4","4","1","0.50000","67","66","1"
"1926","Penn St.","5","4","0","0.55556","200","83","117"
"1927","Penn St.","6","2","1","0.72222","163","81","82"
"1928","Penn St.","3","5","1","0.38889","93","68","25"
"1929","Penn St.","6","3","0","0.66667","101","75","26"
"1949","Delaware Valley (PA)","3","5","0","0.37500","96","144","-48"
"1913","Arkansas","7","2","0","0.77778","137","43","94"
"1914","Arkansas","3","6","0","0.33333","96","206","-110"
"1914","Doane (NE)","4","2","2","0.62500","68","67","1"
"1915","Arkansas","4","2","1","0.64286","121","55","66"
"1916","Arkansas","4","4","0","0.50000","261","124","137"
"1913","Baylor (TX)","4","5","2","0.45455","74","222","-148"
"1917","Arkansas","5","1","1","0.78571","118","27","91"
"1918","Arkansas","3","2","0","0.60000","41","121","-80"
"1920","Iowa St.","4","4","0","0.50000","98","48","50"
"1919","Arkansas","3","4","0","0.42857","55","164","-109"
"1919","Emporia St. (KS)","1","6","2","0.22222","60","101","-41"
"1920","Arkansas","3","2","2","0.57143","42","22","20"
"1921","Arkansas","5","3","1","0.61111","144","48","96"
"1922","Cincinnati (OH)","1","7","1","0.16667","35","175","-140"
"1923","Cincinnati (OH)","6","3","0","0.66667","157","71","86"
"1924","Cincinnati (OH)","2","6","1","0.27778","54","164","-110"
"1925","Cincinnati (OH)","4","5","0","0.44444","65","122","-57"
"1926","Cincinnati (OH)","3","5","1","0.38889","96","152","-56"
"1927","Wyoming","4","5","0","0.44444","122","105","17"
"1928","Wyoming","2","7","0","0.22222","106","224","-118"
"1929","Wyoming","1","7","0","0.12500","33","160","-127"
"1919","Tulsa (OK)","8","0","1","0.94444","591","27","564"
"1920","Tulsa (OK)","10","0","1","0.95455","621","21","600"
"1921","Tulsa (OK)","6","3","0","0.66667","257","95","162"
"1922","Arkansas","4","5","0","0.44444","143","136","7"
"1923","Arkansas","7","2","1","0.75000","178","40","138"
"1924","Arkansas","7","2","1","0.75000","227","69","158"
"1925","Arkansas","4","4","1","0.50000","95","62","33"
"1926","Arkansas","5","5","0","0.50000","179","88","91"
"1927","Arkansas","8","1","0","0.88889","218","76","142"
"1928","Arkansas","7","2","0","0.77778","251","63","188"
"1929","Texas Christian","9","0","1","0.95000","249","33","216"
"1930","Texas Christian","9","2","1","0.79167","298","49","249"
"1931","Texas Christian","8","2","1","0.77273","119","41","78"
"1932","Texas Christian","10","0","1","0.95455","283","23","260"
"1933","Texas Christian","9","2","1","0.79167","208","49","159"
"1934","Ohio St.","7","1","0","0.87500","267","34","233"
"1935","Ohio St.","7","1","0","0.87500","237","57","180"
"1936","Ohio St.","5","3","0","0.62500","160","27","133"
"1937","Ohio St.","6","2","0","0.75000","125","23","102"
"1938","Ohio St.","4","3","1","0.56250","119","65","54"
"1939","Ohio St.","6","2","0","0.75000","189","64","125"
"1940","Ohio St.","4","4","0","0.50000","99","113","-14"
"1941","Idaho","4","5","0","0.44444","123","135","-12"
"1942","Idaho","3","7","0","0.30000","96","209","-113"
"1929","Arkansas","7","2","0","0.77778","230","93","137"
"1930","Arkansas","3","6","0","0.33333","78","154","-76"
"1931","Arkansas","3","5","1","0.38889","82","126","-44"
"1932","Arkansas","1","6","2","0.22222","65","133","-68"
"1933","Arkansas","7","3","1","0.68182","213","61","152"
"1934","Arkansas","4","4","2","0.50000","95","76","19"
"1935","Arkansas","5","5","0","0.50000","152","109","43"
"1936","Arkansas","7","3","0","0.70000","178","87","91"
"1937","Arkansas","6","2","2","0.70000","186","89","97"
"1938","Arkansas","2","7","1","0.25000","128","125","3"
"1939","Arkansas","4","5","1","0.45000","115","117","-2"
"1940","Arkansas","4","6","0","0.40000","112","174","-62"
"1941","Arkansas","3","7","0","0.30000","118","149","-31"
"1949","Missouri St.","5","4","1","0.55000","183","201","-18"
"1950","Missouri St.","5","4","2","0.54545","224","203","21"
"1951","Missouri St.","6","3","1","0.65000","150","152","-2"
"1952","Missouri St.","3","6","0","0.33333","119","157","-38"
"1942","Arkansas","3","7","0","0.30000","89","228","-139"
"1943","Arkansas","2","7","0","0.22222","105","192","-87"
"1944","Arkansas","5","5","1","0.50000","120","161","-41"
"1945","Arkansas","3","7","0","0.30000","112","222","-110"
"1941","Tennessee","8","2","0","0.80000","182","73","109"
"1942","Tennessee","9","1","1","0.86364","259","61","198"
"1944","Tennessee","7","1","1","0.83333","173","73","100"
"1945","Tennessee","8","1","0","0.88889","238","52","186"
"1946","Arkansas","6","3","2","0.63636","136","92","44"
"1947","Arkansas","6","4","1","0.59091","191","145","46"
"1948","Arkansas","5","5","0","0.50000","227","136","91"
"1949","Arkansas","5","5","0","0.50000","167","175","-8"
"1941","Akron (OH)","5","3","1","0.61111","114","76","38"
"1942","Akron (OH)","0","7","2","0.11111","26","183","-157"
"1950","Arkansas","2","8","0","0.20000","156","163","-7"
"1951","Arkansas","5","5","0","0.50000","178","162","16"
"1952","Arkansas","2","8","0","0.20000","166","282","-116"
"1947","Wyoming","4","5","0","0.44444","175","168","7"
"1948","Wyoming","4","5","0","0.44444","270","145","125"
"1949","Wyoming","9","1","0","0.90000","381","65","316"
"1950","Wyoming","10","0","0","1.00000","363","59","304"
"1951","Wyoming","7","2","1","0.75000","220","82","138"
"1952","Wyoming","5","4","0","0.55556","114","102","12"
"1953","Arkansas","3","7","0","0.30000","116","161","-45"
"1954","Arkansas","8","3","0","0.72727","195","104","91"
"1955","Tennessee","6","3","1","0.65000","188","92","96"
"1956","Tennessee","10","1","0","0.90909","275","88","187"
"1957","Tennessee","8","3","0","0.72727","164","75","89"
"1958","Tennessee","4","6","0","0.40000","77","122","-45"
"1959","Tennessee","5","4","1","0.55000","112","118","-6"
"1960","Tennessee","6","2","2","0.70000","209","79","130"
"1961","Tennessee","6","4","0","0.60000","221","149","72"
"1962","Tennessee","4","6","0","0.40000","179","134","45"
"1953","Wichita St. (KS)","4","4","1","0.50000","172","110","62"
"1954","Wichita St. (KS)","9","1","0","0.90000","325","86","239"
"1955","Arkansas","5","4","1","0.55000","126","114","12"
"1956","Arkansas","6","4","0","0.60000","160","155","5"
"1957","Arkansas","6","4","0","0.60000","187","134","53"
"1958","Kansas","4","5","1","0.45000","87","175","-88"
"1959","Kansas","5","5","0","0.50000","163","134","29"
"1960","Kansas","5","4","1","0.55000","219","89","130"
"1961","Kansas","7","3","1","0.68182","269","88","181"
"1962","Kansas","6","3","1","0.65000","214","116","98"
"1963","Kansas","5","5","0","0.50000","207","122","85"
"1964","Kansas","6","4","0","0.60000","136","146","-10"
"1965","Kansas","2","8","0","0.20000","119","215","-96"
"1966","Kansas","2","7","1","0.25000","106","188","-82"
"1957","Missouri","5","4","1","0.55000","149","157","-8"
"1958","Arkansas","4","6","0","0.40000","147","150","-3"
"1959","Arkansas","9","2","0","0.81818","163","101","62"
"1960","Arkansas","8","3","0","0.72727","185","87","98"
"1961","Arkansas","8","3","0","0.72727","183","97","86"
"1962","Arkansas","9","2","0","0.81818","299","115","184"
"1963","Arkansas","5","5","0","0.50000","179","96","83"
"1964","Arkansas","11","0","0","1.00000","231","64","167"
"1965","Arkansas","10","1","0","0.90909","331","118","213"
"1966","Arkansas","8","2","0","0.80000","218","73","145"
"1967","Arkansas","4","5","1","0.45000","200","149","51"
"1968","Arkansas","10","1","0","0.90909","350","189","161"
"1969","Arkansas","9","2","0","0.81818","353","103","250"
"1970","Arkansas","9","2","0","0.81818","402","144","258"
"1971","Arkansas","8","3","1","0.70833","356","169","187"
"1972","Arkansas","6","5","0","0.54545","228","227","1"
"1973","Arkansas","5","5","1","0.50000","124","184","-60"
"1974","Arkansas","6","4","1","0.59091","285","164","121"
"1975","Arkansas","10","2","0","0.83333","336","123","213"
"1976","Arkansas","5","5","1","0.50000","220","204","16"
"1969","William & Mary (VA)","3","7","0","0.30000","146","250","-104"
"1970","William & Mary (VA)","5","7","0","0.41667","218","335","-117"
"1971","William & Mary (VA)","5","6","0","0.45455","278","241","37"
"1972","North Carolina St.","8","3","1","0.70833","409","240","169"
"1973","North Carolina St.","9","3","0","0.75000","396","251","145"
"1974","North Carolina St.","9","2","1","0.79167","317","241","76"
"1975","North Carolina St.","7","4","1","0.62500","260","210","50"
"1977","Arkansas","11","1","0","0.91667","389","101","288"
"1978","Arkansas","9","2","1","0.79167","336","147","189"
"1979","Arkansas","10","2","0","0.83333","284","132","152"
"1980","Arkansas","7","5","0","0.58333","272","236","36"
"1981","Arkansas","8","4","0","0.66667","325","219","106"
"1982","Arkansas","9","2","1","0.79167","303","139","164"
"1983","Arkansas","6","5","0","0.54545","204","172","32"
"1984","Minnesota","4","7","0","0.36364","194","316","-122"
"1985","Minnesota","6","5","0","0.54545","273","227","46"
"1986","Notre Dame (IN)","5","6","0","0.45455","299","219","80"
"1987","Notre Dame (IN)","8","4","0","0.66667","339","218","121"
"1988","Notre Dame (IN)","12","0","0","1.00000","393","156","237"
"1989","Notre Dame (IN)","12","1","0","0.92308","427","189","238"
"1990","Notre Dame (IN)","9","3","0","0.75000","359","259","100"
"1991","Notre Dame (IN)","10","3","0","0.76923","465","289","176"
"1992","Notre Dame (IN)","10","1","1","0.87500","437","181","256"
"1993","Notre Dame (IN)","11","1","0","0.91667","427","215","212"
"1994","Notre Dame (IN)","6","5","1","0.54167","342","280","62"
"1995","Notre Dame (IN)","9","3","0","0.75000","392","247","145"
"1996","Notre Dame (IN)","8","3","0","0.72727","407","181","226"
"1999","South Carolina","0","11","0","0.00000","87","278","-191"
"2000","South Carolina","8","4","0","0.66667","283","181","102"
"2001","South Carolina","9","3","0","0.75000","310","230","80"
"2002","South Carolina","5","7","0","0.41667","225","262","-37"
"2003","South Carolina","5","7","0","0.41667","268","314","-46"
"2004","South Carolina","6","5","0","0.54545","243","229","14"
"1979","Air Force (CO)","2","9","0","0.18182","127","253","-126"
"1980","Air Force (CO)","2","9","1","0.20833","161","290","-129"
"1981","Air Force (CO)","4","7","0","0.36364","171","252","-81"
"1982","Air Force (CO)","8","5","0","0.61538","395","367","28"
"1983","Air Force (CO)","10","2","0","0.83333","367","221","146"
"1984","Arkansas","7","4","1","0.62500","268","159","109"
"1985","Arkansas","10","2","0","0.83333","323","146","177"
"1986","Arkansas","9","3","0","0.75000","311","184","127"
"1987","Arkansas","9","4","0","0.69231","300","219","81"
"1988","Arkansas","10","2","0","0.83333","349","190","159"
"1989","Arkansas","10","2","0","0.83333","385","230","155"
"1990","Clemson (SC)","10","2","0","0.83333","333","109","224"
"1991","Clemson (SC)","9","2","1","0.79167","317","185","132"
"1992","Clemson (SC)","5","6","0","0.45455","261","213","48"
"1993","Clemson (SC)","8","3","0","0.72727","184","179","5"
"1994","Rice (TX)","5","6","0","0.45455","206","203","3"
"1995","Rice (TX)","2","8","1","0.22727","215","284","-69"
"1996","Rice (TX)","7","4","0","0.63636","296","312","-16"
"1997","Rice (TX)","7","4","0","0.63636","306","285","21"
"1998","Rice (TX)","5","6","0","0.45455","235","257","-22"
"1999","Rice (TX)","5","6","0","0.45455","237","261","-24"
"2000","Rice (TX)","3","8","0","0.27273","237","322","-85"
"2001","Rice (TX)","8","4","0","0.66667","333","335","-2"
"2002","Rice (TX)","4","7","0","0.36364","253","296","-43"
"2003","Rice (TX)","5","7","0","0.41667","343","378","-35"
"2004","Rice (TX)","3","8","0","0.27273","279","377","-98"
"2005","Rice (TX)","1","10","0","0.09091","241","447","-206"
"1977","West Alabama","2","8","0","0.20000","91","225","-134"
"1978","West Alabama","3","7","0","0.30000","128","238","-110"
"1990","Arkansas","3","8","0","0.27273","263","360","-97"
"1991","Arkansas","6","6","0","0.50000","175","203","-28"
"1992","Arkansas","0","1","0","0.00000","3","10","-7"
"2000","Jacksonville St. (AL)","4","6","0","0.40000","170","234","-64"
"2001","Jacksonville St. (AL)","5","6","0","0.45455","349","305","44"
"2002","Jacksonville St. (AL)","5","6","0","0.45455","229","298","-69"
"2003","Jacksonville St. (AL)","8","4","0","0.66667","316","278","38"
"2004","Jacksonville St. (AL)","9","2","0","0.81818","412","233","179"
"2005","Jacksonville St. (AL)","6","5","0","0.54545","292","224","68"
"2006","Jacksonville St. (AL)","6","5","0","0.54545","285","193","92"
"2007","Jacksonville St. (AL)","6","5","0","0.54545","305","257","48"
"2008","Jacksonville St. (AL)","8","3","0","0.72727","349","239","110"
"2009","Jacksonville St. (AL)","8","3","0","0.72727","385","188","197"
"2010","Jacksonville St. (AL)","9","3","0","0.75000","386","300","86"
"2011","Jacksonville St. (AL)","7","4","0","0.63636","324","295","29"
"2012","Jacksonville St. (AL)","6","5","0","0.54545","322","357","-35"
"1992","Arkansas","3","6","1","0.35000","169","199","-30"
"2006","Alabama","0","1","0","0.00000","31","34","-3"
"1978","Clemson (SC)","1","0","0","1.00000","17","15","2"
"1979","Clemson (SC)","8","4","0","0.66667","205","116","89"
"1980","Clemson (SC)","6","5","0","0.54545","217","222","-5"
"1981","Clemson (SC)","12","0","0","1.00000","338","105","233"
"1982","Clemson (SC)","9","1","1","0.86364","289","147","142"
"1983","Clemson (SC)","9","1","1","0.86364","338","200","138"
"1984","Clemson (SC)","7","4","0","0.63636","346","215","131"
"1985","Clemson (SC)","6","6","0","0.50000","244","222","22"
"1986","Clemson (SC)","8","2","2","0.75000","296","187","109"
"1987","Clemson (SC)","10","2","0","0.83333","333","176","157"
"1988","Clemson (SC)","10","2","0","0.83333","342","157","185"
"1989","Clemson (SC)","10","2","0","0.83333","368","138","230"
"1993","Arkansas","6","4","1","0.59091","165","208","-43"
"1994","Arkansas","4","7","0","0.36364","212","213","-1"
"1995","Arkansas","8","5","0","0.61538","284","283","1"
"1996","Arkansas","4","7","0","0.36364","174","267","-93"
"1997","Arkansas","4","7","0","0.36364","181","284","-103"
"1993","Murray St. (KY)","4","7","0","0.36364","201","279","-78"
"1994","Murray St. (KY)","5","6","0","0.45455","262","321","-59"
"1995","Murray St. (KY)","11","1","0","0.91667","455","149","306"
"1996","Murray St. (KY)","11","2","0","0.84615","463","206","257"
"1997","Boise St. (ID)","5","6","0","0.45455","285","358","-73"
"1998","Arkansas","9","3","0","0.75000","390","227","163"
"1999","Arkansas","8","4","0","0.66667","353","214","139"
"2000","Arkansas","6","6","0","0.50000","278","289","-11"
"2001","Arkansas","7","5","0","0.58333","294","279","15"
"2002","Arkansas","9","5","0","0.64286","370","277","93"
"2003","Arkansas","9","4","0","0.69231","436","305","131"
"2004","Arkansas","5","6","0","0.45455","328","270","58"
"2005","Arkansas","4","7","0","0.36364","283","271","12"
"2006","Arkansas","10","4","0","0.71429","404","256","148"
"2007","Arkansas","8","4","0","0.66667","478","307","171"
"2008","Mississippi","9","4","0","0.69231","417","247","170"
"2009","Mississippi","9","4","0","0.69231","384","230","154"
"2010","Mississippi","4","8","0","0.33333","367","422","-55"
"2011","Mississippi","2","10","0","0.16667","193","385","-192"
"2007","Arkansas","0","1","0","0.00000","7","38","-31"
"2003","Louisville (KY)","9","4","0","0.69231","450","361","89"
"2004","Louisville (KY)","11","1","0","0.91667","597","236","361"
"2005","Louisville (KY)","9","3","0","0.75000","521","285","236"
"2006","Louisville (KY)","12","1","0","0.92308","491","212","279"
"2008","Arkansas","5","7","0","0.41667","263","374","-111"
"2009","Arkansas","8","5","0","0.61538","468","326","142"
"2010","Arkansas","10","3","0","0.76923","474","304","170"
"2011","Arkansas","11","2","0","0.84615","478","289","189"
"2013","Western Kentucky","8","4","0","0.66667","370","295","75"
"1989","Idaho","9","3","0","0.75000","407","314","93"
"1990","Idaho","9","4","0","0.69231","477","342","135"
"1991","Idaho","6","5","0","0.54545","375","313","62"
"1992","Idaho","9","3","0","0.75000","466","247","219"
"1993","Idaho","11","3","0","0.78571","593","353","240"
"1994","Idaho","9","3","0","0.75000","493","289","204"
"1995","Utah St.","4","7","0","0.36364","293","287","6"
"1996","Utah St.","6","5","0","0.54545","330","339","-9"
"1997","Utah St.","6","6","0","0.50000","389","296","93"
"1998","Louisville (KY)","7","5","0","0.58333","473","435","38"
"1999","Louisville (KY)","7","5","0","0.58333","443","365","78"
"2000","Louisville (KY)","9","3","0","0.75000","405","268","137"
"2001","Louisville (KY)","11","2","0","0.84615","394","223","171"
"2002","Louisville (KY)","7","6","0","0.53846","374","319","55"
"2003","Michigan St.","8","5","0","0.61538","363","293","70"
"2004","Michigan St.","5","7","0","0.41667","353","326","27"
"2005","Michigan St.","5","6","0","0.45455","372","316","56"
"2006","Michigan St.","4","8","0","0.33333","302","341","-39"
"2012","Arkansas","4","8","0","0.33333","282","365","-83"
"2013","Fort Lewis (CO)","4","7","0","0.36364","161","334","-173"
"2006","Wisconsin","12","1","0","0.92308","380","157","223"
"2007","Wisconsin","9","4","0","0.69231","383","301","82"
"2008","Wisconsin","7","6","0","0.53846","357","345","12"
"2009","Wisconsin","10","3","0","0.76923","413","283","130"
"2010","Wisconsin","11","2","0","0.84615","539","267","272"
"2011","Wisconsin","11","3","0","0.78571","618","266","352"
"2012","Wisconsin","8","5","0","0.61538","400","248","152"
"2013","Arkansas","3","9","0","0.25000","248","369","-121"
"1911","Arkansas St.","1","1","0","0.50000","12","11","1"
"1912","Arkansas St.","3","1","0","0.75000","39","20","19"
"1913","Arkansas St.","5","2","1","0.68750","254","39","215"
"1914","Arkansas St.","5","4","0","0.55556","148","156","-8"
"1915","Arkansas St.","4","1","1","0.75000","99","13","86"
"1916","Arkansas St.","4","3","0","0.57143","72","51","21"
"1917","Arkansas St.","4","2","1","0.64286","157","54","103"
"1872","Stevens Tech (NJ)","0","1","0","0.00000","0","6","-6"
"1873","New York (NY)","3","3","0","0.50000","15","13","2"
"1874","Stevens Tech (NJ)","2","3","0","0.40000","10","20","-10"
"1875","Stevens Tech (NJ)","4","4","0","0.50000","21","20","1"
"1876","New York (NY)","2","3","1","0.41667","16","19","-3"
"1877","Stevens Tech (NJ)","3","1","2","0.66667","9","14","-5"
"1878","Stevens Tech (NJ)","3","3","3","0.50000","3","9","-6"
"1879","Stevens Tech (NJ)","2","3","5","0.45000","8","14","-6"
"1880","Stevens Tech (NJ)","1","5","0","0.16667","3","16","-13"
"1881","Stevens Tech (NJ)","3","8","3","0.32143","16","29","-13"
"1882","Lawrence (WI)","7","8","1","0.46875","17","25","-8"
"1883","Stevens Tech (NJ)","7","6","1","0.53571","187","128","59"
"1884","Fordham (NY)","9","10","0","0.47368","221","261","-40"
"1885","Georgetown (DC)","5","17","1","0.23913","359","612","-253"
"1886","New York (NY)","9","15","2","0.38462","180","565","-385"
"1887","Fordham (NY)","8","12","1","0.40476","157","445","-288"
"1888","Amherst (MA)","6","17","3","0.28846","192","791","-599"
"1889","New York (NY)","8","21","4","0.30303","278","647","-369"
"1890","New York (NY)","25","14","2","0.63415","727","538","189"
"1891","Delaware","32","30","7","0.51449","966","971","-5"
"1892","Beloit (WI)","29","31","3","0.48413","726","797","-71"
"1893","Marquette (WI)","39","34","3","0.53289","1091","885","206"
"1894","Manhattan (NY)","32","29","7","0.52206","853","692","161"
"1895","Delaware","44","35","6","0.55294","889","813","76"
"1896","Manhattan (NY)","51","49","6","0.50943","949","1164","-215"
"1897","Stevens Tech (NJ)","37","50","4","0.42857","661","1048","-387"
"1898","Manhattan (NY)","37","43","9","0.46629","781","1050","-269"
"1899","Manhattan (NY)","34","40","6","0.46250","594","1063","-469"
"1900","Manhattan (NY)","43","47","11","0.48020","991","1049","-58"
"1901","Ferris St. (MI)","51","44","7","0.53431","906","852","54"
"1902","Indiana St.","56","48","5","0.53670","1053","927","126"
"1903","Manhattan (NY)","30","49","7","0.38953","762","1319","-557"
"1904","Saint Francis (NY)","44","53","9","0.45755","787","1363","-576"
"1905","Bluffton (OH)","38","59","5","0.39706","850","1433","-583"
"1906","Ferris St. (MI)","32","43","12","0.43678","677","854","-177"
"1907","Ferris St. (MI)","32","48","10","0.41111","722","1208","-486"
"1908","Western Illinois","36","45","10","0.45055","760","1069","-309"
"1909","Delaware Valley (PA)","27","52","2","0.34568","682","1287","-605"
"1910","East Stroudsburg (PA)","23","31","3","0.42982","583","738","-155"
"1911","Western Illinois","32","44","7","0.42771","661","902","-241"
"1912","Indiana (PA)","36","56","7","0.39899","1134","1463","-329"
"1913","Saint Francis (NY)","52","67","8","0.44094","1672","2360","-688"
"1914","Delaware Valley (PA)","41","50","6","0.45361","1217","1585","-368"
"1915","Western Illinois","34","35","11","0.49375","932","1217","-285"
"1916","Morgan St. (MD)","44","43","7","0.50532","1493","1270","223"
"1917","Morgan St. (MD)","21","21","2","0.50000","408","883","-475"
"1918","Oklahoma Baptist University","7","16","2","0.32000","258","358","-100"
"1919","Western Illinois","53","41","8","0.55882","1478","1056","422"
"1920","Virginia Union","28","39","2","0.42029","506","893","-387"
"1921","Cooper Union (NY)","19","34","3","0.36607","441","1112","-671"
"1922","Cooper Union (NY)","27","34","6","0.44776","703","832","-129"
"1923","Cooper Union (NY)","31","45","2","0.41026","718","1112","-394"
"1924","East Stroudsburg (PA)","34","40","6","0.46250","946","1175","-229"
"1925","Saint Anselm (NH)","32","28","10","0.52857","847","802","45"
"1926","Saint Anselm (NH)","22","30","4","0.42857","515","702","-187"
"1927","Bethune-Cookman (FL)","20","29","8","0.42105","674","783","-109"
"1928","Saint Anselm (NH)","28","24","7","0.53390","564","1095","-531"
"1929","Saint Anselm (NH)","25","32","5","0.44355","616","843","-227"
"1930","Saint Anselm (NH)","31","27","10","0.52941","643","549","94"
"1931","Campbell (NC)","21","17","4","0.54762","465","428","37"
"1932","Campbell (NC)","7","30","3","0.21250","254","760","-506"
"1933","Campbell (NC)","11","13","3","0.46296","262","324","-62"
"1934","Bowie St. (MD)","4","7","2","0.38462","116","94","22"
"1935","Florida Southern","7","12","1","0.37500","170","162","8"
"1936","Bowie St. (MD)","5","2","1","0.68750","154","97","57"
"1937","Bowie St. (MD)","6","3","0","0.66667","98","87","11"
"1938","West Alabama","7","5","0","0.58333","151","88","63"
"1939","Elizabeth City St. (NC)","7","13","0","0.35000","150","307","-157"
"1940","Elizabeth City St. (NC)","6","5","4","0.53333","128","67","61"
"1941","Arkansas-Pine Bluff","3","9","5","0.32353","178","223","-45"
"1942","Brevard College (NC)","10","6","2","0.61111","225","189","36"
"1943","Clark Atlanta (GA)","6","8","0","0.42857","127","206","-79"
"1944","Abilene Christian (TX)","9","11","1","0.45238","158","255","-97"
"1945","Benedict (SC)","10","15","2","0.40741","299","296","3"
"1946","Elizabeth City St. (NC)","7","20","3","0.28333","144","540","-396"
"1947","Clark Atlanta (GA)","3","6","2","0.36364","49","230","-181"
"1948","Virginia-Lynchburg","4","6","1","0.40909","77","302","-225"
"1949","Virginia-Lynchburg","0","3","1","0.12500","7","70","-63"
"1950","Virginia-Lynchburg","2","3","0","0.40000","53","98","-45"
"1951","Lane (TN)","8","6","0","0.57143","295","234","61"
"1952","Lane (TN)","9","5","1","0.63333","220","206","14"
"1953","Lane (TN)","1","7","0","0.12500","58","215","-157"
"1954","Lane (TN)","2","6","0","0.25000","105","135","-30"
"1955","Lane (TN)","2","4","0","0.33333","83","129","-46"
"1957","Louisiana College","2","7","0","0.22222","106","179","-73"
"1959","Azusa Pacific (CA)","2","3","0","0.40000","117","90","27"
"1960","Azusa Pacific (CA)","4","3","1","0.56250","103","76","27"
"1961","Azusa Pacific (CA)","3","3","0","0.50000","123","147","-24"
"1963","San Francisco (CA)","2","5","0","0.28571","58","98","-40"
"1964","New York (NY)","0","2","0","0.00000","20","48","-28"
"1965","Adelphi (NY)","4","8","0","0.33333","198","216","-18"
"1966","Fairfield (CT)","18","22","2","0.45238","545","652","-107"
"1967","La Salle (PA)","25","31","0","0.44643","846","1080","-234"
"1968","Centenary (LA)","17","42","2","0.29508","726","1393","-667"
"1969","Bluffton (OH)","33","43","0","0.43421","1058","1548","-490"
"1970","Saint John's (NY)","35","54","1","0.39444","1379","1783","-404"
"1971","Bluffton (OH)","43","45","1","0.48876","1360","1384","-24"
"1972","Marquette (WI)","39","44","2","0.47059","1217","1351","-134"
"1973","Brooklyn (NY)","30","52","1","0.36747","1007","1611","-604"
"1974","Marquette (WI)","33","36","3","0.47917","959","1169","-210"
"1975","Marquette (WI)","31","22","4","0.57895","1042","932","110"
"1976","Bluffton (OH)","23","33","1","0.41228","862","1186","-324"
"1977","Manhattan (NY)","14","28","1","0.33721","568","923","-355"
"1978","Fairfield (CT)","5","7","1","0.42308","194","203","-9"
"1979","Fairfield (CT)","7","8","0","0.46667","247","260","-13"
"1980","Westfield St. (MA)","6","5","4","0.53333","184","196","-12"
"1981","San Francisco (CA)","17","14","0","0.54839","567","498","69"
"1982","Manhattan (NY)","18","16","0","0.52941","580","644","-64"
"1983","SUNY-Stony Brook (NY)","15","11","0","0.57692","474","453","21"
"1984","Stonehill (MA)","7","12","0","0.36842","231","439","-208"
"1985","Manhattan (NY)","10","10","0","0.50000","313","316","-3"
"1986","Marquette (WI)","13","17","0","0.43333","497","564","-67"
"1987","Marquette (WI)","10","17","0","0.37037","389","487","-98"
"1988","Marquette (WI)","1","5","0","0.16667","80","125","-45"
"1989","Marquette (WI)","4","4","0","0.50000","209","151","58"
"1990","Marquette (WI)","1","7","0","0.12500","80","180","-100"
"1991","Marquette (WI)","1","5","0","0.16667","106","182","-76"
"1992","Marquette (WI)","2","5","0","0.28571","81","129","-48"
"1993","Marquette (WI)","7","1","0","0.87500","212","126","86"
"1994","Marquette (WI)","1","6","0","0.14286","125","184","-59"
"1995","Marquette (WI)","3","4","0","0.42857","141","191","-50"
"1996","Marquette (WI)","3","5","0","0.37500","139","182","-43"
"1998","Madison College (WI)","2","15","0","0.11765","221","613","-392"
"1999","Marquette (WI)","0","7","0","0.00000","110","298","-188"
"2000","Marquette (WI)","1","5","0","0.16667","60","96","-36"
"2001","Marquette (WI)","2","6","0","0.25000","144","179","-35"
"2002","Marquette (WI)","3","4","0","0.42857","127","208","-81"
"2003","Marquette (WI)","1","6","0","0.14286","71","151","-80"
"2004","Marquette (WI)","0","6","0","0.00000","53","238","-185"
"2005","Marquette (WI)","2","5","0","0.28571","92","226","-134"
"2006","Marquette (WI)","1","6","0","0.14286","62","206","-144"
"2007","Marquette (WI)","2","5","0","0.28571","140","215","-75"
"2008","Marquette (WI)","0","7","0","0.00000","61","304","-243"
"2009","Marquette (WI)","0","1","0","0.00000","0","22","-22"
"1919","Arkansas St.","2","5","0","0.28571","27","101","-74"
"1920","Arkansas St.","3","3","0","0.50000","56","97","-41"
"1921","Arkansas St.","3","2","1","0.58333","47","33","14"
"1926","Ouachita Baptist (AR)","6","0","1","0.92857","207","7","200"
"1927","Ouachita Baptist (AR)","6","1","2","0.77778","140","71","69"
"1928","Ouachita Baptist (AR)","5","3","1","0.61111","157","63","94"
"1929","Ouachita Baptist (AR)","3","4","2","0.44444","106","118","-12"
"1930","Ouachita Baptist (AR)","5","3","1","0.61111","119","39","80"
"1931","Arkansas-Monticello","7","2","1","0.75000","210","39","171"
"1932","Arkansas-Monticello","2","5","2","0.33333","51","104","-53"
"1933","Arkansas-Monticello","2","3","2","0.42857","46","79","-33"
"1922","Arkansas St.","0","8","0","0.00000","0","466","-466"
"1923","Arkansas St.","0","6","1","0.07143","0","164","-164"
"1931","Marshall (WV)","6","3","0","0.66667","214","84","130"
"1932","Marshall (WV)","6","2","1","0.72222","161","58","103"
"1933","Marshall (WV)","3","5","1","0.38889","109","103","6"
"1934","Marshall (WV)","3","6","0","0.33333","93","111","-18"
"1924","Arkansas St.","4","5","0","0.44444","101","89","12"
"1925","Arkansas St.","4","3","1","0.56250","76","120","-44"
"1926","Arkansas St.","4","3","1","0.56250","60","69","-9"
"1927","Arkansas St.","4","3","0","0.57143","61","67","-6"
"1928","Arkansas St.","3","3","1","0.50000","105","65","40"
"1929","Arkansas St.","2","5","0","0.28571","60","137","-77"
"1930","Arkansas St.","1","4","3","0.31250","20","84","-64"
"1931","Arkansas St.","6","2","0","0.75000","98","53","45"
"1932","Arkansas St.","3","4","0","0.42857","98","73","25"
"1933","Arkansas St.","2","4","2","0.37500","34","79","-45"
"1915","Creighton (NE)","3","3","1","0.50000","138","72","66"
"1916","Creighton (NE)","4","1","2","0.71429","107","38","69"
"1917","Creighton (NE)","6","2","1","0.72222","207","48","159"
"1918","Creighton (NE)","3","0","0","1.00000","107","7","100"
"1919","Creighton (NE)","4","0","2","0.83333","113","6","107"
"1920","Beloit (WI)","4","3","0","0.57143","92","48","44"
"1921","Beloit (WI)","5","2","1","0.68750","71","115","-44"
"1922","Beloit (WI)","3","3","1","0.50000","124","53","71"
"1923","Beloit (WI)","6","1","1","0.81250","139","54","85"
"1924","Beloit (WI)","4","3","1","0.56250","84","81","3"
"1925","Beloit (WI)","6","2","0","0.75000","124","44","80"
"1930","Georgetown (DC)","5","5","0","0.50000","138","107","31"
"1931","Georgetown (DC)","4","5","1","0.45000","78","86","-8"
"1932","Georgetown (DC)","2","3","0","0.40000","46","70","-24"
"1934","Arkansas St.","2","5","1","0.31250","31","80","-49"
"1935","Arkansas St.","2","7","0","0.22222","38","196","-158"
"1936","Arkansas St.","3","5","0","0.37500","54","188","-134"
"1937","Arkansas St.","1","5","0","0.16667","16","267","-251"
"1938","Arkansas St.","3","3","0","0.50000","54","68","-14"
"1939","Arkansas St.","4","3","0","0.57143","65","98","-33"
"1940","Arkansas St.","1","4","2","0.28571","45","98","-53"
"1941","Arkansas St.","0","7","0","0.00000","0","308","-308"
"1945","Arkansas St.","2","4","1","0.35714","51","95","-44"
"1946","Arkansas St.","4","3","3","0.55000","99","103","-4"
"1947","Arkansas St.","4","2","3","0.61111","159","91","68"
"1948","Arkansas St.","4","4","1","0.50000","131","186","-55"
"1949","Arkansas St.","4","5","0","0.44444","87","176","-89"
"1950","Arkansas St.","6","3","0","0.66667","201","179","22"
"1951","Arkansas St.","10","2","0","0.83333","456","111","345"
"1952","Arkansas St.","8","3","0","0.72727","351","123","228"
"1953","Arkansas St.","8","0","2","0.90000","239","65","174"
"1954","Toledo (OH)","6","2","1","0.72222","205","113","92"
"1955","Toledo (OH)","3","5","1","0.38889","77","213","-136"
"1934","Lehigh (PA)","4","4","0","0.50000","85","164","-79"
"1935","Lehigh (PA)","5","4","0","0.55556","157","114","43"
"1936","Lehigh (PA)","6","2","0","0.75000","119","49","70"
"1937","Lehigh (PA)","1","8","0","0.11111","65","151","-86"
"1938","Lehigh (PA)","2","5","2","0.33333","60","162","-102"
"1939","Lehigh (PA)","3","6","0","0.33333","120","168","-48"
"1940","Lehigh (PA)","2","7","0","0.22222","71","223","-152"
"1941","Lehigh (PA)","0","6","3","0.16667","60","190","-130"
"1946","Wabash (IN)","7","1","0","0.87500","144","32","112"
"1947","Wabash (IN)","5","1","2","0.75000","162","54","108"
"1948","Wabash (IN)","4","4","0","0.50000","101","71","30"
"1949","Wabash (IN)","5","2","1","0.68750","153","93","60"
"1950","Wabash (IN)","4","2","3","0.61111","158","103","55"
"1954","Arkansas St.","1","8","0","0.11111","74","353","-279"
"1955","Arkansas St.","6","3","0","0.66667","203","127","76"
"1956","Arkansas St.","5","4","0","0.55556","193","170","23"
"1957","Arkansas St.","4","5","0","0.44444","138","180","-42"
"1958","Arkansas St.","4","5","0","0.44444","162","176","-14"
"1959","Arkansas St.","3","6","0","0.33333","171","176","-5"
"1960","Arkansas St.","4","5","0","0.44444","116","137","-21"
"1961","Arkansas St.","3","6","0","0.33333","84","179","-95"
"1962","Arkansas St.","6","3","0","0.66667","146","96","50"
"1963","Arkansas St.","2","6","0","0.25000","159","174","-15"
"1964","Arkansas St.","7","0","2","0.88889","148","61","87"
"1965","Arkansas St.","6","3","0","0.66667","157","107","50"
"1966","Arkansas St.","7","2","0","0.77778","222","109","113"
"1967","Arkansas St.","4","5","0","0.44444","126","116","10"
"1968","Arkansas St.","7","3","1","0.68182","245","172","73"
"1969","Arkansas St.","8","1","1","0.85000","262","140","122"
"1970","Arkansas St.","11","0","0","1.00000","360","134","226"
"1971","Tulane (LA)","3","8","0","0.27273","152","215","-63"
"1972","Tulane (LA)","6","5","0","0.54545","212","165","47"
"1973","Tulane (LA)","9","3","0","0.75000","228","194","34"
"1974","Tulane (LA)","5","6","0","0.45455","176","214","-38"
"1975","Tulane (LA)","4","7","0","0.36364","123","192","-69"
"1971","Arkansas St.","4","4","1","0.50000","175","147","28"
"1972","Arkansas St.","3","8","0","0.27273","163","198","-35"
"1973","Arkansas St.","7","3","0","0.70000","249","166","83"
"1974","Arkansas St.","7","3","0","0.70000","215","122","93"
"1975","Arkansas St.","11","0","0","1.00000","355","81","274"
"1976","Arkansas St.","5","6","0","0.45455","274","221","53"
"1977","Arkansas St.","7","4","0","0.63636","184","214","-30"
"1978","Arkansas St.","7","4","0","0.63636","163","144","19"
"1979","Arkansas St.","4","7","0","0.36364","167","188","-21"
"1980","Arkansas St.","2","9","0","0.18182","129","269","-140"
"1981","Arkansas St.","6","5","0","0.54545","177","159","18"
"1982","Arkansas St.","5","6","0","0.45455","170","244","-74"
"1983","Arkansas St.","5","5","1","0.50000","195","226","-31"
"1984","Arkansas St.","8","4","1","0.65385","347","187","160"
"1985","Arkansas St.","9","4","0","0.69231","322","169","153"
"1986","Arkansas St.","12","2","1","0.83333","452","210","242"
"1987","Arkansas St.","8","4","1","0.65385","395","277","118"
"1988","Arkansas St.","5","6","0","0.45455","261","245","16"
"1989","Arkansas St.","5","6","0","0.45455","261","265","-4"
"1981","Wyoming","8","3","0","0.72727","344","203","141"
"1982","Wyoming","5","7","0","0.41667","267","280","-13"
"1983","Wyoming","7","5","0","0.58333","341","327","14"
"1984","Wyoming","6","6","0","0.50000","334","342","-8"
"1985","Wyoming","3","8","0","0.27273","210","371","-161"
"1990","Arkansas St.","3","7","1","0.31818","200","313","-113"
"1991","Arkansas St.","1","10","0","0.09091","189","361","-172"
"1983","Alabama","8","4","0","0.66667","366","229","137"
"1984","Alabama","5","6","0","0.45455","226","208","18"
"1985","Alabama","9","2","1","0.79167","318","181","137"
"1986","Alabama","10","3","0","0.76923","351","163","188"
"1992","Arkansas St.","2","9","0","0.18182","118","402","-284"
"1993","Arkansas St.","2","8","1","0.22727","122","274","-152"
"1994","Arkansas St.","1","10","0","0.09091","123","316","-193"
"1995","Arkansas St.","6","5","0","0.54545","265","270","-5"
"1996","Arkansas St.","4","7","0","0.36364","272","365","-93"
"1984","Jacksonville St. (AL)","4","5","1","0.45000","190","237","-47"
"1997","Arkansas St.","2","9","0","0.18182","200","394","-194"
"1998","Arkansas St.","4","8","0","0.33333","216","385","-169"
"1999","Arkansas St.","4","7","0","0.36364","246","332","-86"
"2000","Arkansas St.","1","10","0","0.09091","247","410","-163"
"2001","Arkansas St.","2","9","0","0.18182","177","357","-180"
"1994","Southern Arkansas","1","7","1","0.16667","128","184","-56"
"1995","Southern Arkansas","4","6","0","0.40000","146","219","-73"
"1996","Southern Arkansas","4","6","0","0.40000","158","218","-60"
"1997","Southern Arkansas","9","2","0","0.81818","218","118","100"
"1998","Southern Arkansas","8","2","0","0.80000","330","137","193"
"1999","Southern Arkansas","9","1","0","0.90000","270","169","101"
"2000","Northwestern St. (LA)","4","7","0","0.36364","256","236","20"
"2001","Northwestern St. (LA)","8","4","0","0.66667","319","232","87"
"2002","Arkansas St.","6","7","0","0.46154","259","361","-102"
"2003","Arkansas St.","5","7","0","0.41667","242","401","-159"
"2004","Arkansas St.","3","8","0","0.27273","215","365","-150"
"2005","Arkansas St.","6","6","0","0.50000","294","303","-9"
"2006","Arkansas St.","6","6","0","0.50000","182","289","-107"
"2007","Arkansas St.","5","7","0","0.41667","291","331","-40"
"2008","Arkansas St.","6","6","0","0.50000","324","285","39"
"2009","Arkansas St.","4","8","0","0.33333","272","279","-7"
"2010","Arkansas St.","4","8","0","0.33333","360","369","-9"
"2011","Arkansas St.","0","1","0","0.00000","20","38","-18"
"2008","Lambuth (TN)","8","4","0","0.66667","522","356","166"
"2009","Lambuth (TN)","12","1","0","0.92308","495","231","264"
"2011","Arkansas St.","10","2","0","0.83333","402","232","170"
"2012","Mississippi","7","6","0","0.53846","409","359","50"
"2013","Mississippi","8","5","0","0.61538","390","308","82"
"2012","Arkansas St.","9","3","0","0.75000","437","305","132"
"2013","Auburn (AL)","12","2","0","0.85714","553","346","207"
"2003","East Carolina (NC)","1","11","0","0.08333","217","428","-211"
"2004","East Carolina (NC)","2","9","0","0.18182","231","439","-208"
"2012","Arkansas St.","1","0","0","1.00000","17","13","4"
"2013","Arkansas St.","1","0","0","1.00000","23","20","3"
"2013","Arkansas St.","7","5","0","0.58333","356","320","36"
"1891","Army (NY)","4","1","1","0.75000","80","73","7"
"1900","Minnesota","10","0","2","0.91667","299","23","276"
"1901","Minnesota","9","1","1","0.86364","183","18","165"
"1902","Minnesota","9","2","1","0.79167","335","34","301"
"1903","Minnesota","14","0","1","0.96667","656","12","644"
"1904","Minnesota","13","0","0","1.00000","725","12","713"
"1905","Minnesota","11","1","0","0.91667","542","22","520"
"1906","Minnesota","4","1","0","0.80000","47","29","18"
"1907","Minnesota","2","2","1","0.50000","55","52","3"
"1908","Minnesota","3","2","1","0.58333","32","50","-18"
"1909","Minnesota","6","1","0","0.85714","158","27","131"
"1910","Minnesota","6","1","0","0.85714","179","6","173"
"1911","Minnesota","6","0","1","0.92857","102","15","87"
"1912","Minnesota","4","3","0","0.57143","87","38","49"
"1913","Minnesota","5","2","0","0.71429","116","32","84"
"1914","Minnesota","6","1","0","0.85714","123","44","79"
"1915","Minnesota","6","0","1","0.92857","191","35","156"
"1916","Minnesota","6","1","0","0.85714","348","28","320"
"1917","Minnesota","4","1","0","0.80000","164","25","139"
"1918","Minnesota","5","2","1","0.68750","133","39","94"
"1919","Minnesota","4","2","1","0.64286","130","45","85"
"1920","Minnesota","1","6","0","0.14286","62","92","-30"
"1921","Minnesota","3","4","0","0.42857","60","141","-81"
"1890","Army (NY)","0","1","0","0.00000","0","24","-24"
"1892","Army (NY)","3","1","1","0.70000","90","18","72"
"1893","Army (NY)","4","5","0","0.44444","84","109","-25"
"1895","Lehigh (PA)","3","6","0","0.33333","63","134","-71"
"1893","Lehigh (PA)","7","3","0","0.70000","174","84","90"
"1894","Army (NY)","3","2","0","0.60000","95","22","73"
"1895","Army (NY)","5","2","0","0.71429","141","32","109"
"1896","Army (NY)","3","2","1","0.58333","93","45","48"
"1897","Army (NY)","6","1","1","0.81250","194","41","153"
"1898","Army (NY)","3","2","1","0.58333","90","51","39"
"1899","Army (NY)","4","5","0","0.44444","57","100","-43"
"1900","Army (NY)","7","3","1","0.68182","109","68","41"
"1901","Army (NY)","5","1","2","0.75000","98","22","76"
"1902","Army (NY)","6","1","1","0.81250","180","28","152"
"1903","Army (NY)","6","2","1","0.72222","164","33","131"
"1904","Army (NY)","7","2","0","0.77778","136","27","109"
"1905","Army (NY)","4","4","1","0.50000","104","60","44"
"1906","Army (NY)","2","5","1","0.31250","47","37","10"
"1912","Army (NY)","5","3","0","0.62500","108","59","49"
"1906","Army (NY)","1","0","0","1.00000","12","0","12"
"1907","Army (NY)","6","2","1","0.72222","125","24","101"
"1908","Army (NY)","6","1","2","0.77778","87","21","66"
"1909","Army (NY)","3","2","0","0.60000","57","32","25"
"1910","Army (NY)","6","2","0","0.75000","96","12","84"
"1896","Cornell (NY)","5","3","1","0.61111","162","82","80"
"1911","Army (NY)","6","1","1","0.81250","88","11","77"
"1913","Army (NY)","8","1","0","0.88889","253","57","196"
"1914","Army (NY)","9","0","0","1.00000","219","20","199"
"1915","Army (NY)","5","3","1","0.61111","114","57","57"
"1916","Army (NY)","9","0","0","1.00000","235","36","199"
"1919","Army (NY)","6","3","0","0.66667","140","38","102"
"1920","Army (NY)","7","2","0","0.77778","314","47","267"
"1921","Army (NY)","6","4","0","0.60000","217","65","152"
"1922","Army (NY)","8","0","2","0.90000","228","27","201"
"1917","Army (NY)","7","1","0","0.87500","203","24","179"
"1918","Army (NY)","1","0","0","1.00000","20","0","20"
"1923","Army (NY)","6","2","1","0.72222","237","56","181"
"1924","Army (NY)","5","1","2","0.75000","111","41","70"
"1925","Army (NY)","7","2","0","0.77778","185","71","114"
"1926","Oregon","2","4","1","0.35714","86","88","-2"
"1927","Oregon","2","4","1","0.35714","45","69","-24"
"1928","Oregon","9","2","0","0.81818","235","59","176"
"1929","Oregon","7","3","0","0.70000","209","91","118"
"1930","Holy Cross (MA)","8","2","0","0.80000","195","45","150"
"1931","Holy Cross (MA)","7","2","1","0.75000","166","53","113"
"1932","Holy Cross (MA)","6","1","0","0.85714","101","35","66"
"1926","Army (NY)","7","1","1","0.83333","240","71","169"
"1927","Army (NY)","9","1","0","0.90000","197","37","160"
"1928","Army (NY)","8","2","0","0.80000","215","79","136"
"1929","Army (NY)","6","4","1","0.59091","276","132","144"
"1932","Louisiana St.","6","3","1","0.65000","187","31","156"
"1933","Louisiana St.","7","0","3","0.85000","176","27","149"
"1934","Louisiana St.","7","2","2","0.72727","172","77","95"
"1935","Oklahoma","6","3","0","0.66667","99","44","55"
"1936","Oklahoma","3","3","3","0.50000","84","67","17"
"1937","Nebraska","6","1","2","0.77778","99","42","57"
"1938","Nebraska","3","5","1","0.38889","68","84","-16"
"1939","Nebraska","7","1","1","0.83333","115","70","45"
"1940","Nebraska","8","2","0","0.80000","183","75","108"
"1941","Nebraska","4","5","0","0.44444","93","81","12"
"1930","Army (NY)","9","1","1","0.86364","268","22","246"
"1931","Army (NY)","8","2","1","0.77273","296","72","224"
"1932","Army (NY)","8","2","0","0.80000","261","39","222"
"1935","Mississippi St.","8","3","0","0.72727","191","77","114"
"1936","Mississippi St.","7","3","1","0.68182","232","38","194"
"1937","Mississippi St.","5","4","1","0.55000","119","117","2"
"1933","Army (NY)","9","1","0","0.90000","227","26","201"
"1934","Army (NY)","7","3","0","0.70000","215","40","175"
"1935","Army (NY)","6","2","1","0.72222","176","62","114"
"1936","Army (NY)","6","3","0","0.66667","238","71","167"
"1937","Army (NY)","7","2","0","0.77778","176","72","104"
"1938","Army (NY)","8","2","0","0.80000","243","95","148"
"1939","Army (NY)","3","4","2","0.44444","106","105","1"
"1940","Army (NY)","1","7","1","0.16667","54","197","-143"
"1934","Dartmouth (NH)","6","3","0","0.66667","177","73","104"
"1935","Dartmouth (NH)","8","2","0","0.80000","302","57","245"
"1936","Dartmouth (NH)","7","1","1","0.83333","238","53","185"
"1937","Dartmouth (NH)","7","0","2","0.88889","248","33","215"
"1938","Dartmouth (NH)","7","2","0","0.77778","254","69","185"
"1939","Dartmouth (NH)","5","3","1","0.61111","154","73","81"
"1940","Dartmouth (NH)","5","4","0","0.55556","134","82","52"
"1941","Army (NY)","5","3","1","0.61111","105","87","18"
"1942","Army (NY)","6","3","0","0.66667","149","74","75"
"1943","Army (NY)","7","2","1","0.75000","299","66","233"
"1944","Army (NY)","9","0","0","1.00000","504","35","469"
"1945","Army (NY)","9","0","0","1.00000","412","46","366"
"1946","Army (NY)","9","0","1","0.95000","263","80","183"
"1947","Army (NY)","5","2","2","0.66667","220","68","152"
"1948","Army (NY)","8","0","1","0.94444","294","89","205"
"1949","Army (NY)","9","0","0","1.00000","354","68","286"
"1950","Army (NY)","8","1","0","0.88889","267","40","227"
"1951","Army (NY)","2","7","0","0.22222","116","183","-67"
"1952","Army (NY)","4","4","1","0.50000","155","151","4"
"1953","Army (NY)","7","1","1","0.83333","210","81","129"
"1954","Army (NY)","7","2","0","0.77778","325","127","198"
"1955","Army (NY)","6","3","0","0.66667","256","72","184"
"1956","Army (NY)","5","3","1","0.61111","223","153","70"
"1957","Army (NY)","7","2","0","0.77778","251","129","122"
"1958","Army (NY)","8","0","1","0.94444","264","49","215"
"1959","Army (NY)","4","4","1","0.50000","174","141","33"
"1960","Army (NY)","6","3","1","0.65000","222","95","127"
"1961","Army (NY)","6","4","0","0.60000","224","118","106"
"1955","Louisiana St.","3","5","2","0.40000","139","149","-10"
"1956","Louisiana St.","3","7","0","0.30000","104","197","-93"
"1957","Louisiana St.","5","5","0","0.50000","159","110","49"
"1958","Louisiana St.","11","0","0","1.00000","282","53","229"
"1959","Louisiana St.","9","2","0","0.81818","164","50","114"
"1960","Louisiana St.","5","4","1","0.55000","105","50","55"
"1961","Louisiana St.","10","1","0","0.90909","259","57","202"
"1962","Army (NY)","6","4","0","0.60000","152","104","48"
"1963","Army (NY)","7","3","0","0.70000","177","97","80"
"1964","Army (NY)","4","6","0","0.40000","118","143","-25"
"1965","Army (NY)","4","5","1","0.45000","119","132","-13"
"1966","South Carolina","1","9","0","0.10000","95","216","-121"
"1967","South Carolina","5","5","0","0.50000","159","166","-7"
"1968","South Carolina","4","6","0","0.40000","214","223","-9"
"1969","South Carolina","7","4","0","0.63636","189","195","-6"
"1970","South Carolina","4","6","1","0.40909","285","253","32"
"1971","South Carolina","6","5","0","0.54545","191","196","-5"
"1972","South Carolina","4","7","0","0.36364","214","232","-18"
"1973","South Carolina","7","4","0","0.63636","347","261","86"
"1974","South Carolina","4","7","0","0.36364","223","312","-89"
"1966","Army (NY)","8","2","0","0.80000","141","105","36"
"1967","Army (NY)","8","2","0","0.80000","183","94","89"
"1968","Army (NY)","7","3","0","0.70000","270","137","133"
"1969","Army (NY)","4","5","1","0.45000","161","160","1"
"1970","Army (NY)","1","9","1","0.13636","151","281","-130"
"1971","Army (NY)","6","4","0","0.60000","146","206","-60"
"1972","Army (NY)","6","4","0","0.60000","160","282","-122"
"1973","Army (NY)","0","10","0","0.00000","67","382","-315"
"1965","Davidson (NC)","6","4","0","0.60000","175","141","34"
"1966","Davidson (NC)","4","5","0","0.44444","209","183","26"
"1967","Davidson (NC)","4","5","0","0.44444","213","222","-9"
"1968","Davidson (NC)","3","6","0","0.33333","181","223","-42"
"1969","Davidson (NC)","7","4","0","0.63636","366","274","92"
"1970","Pacific (CA)","5","6","0","0.45455","166","231","-65"
"1971","Pacific (CA)","3","8","0","0.27273","176","198","-22"
"1974","Army (NY)","3","8","0","0.27273","156","306","-150"
"1975","Army (NY)","2","9","0","0.18182","165","337","-172"
"1976","Army (NY)","5","6","0","0.45455","201","267","-66"
"1977","Army (NY)","7","4","0","0.63636","287","245","42"
"1978","Army (NY)","4","6","1","0.40909","184","255","-71"
"1955","Northwestern (IL)","0","8","1","0.05556","66","241","-175"
"1957","Western Illinois","5","4","0","0.55556","154","150","4"
"1958","Western Illinois","6","1","1","0.81250","222","109","113"
"1959","Western Illinois","9","0","0","1.00000","303","104","199"
"1966","Maryland","4","6","0","0.40000","180","204","-24"
"1977","Miami (FL)","3","8","0","0.27273","125","245","-120"
"1978","Miami (FL)","6","5","0","0.54545","194","193","1"
"1979","Army (NY)","2","8","1","0.22727","96","308","-212"
"1983","Central Florida","5","6","0","0.45455","283","306","-23"
"1984","Central Florida","1","6","0","0.14286","154","270","-116"
"2001","Chowan (NC)","3","7","0","0.30000","241","281","-40"
"2002","Chowan (NC)","0","10","0","0.00000","69","274","-205"
"1968","Idaho St.","4","5","0","0.44444","216","236","-20"
"1969","Idaho St.","5","5","0","0.50000","356","287","69"
"1970","Idaho St.","5","5","0","0.50000","257","293","-36"
"1971","Idaho St.","6","4","0","0.60000","233","201","32"
"1980","Army (NY)","3","7","1","0.31818","204","295","-91"
"1981","Army (NY)","3","7","1","0.31818","126","212","-86"
"1982","Army (NY)","4","7","0","0.36364","164","271","-107"
"1973","Arizona","8","3","0","0.72727","286","213","73"
"1974","Arizona","9","2","0","0.81818","263","174","89"
"1975","Arizona","9","2","0","0.81818","330","169","161"
"1976","Arizona","5","6","0","0.45455","283","273","10"
"1977","Purdue (IN)","5","6","0","0.45455","231","247","-16"
"1978","Purdue (IN)","9","2","1","0.79167","261","130","131"
"1979","Purdue (IN)","10","2","0","0.83333","287","226","61"
"1980","Purdue (IN)","9","3","0","0.75000","328","233","95"
"1981","Purdue (IN)","5","6","0","0.45455","242","241","1"
"1983","Army (NY)","2","9","0","0.18182","140","304","-164"
"1984","Army (NY)","8","3","1","0.70833","320","218","102"
"1985","Army (NY)","9","3","0","0.75000","396","232","164"
"1986","Army (NY)","6","5","0","0.54545","276","292","-16"
"1987","Army (NY)","5","6","0","0.45455","277","223","54"
"1988","Army (NY)","9","3","0","0.75000","336","226","110"
"1989","Army (NY)","6","5","0","0.54545","316","212","104"
"1990","Army (NY)","6","5","0","0.54545","295","264","31"
"1991","Army (NY)","4","7","0","0.36364","196","226","-30"
"1992","Army (NY)","5","6","0","0.45455","225","251","-26"
"1993","Army (NY)","6","5","0","0.54545","289","243","46"
"1994","Army (NY)","4","7","0","0.36364","215","252","-37"
"1995","Army (NY)","5","5","1","0.50000","325","211","114"
"1996","Army (NY)","10","2","0","0.83333","379","224","155"
"1997","Army (NY)","4","7","0","0.36364","221","311","-90"
"1998","Army (NY)","3","8","0","0.27273","257","325","-68"
"1999","Army (NY)","3","8","0","0.27273","225","317","-92"
"1990","Southeast Missouri St.","7","3","0","0.70000","201","180","21"
"1991","Southeast Missouri St.","3","8","0","0.27273","213","374","-161"
"1992","Southeast Missouri St.","2","9","0","0.18182","246","352","-106"
"1993","Southeast Missouri St.","3","8","0","0.27273","176","245","-69"
"1994","Southeast Missouri St.","7","5","0","0.58333","218","229","-11"
"1995","Southeast Missouri St.","5","6","0","0.45455","243","309","-66"
"1996","Southeast Missouri St.","3","8","0","0.27273","130","287","-157"
"1997","Southeast Missouri St.","4","7","0","0.36364","199","244","-45"
"1998","Southeast Missouri St.","3","8","0","0.27273","204","295","-91"
"1999","Southeast Missouri St.","3","8","0","0.27273","245","359","-114"
"2003","Army (NY)","0","7","0","0.00000","121","253","-132"
"1996","Illinois St.","3","8","0","0.27273","226","306","-80"
"1997","Illinois St.","2","9","0","0.18182","220","333","-113"
"1998","Illinois St.","8","4","0","0.66667","425","341","84"
"1999","Illinois St.","11","3","0","0.78571","487","356","131"
"2000","Army (NY)","1","10","0","0.09091","224","372","-148"
"2001","Army (NY)","3","8","0","0.27273","229","365","-136"
"2002","Army (NY)","1","11","0","0.08333","226","491","-265"
"2003","Army (NY)","0","6","0","0.00000","85","223","-138"
"2010","Louisiana-Monroe","5","7","0","0.41667","250","389","-139"
"2011","Louisiana-Monroe","4","8","0","0.33333","295","305","-10"
"2012","Louisiana-Monroe","8","5","0","0.61538","440","379","61"
"2013","Louisiana-Monroe","6","6","0","0.50000","267","362","-95"
"1973","Citadel (SC)","3","8","0","0.27273","137","250","-113"
"1974","Citadel (SC)","4","7","0","0.36364","216","248","-32"
"1975","Citadel (SC)","6","5","0","0.54545","144","97","47"
"1976","Citadel (SC)","6","5","0","0.54545","171","176","-5"
"1977","Citadel (SC)","5","6","0","0.45455","133","162","-29"
"1982","Maryland","8","4","0","0.66667","373","220","153"
"1983","Maryland","8","4","0","0.66667","316","253","63"
"1984","Maryland","9","3","0","0.75000","380","280","100"
"1985","Maryland","9","3","0","0.75000","326","192","134"
"1986","Maryland","5","5","1","0.50000","262","211","51"
"1987","Georgia Tech","2","9","0","0.18182","199","275","-76"
"1988","Georgia Tech","3","8","0","0.27273","200","194","6"
"1989","Georgia Tech","7","4","0","0.63636","265","213","52"
"1990","Georgia Tech","11","0","1","0.95833","379","186","193"
"1991","Georgia Tech","8","5","0","0.61538","283","214","69"
"2004","Army (NY)","2","9","0","0.18182","260","388","-128"
"2005","Army (NY)","4","7","0","0.36364","220","294","-74"
"2006","Army (NY)","3","9","0","0.25000","232","335","-103"
"2007","Army (NY)","3","9","0","0.25000","203","364","-161"
"2008","Army (NY)","3","9","0","0.25000","177","284","-107"
"1996","Southern Utah","4","7","0","0.36364","286","354","-68"
"2001","Cal Poly-San Luis Obispo","6","5","0","0.54545","292","248","44"
"2002","Cal Poly-San Luis Obispo","3","8","0","0.27273","247","302","-55"
"2003","Cal Poly-San Luis Obispo","7","4","0","0.63636","316","241","75"
"2004","Cal Poly-San Luis Obispo","9","2","0","0.81818","336","183","153"
"2005","Cal Poly-San Luis Obispo","9","4","0","0.69231","354","232","122"
"2006","Cal Poly-San Luis Obispo","7","4","0","0.63636","248","162","86"
"2007","Cal Poly-San Luis Obispo","7","4","0","0.63636","432","278","154"
"2008","Cal Poly-San Luis Obispo","8","3","0","0.72727","488","292","196"
"2009","Army (NY)","5","7","0","0.41667","184","263","-79"
"2010","Army (NY)","7","6","0","0.53846","346","316","30"
"2011","Army (NY)","3","9","0","0.25000","298","339","-41"
"2012","Army (NY)","2","10","0","0.16667","291","424","-133"
"2013","Army (NY)","3","9","0","0.25000","293","379","-86"
"1891","Auburn (AL)","1","0","0","1.00000","10","0","10"
"1892","Auburn (AL)","1","2","0","0.33333","32","98","-66"
"1892","Auburn (AL)","1","0","0","1.00000","32","22","10"
"1893","Purdue (IN)","5","2","1","0.68750","334","144","190"
"1894","Purdue (IN)","9","1","0","0.90000","177","42","135"
"1895","Purdue (IN)","4","3","0","0.57143","77","58","19"
"1901","Purdue (IN)","4","4","1","0.50000","138","66","72"
"1893","Auburn (AL)","2","0","2","0.75000","84","40","44"
"1894","Auburn (AL)","1","3","0","0.25000","106","48","58"
"1893","Akron (OH)","5","2","0","0.71429","276","82","194"
"1894","Akron (OH)","1","0","0","1.00000","12","6","6"
"1895","Auburn (AL)","2","1","0","0.66667","70","15","55"
"1896","Auburn (AL)","3","1","0","0.75000","135","18","117"
"1897","Auburn (AL)","2","0","1","0.83333","40","4","36"
"1898","Auburn (AL)","2","1","0","0.66667","47","47","0"
"1899","Auburn (AL)","3","1","1","0.70000","148","11","137"
"1900","Clemson (SC)","6","0","0","1.00000","222","10","212"
"1901","Clemson (SC)","3","1","1","0.70000","190","38","152"
"1902","Clemson (SC)","6","1","0","0.85714","152","22","130"
"1903","Clemson (SC)","4","1","1","0.75000","167","22","145"
"1904","Georgia Tech","8","1","1","0.85000","287","34","253"
"1905","Georgia Tech","7","0","1","0.93750","233","33","200"
"1906","Georgia Tech","6","3","1","0.65000","140","69","71"
"1907","Georgia Tech","4","4","0","0.50000","148","100","48"
"1908","Georgia Tech","6","3","0","0.66667","147","74","73"
"1909","Georgia Tech","7","2","0","0.77778","217","44","173"
"1910","Georgia Tech","5","3","0","0.62500","197","50","147"
"1911","Georgia Tech","6","2","1","0.72222","150","21","129"
"1912","Georgia Tech","5","3","1","0.61111","100","86","14"
"1913","Georgia Tech","7","2","0","0.77778","250","43","207"
"1914","Georgia Tech","6","2","0","0.75000","206","40","166"
"1915","Georgia Tech","7","0","1","0.93750","233","24","209"
"1916","Georgia Tech","8","0","1","0.94444","421","20","401"
"1917","Georgia Tech","9","0","0","1.00000","491","17","474"
"1918","Georgia Tech","6","1","0","0.85714","466","32","434"
"1919","Georgia Tech","7","3","0","0.70000","256","33","223"
"1920","Pennsylvania","6","4","0","0.60000","167","133","34"
"1921","Pennsylvania","4","3","2","0.55556","164","135","29"
"1922","Pennsylvania","6","3","0","0.66667","100","44","56"
"1924","Rice (TX)","4","4","0","0.50000","85","70","15"
"1925","Rice (TX)","4","4","1","0.50000","85","79","6"
"1926","Rice (TX)","4","4","1","0.50000","84","81","3"
"1927","Rice (TX)","2","6","1","0.27778","64","160","-96"
"1900","Auburn (AL)","4","0","0","1.00000","148","5","143"
"1901","Vanderbilt (TN)","8","4","2","0.64286","228","86","142"
"1902","Vanderbilt (TN)","8","1","0","0.88889","214","60","154"
"1902","Auburn (AL)","2","2","1","0.50000","41","17","24"
"1901","Alabama","2","1","2","0.60000","92","23","69"
"1902","Auburn (AL)","0","2","0","0.00000","5","28","-23"
"1903","Mississippi","2","1","1","0.62500","34","39","-5"
"1904","Mississippi","4","3","0","0.57143","185","106","79"
"1903","Auburn (AL)","4","3","0","0.57143","125","92","33"
"1904","Franklin & Marshall (PA)","0","10","0","0.00000","11","303","-292"
"1905","Franklin & Marshall (PA)","4","6","0","0.40000","76","250","-174"
"1904","Auburn (AL)","7","0","0","1.00000","170","11","159"
"1905","Auburn (AL)","4","4","0","0.50000","148","96","52"
"1906","Auburn (AL)","1","5","1","0.21429","24","41","-17"
"1908","Auburn (AL)","6","1","0","0.85714","158","10","148"
"1909","Auburn (AL)","6","2","0","0.75000","140","39","101"
"1910","Auburn (AL)","6","1","0","0.85714","176","9","167"
"1911","Auburn (AL)","5","2","1","0.68750","103","45","58"
"1912","Auburn (AL)","7","1","1","0.83333","206","45","161"
"1913","Auburn (AL)","8","0","0","1.00000","224","13","211"
"1914","Auburn (AL)","8","0","1","0.94444","193","0","193"
"1915","Auburn (AL)","6","2","0","0.75000","182","24","158"
"1916","Auburn (AL)","6","2","0","0.75000","191","56","135"
"1917","Auburn (AL)","6","2","1","0.72222","199","102","97"
"1918","Auburn (AL)","2","5","0","0.28571","84","116","-32"
"1919","Auburn (AL)","8","1","0","0.88889","132","33","99"
"1920","Auburn (AL)","7","2","0","0.77778","332","49","283"
"1921","Auburn (AL)","5","3","0","0.62500","162","52","110"
"1922","Auburn (AL)","8","2","0","0.80000","276","48","228"
"1923","Louisiana St.","3","5","1","0.38889","103","121","-18"
"1924","Louisiana St.","5","4","0","0.55556","124","81","43"
"1925","Louisiana St.","5","3","1","0.61111","90","70","20"
"1926","Louisiana St.","6","3","0","0.66667","128","45","83"
"1927","Louisiana St.","4","4","1","0.50000","128","83","45"
"1904","North Carolina St.","3","1","2","0.66667","89","11","78"
"1905","Colorado","8","1","0","0.88889","359","28","331"
"1906","North Carolina","1","4","2","0.28571","18","83","-65"
"1907","Auburn (AL)","6","2","1","0.72222","185","30","155"
"1909","Washington St.","4","1","0","0.80000","159","17","142"
"1923","Auburn (AL)","3","3","3","0.50000","96","58","38"
"1924","Auburn (AL)","4","4","1","0.50000","46","40","6"
"1927","Auburn (AL)","0","4","2","0.16667","24","82","-58"
"1921","Middlebury (VT)","4","4","0","0.50000","60","86","-26"
"1922","Middlebury (VT)","2","6","0","0.25000","39","137","-98"
"1923","Middlebury (VT)","3","3","2","0.50000","105","55","50"
"1924","Middlebury (VT)","7","1","0","0.87500","254","44","210"
"1925","Auburn (AL)","5","3","1","0.61111","81","114","-33"
"1926","Auburn (AL)","5","4","0","0.55556","122","85","37"
"1927","Auburn (AL)","0","3","0","0.00000","6","42","-36"
"1928","Auburn (AL)","1","8","0","0.11111","37","154","-117"
"1929","Auburn (AL)","2","3","0","0.40000","22","86","-64"
"1930","Louisiana Tech","3","6","0","0.33333","39","187","-148"
"1931","Louisiana Tech","7","0","0","1.00000","167","36","131"
"1932","Louisiana Tech","4","4","0","0.50000","113","83","30"
"1933","Louisiana Tech","1","7","0","0.12500","32","143","-111"
"1917","Middle Tennessee St.","7","0","0","1.00000","201","0","201"
"1929","Auburn (AL)","0","4","0","0.00000","6","122","-116"
"1930","Citadel (SC)","4","5","2","0.45455","60","95","-35"
"1931","Citadel (SC)","5","4","1","0.55000","93","125","-32"
"1935","Middle Tennessee St.","8","0","0","1.00000","128","25","103"
"1936","Middle Tennessee St.","7","1","0","0.87500","112","65","47"
"1937","Middle Tennessee St.","6","1","1","0.81250","134","40","94"
"1938","Middle Tennessee St.","2","6","0","0.25000","65","115","-50"
"1923","Creighton (NE)","5","5","0","0.50000","127","80","47"
"1924","Creighton (NE)","6","1","2","0.77778","182","57","125"
"1925","Creighton (NE)","6","3","1","0.65000","169","102","67"
"1926","Creighton (NE)","4","4","1","0.50000","107","107","0"
"1927","Creighton (NE)","6","1","1","0.81250","103","46","57"
"1928","Creighton (NE)","3","5","1","0.38889","86","119","-33"
"1929","Creighton (NE)","2","6","0","0.25000","68","183","-115"
"1930","Auburn (AL)","3","7","0","0.30000","101","135","-34"
"1931","Auburn (AL)","5","3","1","0.61111","114","78","36"
"1932","Auburn (AL)","9","0","1","0.95000","275","54","221"
"1933","Auburn (AL)","5","5","0","0.50000","133","104","29"
"1934","Kentucky","5","5","0","0.50000","123","86","37"
"1935","Kentucky","5","4","0","0.55556","167","94","73"
"1936","Kentucky","6","4","0","0.60000","179","84","95"
"1937","Kentucky","4","6","0","0.40000","93","130","-37"
"1929","Rice (TX)","2","7","0","0.22222","34","208","-174"
"1930","Rice (TX)","8","4","0","0.66667","135","91","44"
"1931","Rice (TX)","6","4","0","0.60000","178","66","112"
"1932","Rice (TX)","7","3","0","0.70000","141","77","64"
"1933","Rice (TX)","3","8","0","0.27273","56","137","-81"
"1934","Auburn (AL)","2","8","0","0.20000","58","107","-49"
"1935","Auburn (AL)","8","2","0","0.80000","201","46","155"
"1936","Auburn (AL)","7","2","2","0.72727","160","63","97"
"1937","Auburn (AL)","6","2","3","0.68182","127","36","91"
"1938","Auburn (AL)","4","5","1","0.45000","110","88","22"
"1939","Auburn (AL)","5","5","1","0.50000","71","69","2"
"1940","Auburn (AL)","6","4","1","0.59091","170","153","17"
"1941","Auburn (AL)","4","5","1","0.45000","123","115","8"
"1942","Auburn (AL)","6","4","1","0.59091","174","133","41"
"1939","William & Mary (VA)","6","2","1","0.72222","158","95","63"
"1940","William & Mary (VA)","6","2","1","0.72222","185","60","125"
"1941","William & Mary (VA)","8","2","0","0.80000","259","64","195"
"1942","William & Mary (VA)","9","1","1","0.86364","245","55","190"
"1944","Auburn (AL)","4","4","0","0.50000","181","137","44"
"1945","Auburn (AL)","5","5","0","0.50000","172","129","43"
"1946","Auburn (AL)","4","6","0","0.40000","132","210","-78"
"1947","Auburn (AL)","2","7","0","0.22222","78","204","-126"
"1943","Dartmouth (NH)","6","1","0","0.85714","185","39","146"
"1944","Dartmouth (NH)","2","5","1","0.31250","57","142","-85"
"1945","Merchant Marine (NY)","5","3","0","0.62500","175","127","48"
"1946","Canisius (NY)","3","3","1","0.50000","117","58","59"
"1947","Canisius (NY)","7","2","0","0.77778","199","79","120"
"1948","Auburn (AL)","1","8","1","0.15000","68","262","-194"
"1949","Auburn (AL)","2","4","3","0.38889","134","188","-54"
"1950","Auburn (AL)","0","10","0","0.00000","31","255","-224"
"1951","Auburn (AL)","5","5","0","0.50000","180","212","-32"
"1952","Auburn (AL)","2","8","0","0.20000","139","208","-69"
"1953","Auburn (AL)","7","3","1","0.68182","270","173","97"
"1954","Auburn (AL)","8","3","0","0.72727","276","86","190"
"1955","Auburn (AL)","8","2","1","0.77273","224","123","101"
"1956","Auburn (AL)","7","3","0","0.70000","174","117","57"
"1957","Auburn (AL)","10","0","0","1.00000","207","28","179"
"1958","Auburn (AL)","9","0","1","0.95000","173","62","111"
"1959","Auburn (AL)","7","3","0","0.70000","174","58","116"
"1960","Auburn (AL)","8","2","0","0.80000","155","80","75"
"1961","Auburn (AL)","6","4","0","0.60000","174","137","37"
"1962","Auburn (AL)","6","3","1","0.65000","173","168","5"
"1963","Auburn (AL)","9","2","0","0.81818","196","116","80"
"1964","Auburn (AL)","6","4","0","0.60000","123","91","32"
"1965","Auburn (AL)","5","5","1","0.50000","172","175","-3"
"1966","Auburn (AL)","4","6","0","0.40000","104","162","-58"
"1967","Auburn (AL)","6","4","0","0.60000","237","123","114"
"1968","Auburn (AL)","7","4","0","0.63636","257","159","98"
"1969","Auburn (AL)","8","3","0","0.72727","370","173","197"
"1970","Auburn (AL)","9","2","0","0.81818","390","177","213"
"1971","Auburn (AL)","9","2","0","0.81818","335","182","153"
"1972","Auburn (AL)","10","1","0","0.90909","209","141","68"
"1973","Auburn (AL)","6","6","0","0.50000","170","193","-23"
"1974","Auburn (AL)","10","2","0","0.83333","287","122","165"
"1975","Auburn (AL)","4","6","1","0.40909","174","243","-69"
"1976","Auburn (AL)","4","7","0","0.36364","194","267","-73"
"1977","Auburn (AL)","6","5","0","0.54545","204","243","-39"
"1978","Auburn (AL)","6","4","1","0.59091","238","191","47"
"1979","Auburn (AL)","8","3","0","0.72727","330","238","92"
"1980","Auburn (AL)","5","6","0","0.45455","235","238","-3"
"1974","East Carolina (NC)","7","4","0","0.63636","250","167","83"
"1975","East Carolina (NC)","8","3","0","0.72727","296","154","142"
"1976","East Carolina (NC)","9","2","0","0.81818","278","116","162"
"1977","East Carolina (NC)","8","3","0","0.72727","268","154","114"
"1978","East Carolina (NC)","9","3","0","0.75000","287","136","151"
"1979","East Carolina (NC)","7","3","1","0.68182","380","193","187"
"1980","Wyoming","6","5","0","0.54545","316","243","73"
"1981","Auburn (AL)","5","6","0","0.45455","186","166","20"
"1982","Auburn (AL)","9","3","0","0.75000","274","197","77"
"1983","Auburn (AL)","11","1","0","0.91667","311","186","125"
"1984","Auburn (AL)","9","4","0","0.69231","360","254","106"
"1985","Auburn (AL)","8","4","0","0.66667","344","208","136"
"1986","Auburn (AL)","10","2","0","0.83333","395","122","273"
"1987","Auburn (AL)","9","1","2","0.83333","314","132","182"
"1988","Auburn (AL)","10","2","0","0.83333","338","92","246"
"1989","Auburn (AL)","10","2","0","0.83333","284","131","153"
"1990","Auburn (AL)","8","3","1","0.70833","283","216","67"
"1991","Auburn (AL)","5","6","0","0.45455","233","214","19"
"1992","Auburn (AL)","5","5","1","0.50000","228","205","23"
"1987","Samford (AL)","9","1","0","0.90000","517","228","289"
"1988","Samford (AL)","5","6","0","0.45455","232","274","-42"
"1989","Samford (AL)","5","6","0","0.45455","249","330","-81"
"1990","Samford (AL)","6","4","1","0.59091","268","233","35"
"1991","Samford (AL)","12","2","0","0.85714","385","198","187"
"1992","Samford (AL)","9","3","0","0.75000","400","257","143"
"1993","Auburn (AL)","11","0","0","1.00000","353","192","161"
"1994","Auburn (AL)","9","1","1","0.86364","359","199","160"
"1995","Auburn (AL)","8","4","0","0.66667","438","283","155"
"1996","Auburn (AL)","8","4","0","0.66667","398","277","121"
"1997","Auburn (AL)","10","3","0","0.76923","340","250","90"
"1998","Auburn (AL)","1","5","0","0.16667","69","129","-60"
"2009","North Alabama","11","2","0","0.84615","513","223","290"
"2010","North Alabama","9","4","0","0.69231","378","191","187"
"2011","North Alabama","9","3","0","0.75000","381","248","133"
"2012","Akron (OH)","1","11","0","0.08333","313","428","-115"
"2013","Akron (OH)","5","7","0","0.41667","242","343","-101"
"1980","Tennessee-Chattanooga","8","3","0","0.72727","300","197","103"
"1981","Tennessee-Chattanooga","7","3","1","0.68182","217","172","45"
"1982","Tennessee-Chattanooga","7","4","0","0.63636","235","137","98"
"1983","Tennessee-Chattanooga","7","4","0","0.63636","227","167","60"
"1998","Auburn (AL)","2","3","0","0.40000","97","106","-9"
"1995","Mississippi","6","5","0","0.54545","209","208","1"
"1996","Mississippi","5","6","0","0.45455","203","270","-67"
"1997","Mississippi","8","4","0","0.66667","267","240","27"
"1998","Mississippi","6","5","0","0.54545","245","256","-11"
"1999","Auburn (AL)","5","6","0","0.45455","233","236","-3"
"2000","Auburn (AL)","9","4","0","0.69231","316","266","50"
"2001","Auburn (AL)","7","5","0","0.58333","254","281","-27"
"2002","Auburn (AL)","9","4","0","0.69231","388","231","157"
"2003","Auburn (AL)","8","5","0","0.61538","342","212","130"
"2004","Auburn (AL)","13","0","0","1.00000","417","147","270"
"2005","Auburn (AL)","9","3","0","0.75000","386","186","200"
"2006","Auburn (AL)","11","2","0","0.84615","322","181","141"
"2007","Auburn (AL)","9","4","0","0.69231","315","220","95"
"2008","Auburn (AL)","5","7","0","0.41667","208","216","-8"
"2010","Texas Tech","8","5","0","0.61538","430","402","28"
"2011","Texas Tech","5","7","0","0.41667","406","471","-65"
"2012","Texas Tech","7","5","0","0.58333","453","382","71"
"2013","Cincinnati (OH)","9","4","0","0.69231","417","273","144"
"2007","Iowa St.","3","9","0","0.25000","218","381","-163"
"2008","Iowa St.","2","10","0","0.16667","304","430","-126"
"2009","Auburn (AL)","8","5","0","0.61538","433","358","75"
"2010","Auburn (AL)","14","0","0","1.00000","577","337","240"
"2011","Auburn (AL)","8","5","0","0.61538","334","376","-42"
"2012","Auburn (AL)","3","9","0","0.25000","224","340","-116"
"2012","Arkansas St.","9","3","0","0.75000","437","305","132"
"2013","Auburn (AL)","12","2","0","0.85714","553","346","207"
"1924","Ball St. (IN)","1","3","0","0.25000","11","87","-76"
"1925","Ball St. (IN)","2","5","0","0.28571","58","132","-74"
"1926","Ball St. (IN)","5","1","1","0.78571","127","53","74"
"1927","Ball St. (IN)","5","2","1","0.68750","152","109","43"
"1928","Ball St. (IN)","3","2","2","0.57143","88","50","38"
"1929","Ball St. (IN)","0","7","0","0.00000","43","200","-157"
"1930","Ball St. (IN)","6","1","0","0.85714","131","37","94"
"1931","Ball St. (IN)","2","6","0","0.25000","65","161","-96"
"1932","Ball St. (IN)","4","4","0","0.50000","102","90","12"
"1933","Ball St. (IN)","1","6","1","0.18750","20","90","-70"
"1934","Ball St. (IN)","2","6","0","0.25000","58","100","-42"
"1935","Ball St. (IN)","3","4","1","0.43750","77","66","11"
"1936","Ball St. (IN)","3","4","1","0.43750","78","55","23"
"1937","Ball St. (IN)","5","2","1","0.68750","135","38","97"
"1938","Ball St. (IN)","6","1","1","0.81250","131","48","83"
"1939","Ball St. (IN)","6","2","0","0.75000","112","69","43"
"1940","Ball St. (IN)","3","4","1","0.43750","78","69","9"
"1941","Ball St. (IN)","3","2","2","0.57143","98","26","72"
"1942","Ball St. (IN)","6","2","0","0.75000","178","58","120"
"1944","Ball St. (IN)","2","2","0","0.50000","58","45","13"
"1945","Ball St. (IN)","4","1","1","0.75000","119","27","92"
"1946","Ball St. (IN)","3","4","1","0.43750","101","67","34"
"1947","Ball St. (IN)","5","1","2","0.75000","99","53","46"
"1948","Ball St. (IN)","6","2","0","0.75000","155","73","82"
"1949","Ball St. (IN)","8","0","0","1.00000","276","61","215"
"1950","Ball St. (IN)","2","4","1","0.35714","74","122","-48"
"1951","Ball St. (IN)","0","6","1","0.07143","94","176","-82"
"1952","Ball St. (IN)","3","5","1","0.38889","164","167","-3"
"1953","Ball St. (IN)","5","2","1","0.68750","163","125","38"
"1954","Ball St. (IN)","6","2","0","0.75000","218","113","105"
"1955","Ball St. (IN)","3","5","0","0.37500","97","144","-47"
"1956","Ball St. (IN)","4","4","0","0.50000","116","203","-87"
"1957","Ball St. (IN)","2","5","1","0.31250","119","209","-90"
"1958","Ball St. (IN)","6","2","0","0.75000","140","69","71"
"1959","Ball St. (IN)","1","7","0","0.12500","66","172","-106"
"1960","Ball St. (IN)","3","5","0","0.37500","102","113","-11"
"1961","Ball St. (IN)","2","5","1","0.31250","68","179","-111"
"1962","Ball St. (IN)","4","3","1","0.56250","138","107","31"
"1963","Ball St. (IN)","5","3","0","0.62500","156","115","41"
"1964","Ball St. (IN)","5","3","0","0.62500","175","139","36"
"1965","Ball St. (IN)","9","0","1","0.95000","309","150","159"
"1966","Ball St. (IN)","7","1","1","0.83333","207","152","55"
"1967","Ball St. (IN)","7","3","0","0.70000","262","126","136"
"1968","Ball St. (IN)","5","4","0","0.55556","189","218","-29"
"1969","Ball St. (IN)","5","5","0","0.50000","178","201","-23"
"1970","Ball St. (IN)","5","5","0","0.50000","146","226","-80"
"1971","Ball St. (IN)","4","5","1","0.45000","136","155","-19"
"1972","Ball St. (IN)","5","4","1","0.55000","235","180","55"
"1973","Ball St. (IN)","5","5","1","0.50000","226","201","25"
"1974","Ball St. (IN)","6","4","0","0.60000","265","177","88"
"1975","Ball St. (IN)","9","2","0","0.81818","244","171","73"
"1976","Ball St. (IN)","8","3","0","0.72727","257","124","133"
"1977","Ball St. (IN)","9","2","0","0.81818","377","169","208"
"1978","Wisconsin","5","4","2","0.54545","223","277","-54"
"1979","Wisconsin","4","7","0","0.36364","208","311","-103"
"1980","Wisconsin","4","7","0","0.36364","138","211","-73"
"1981","Wisconsin","7","5","0","0.58333","268","219","49"
"1982","Wisconsin","7","5","0","0.58333","287","252","35"
"1983","Wisconsin","7","4","0","0.63636","359","242","117"
"1984","Wisconsin","7","4","1","0.62500","242","206","36"
"1985","Wisconsin","5","6","0","0.45455","231","263","-32"
"1978","Ball St. (IN)","10","1","0","0.90909","251","82","169"
"1979","Ball St. (IN)","6","5","0","0.54545","272","191","81"
"1980","Ball St. (IN)","6","5","0","0.54545","239","198","41"
"1981","Ball St. (IN)","4","7","0","0.36364","157","218","-61"
"1982","Ball St. (IN)","5","6","0","0.45455","177","207","-30"
"1983","Ball St. (IN)","6","5","0","0.54545","247","302","-55"
"1984","Ball St. (IN)","3","8","0","0.27273","134","275","-141"
"1985","Ball St. (IN)","4","7","0","0.36364","203","283","-80"
"1986","Ball St. (IN)","6","5","0","0.54545","199","201","-2"
"1987","Ball St. (IN)","4","7","0","0.36364","226","255","-29"
"1988","Ball St. (IN)","8","3","0","0.72727","286","170","116"
"1989","Ball St. (IN)","7","3","2","0.66667","274","239","35"
"1990","Ball St. (IN)","7","4","0","0.63636","204","121","83"
"1991","Ball St. (IN)","6","5","0","0.54545","159","150","9"
"1992","Ball St. (IN)","5","6","0","0.45455","171","243","-72"
"1993","Ball St. (IN)","8","3","1","0.70833","301","265","36"
"1994","Ball St. (IN)","5","5","1","0.50000","276","296","-20"
"2001","Central Connecticut St.","2","7","0","0.22222","146","233","-87"
"2002","Central Connecticut St.","5","6","0","0.45455","139","251","-112"
"2003","Central Connecticut St.","3","8","0","0.27273","231","359","-128"
"1985","Butler (IN)","8","2","0","0.80000","247","138","109"
"1986","Butler (IN)","5","5","0","0.50000","258","169","89"
"1987","Butler (IN)","8","1","1","0.85000","311","149","162"
"1988","Butler (IN)","8","2","1","0.77273","304","176","128"
"1989","Butler (IN)","7","2","1","0.75000","280","205","75"
"1995","Ball St. (IN)","7","4","0","0.63636","204","187","17"
"1996","Ball St. (IN)","8","4","0","0.66667","296","210","86"
"1997","Ball St. (IN)","5","6","0","0.45455","239","260","-21"
"1998","Ball St. (IN)","1","10","0","0.09091","150","343","-193"
"1999","Ball St. (IN)","0","11","0","0.00000","157","361","-204"
"2000","Ball St. (IN)","5","6","0","0.45455","212","349","-137"
"2001","Ball St. (IN)","5","6","0","0.45455","268","296","-28"
"2002","Ball St. (IN)","6","6","0","0.50000","278","333","-55"
"2004","DePauw (IN)","8","2","0","0.80000","261","160","101"
"2007","Indiana","7","6","0","0.53846","412","370","42"
"2008","Indiana","3","9","0","0.25000","246","423","-177"
"2009","Indiana","4","8","0","0.33333","282","354","-72"
"2010","Indiana","5","7","0","0.41667","326","408","-82"
"2013","DePauw (IN)","4","6","0","0.40000","214","242","-28"
"2003","Ball St. (IN)","4","8","0","0.33333","261","386","-125"
"2004","Ball St. (IN)","2","9","0","0.18182","225","405","-180"
"2005","Ball St. (IN)","4","7","0","0.36364","233","416","-183"
"2006","Ball St. (IN)","5","7","0","0.41667","326","309","17"
"2007","Ball St. (IN)","7","6","0","0.53846","409","368","41"
"2008","Ball St. (IN)","12","1","0","0.92308","476","242","234"
"2009","San Diego St. (CA)","4","8","0","0.33333","280","366","-86"
"2010","San Diego St. (CA)","9","4","0","0.69231","455","287","168"
"2011","Michigan","11","2","0","0.84615","433","226","207"
"2012","Michigan","8","5","0","0.61538","388","258","130"
"2013","Michigan","7","6","0","0.53846","419","349","70"
"1978","Wabash (IN)","8","1","0","0.88889","171","59","112"
"1979","Wabash (IN)","8","1","0","0.88889","288","76","212"
"1980","Wabash (IN)","8","0","1","0.94444","293","57","236"
"1981","Wabash (IN)","8","1","0","0.88889","272","73","199"
"1982","Wabash (IN)","10","0","0","1.00000","293","117","176"
"1984","Marshall (WV)","6","5","0","0.54545","238","226","12"
"1985","Marshall (WV)","7","3","1","0.68182","193","197","-4"
"1986","Kansas St.","2","9","0","0.18182","134","343","-209"
"1987","Kansas St.","0","10","1","0.04545","135","421","-286"
"1988","Kansas St.","0","11","0","0.00000","171","448","-277"
"2008","Ball St. (IN)","0","1","0","0.00000","13","45","-32"
"2009","Ball St. (IN)","2","10","0","0.16667","230","338","-108"
"2010","Ball St. (IN)","4","8","0","0.33333","264","365","-101"
"2013","Eastern Michigan","1","2","0","0.33333","52","132","-80"
"2001","Lehigh (PA)","11","1","0","0.91667","427","216","211"
"2002","Lehigh (PA)","8","4","0","0.66667","319","216","103"
"2003","Lehigh (PA)","8","3","0","0.72727","330","185","145"
"2004","Lehigh (PA)","9","3","0","0.75000","345","193","152"
"2005","Lehigh (PA)","8","3","0","0.72727","399","228","171"
"2006","Elon (NC)","5","6","0","0.45455","253","256","-3"
"2007","Elon (NC)","7","4","0","0.63636","400","334","66"
"2008","Elon (NC)","8","4","0","0.66667","323","256","67"
"2009","Elon (NC)","9","3","0","0.75000","365","158","207"
"2010","Elon (NC)","6","5","0","0.54545","351","303","48"
"2011","Ball St. (IN)","6","6","0","0.50000","304","416","-112"
"2012","Ball St. (IN)","9","4","0","0.69231","437","416","21"
"2013","Ball St. (IN)","10","3","0","0.76923","501","321","180"
"1899","Baylor (TX)","2","1","1","0.62500","26","33","-7"
"1900","Baylor (TX)","3","0","0","1.00000","44","6","38"
"1901","Baylor (TX)","5","3","0","0.62500","173","61","112"
"1902","Baylor (TX)","3","4","2","0.44444","71","89","-18"
"1903","Baylor (TX)","4","3","1","0.56250","46","69","-23"
"1904","Baylor (TX)","2","5","1","0.31250","34","106","-72"
"1908","Pennsylvania","11","0","1","0.95833","215","28","187"
"1909","Oregon St.","4","2","1","0.64286","54","41","13"
"1914","West Virginia","5","4","0","0.55556","159","96","63"
"1915","West Virginia","5","2","1","0.68750","208","20","188"
"1920","South Carolina","5","4","0","0.55556","82","140","-58"
"1921","South Carolina","5","1","2","0.75000","116","28","88"
"1922","South Carolina","5","4","0","0.55556","93","69","24"
"1923","South Carolina","4","6","0","0.40000","104","77","27"
"1924","South Carolina","7","3","0","0.70000","120","48","72"
"1905","Baylor (TX)","1","6","0","0.14286","20","159","-139"
"1907","Baylor (TX)","4","3","1","0.56250","91","105","-14"
"1908","Baylor (TX)","3","5","0","0.37500","48","164","-116"
"1909","Baylor (TX)","5","3","0","0.62500","112","41","71"
"1918","Colorado","2","3","0","0.40000","43","42","1"
"1919","Colorado","2","3","1","0.41667","87","96","-9"
"1910","Baylor (TX)","6","1","1","0.81250","217","17","200"
"1911","Baylor (TX)","3","4","2","0.44444","103","53","50"
"1912","Baylor (TX)","3","5","0","0.37500","79","123","-44"
"1914","Southern California","4","3","0","0.57143","116","88","28"
"1915","Southern California","3","4","0","0.42857","132","119","13"
"1916","Drake (IA)","3","5","0","0.37500","72","162","-90"
"1917","Northern Colorado","0","11","2","0.07692","44","290","-246"
"1918","Northern Colorado","2","1","0","0.66667","35","48","-13"
"1919","Colorado School of Mines","0","4","2","0.16667","15","89","-74"
"1920","Colorado School of Mines","0","6","0","0.00000","23","104","-81"
"1921","Lake Forest (IL)","4","4","0","0.50000","111","87","24"
"1922","Lake Forest (IL)","4","3","2","0.55556","94","88","6"
"1923","Lake Forest (IL)","2","6","1","0.27778","33","161","-128"
"1913","Baylor (TX)","4","5","2","0.45455","74","222","-148"
"1917","Arkansas","5","1","1","0.78571","118","27","91"
"1918","Arkansas","3","2","0","0.60000","41","121","-80"
"1920","Iowa St.","4","4","0","0.50000","98","48","50"
"1914","Baylor (TX)","3","5","2","0.40000","70","159","-89"
"1915","Baylor (TX)","7","1","0","0.87500","188","22","166"
"1916","Baylor (TX)","9","1","0","0.90000","315","27","288"
"1917","Baylor (TX)","6","2","1","0.72222","221","41","180"
"1918","Baylor (TX)","0","6","0","0.00000","19","92","-73"
"1919","Baylor (TX)","5","3","1","0.61111","146","73","73"
"1920","Baylor (TX)","4","4","1","0.50000","65","89","-24"
"1921","Baylor (TX)","8","3","0","0.72727","214","83","131"
"1922","Baylor (TX)","8","3","0","0.72727","295","128","167"
"1923","Baylor (TX)","5","1","2","0.75000","104","39","65"
"1924","Baylor (TX)","7","2","1","0.75000","149","66","83"
"1925","Baylor (TX)","3","5","2","0.40000","79","115","-36"
"1927","Hardin-Simmons (TX)","5","3","2","0.60000","103","75","28"
"1928","Hardin-Simmons (TX)","6","6","1","0.50000","148","118","30"
"1929","Hardin-Simmons (TX)","5","4","1","0.55000","66","65","1"
"1912","Ouachita Baptist (AR)","2","2","1","0.50000","80","32","48"
"1913","Ouachita Baptist (AR)","3","2","3","0.56250","95","36","59"
"1914","Ouachita Baptist (AR)","8","0","1","0.94444","291","15","276"
"1915","Ouachita Baptist (AR)","7","1","0","0.87500","231","27","204"
"1916","Ouachita Baptist (AR)","4","2","0","0.66667","94","45","49"
"1917","Ouachita Baptist (AR)","4","0","0","1.00000","184","10","174"
"1918","Ouachita Baptist (AR)","2","1","0","0.66667","58","13","45"
"1919","Ouachita Baptist (AR)","4","1","1","0.75000","220","17","203"
"1920","Ouachita Baptist (AR)","6","1","1","0.81250","226","13","213"
"1921","Ouachita Baptist (AR)","5","3","0","0.62500","169","69","100"
"1922","Ouachita Baptist (AR)","6","1","1","0.81250","95","45","50"
"1923","Ouachita Baptist (AR)","4","3","1","0.56250","90","61","29"
"1924","Ouachita Baptist (AR)","8","0","1","0.94444","168","6","162"
"1925","Ouachita Baptist (AR)","7","0","2","0.88889","173","23","150"
"1926","Baylor (TX)","6","3","1","0.65000","103","93","10"
"1927","Baylor (TX)","2","7","0","0.22222","74","139","-65"
"1928","Baylor (TX)","8","2","0","0.80000","219","53","166"
"1929","Baylor (TX)","7","3","1","0.68182","291","106","185"
"1930","Baylor (TX)","6","3","1","0.65000","205","80","125"
"1931","Baylor (TX)","3","6","0","0.33333","100","134","-34"
"1932","Baylor (TX)","3","5","1","0.38889","77","92","-15"
"1933","Baylor (TX)","6","4","0","0.60000","85","84","1"
"1934","Baylor (TX)","3","7","0","0.30000","91","140","-49"
"1935","Baylor (TX)","8","3","0","0.72727","122","75","47"
"1936","Baylor (TX)","6","3","1","0.65000","128","90","38"
"1937","Baylor (TX)","7","3","0","0.70000","178","64","114"
"1938","Baylor (TX)","7","2","1","0.75000","165","89","76"
"1939","Baylor (TX)","7","3","0","0.70000","136","81","55"
"1940","Baylor (TX)","4","6","0","0.40000","109","114","-5"
"1935","Hardin-Simmons (TX)","6","3","1","0.65000","182","64","118"
"1936","Hardin-Simmons (TX)","9","2","0","0.81818","302","41","261"
"1937","Hardin-Simmons (TX)","8","0","1","0.94444","247","32","215"
"1938","Hardin-Simmons (TX)","8","2","0","0.80000","201","85","116"
"1939","Hardin-Simmons (TX)","7","1","1","0.83333","137","54","83"
"1940","Hardin-Simmons (TX)","9","0","0","1.00000","229","76","153"
"1941","Baylor (TX)","3","6","1","0.35000","106","161","-55"
"1942","Baylor (TX)","6","4","1","0.59091","148","116","32"
"1945","Baylor (TX)","5","5","1","0.50000","178","141","37"
"1946","Baylor (TX)","1","8","0","0.11111","56","181","-125"
"1947","West Texas A&M","7","4","0","0.63636","253","125","128"
"1948","West Texas A&M","6","5","0","0.54545","192","153","39"
"1949","West Texas A&M","5","4","0","0.55556","249","170","79"
"1950","West Texas A&M","10","1","0","0.90909","386","190","196"
"1951","West Texas A&M","2","7","0","0.22222","131","249","-118"
"1952","West Texas A&M","3","6","0","0.33333","137","243","-106"
"1953","West Texas A&M","1","8","1","0.15000","126","276","-150"
"1954","West Texas A&M","1","8","0","0.11111","146","227","-81"
"1955","West Texas A&M","4","4","1","0.50000","193","112","81"
"1956","West Texas A&M","8","2","0","0.80000","296","96","200"
"1957","West Texas A&M","7","3","0","0.70000","204","149","55"
"1947","Baylor (TX)","5","5","0","0.50000","127","138","-11"
"1948","Baylor (TX)","6","3","2","0.63636","167","125","42"
"1949","Baylor (TX)","8","2","0","0.80000","232","126","106"
"1950","Florida","5","5","0","0.50000","157","181","-24"
"1951","Florida","5","5","0","0.50000","174","131","43"
"1952","Florida","8","3","0","0.72727","304","122","182"
"1953","Florida","3","5","2","0.40000","200","113","87"
"1954","Florida","5","5","0","0.50000","115","128","-13"
"1955","Florida","4","6","0","0.40000","111","126","-15"
"1956","Florida","6","3","1","0.65000","158","98","60"
"1957","Florida","6","2","1","0.72222","133","70","63"
"1958","Florida","6","4","1","0.59091","174","100","74"
"1959","Florida","5","4","1","0.55000","169","107","62"
"1937","New Hampshire","7","1","0","0.87500","144","31","113"
"1938","New Hampshire","3","6","0","0.33333","42","112","-70"
"1939","New Hampshire","3","5","0","0.37500","71","126","-55"
"1940","New Hampshire","5","3","0","0.62500","121","86","35"
"1941","New Hampshire","4","3","1","0.56250","153","62","91"
"1946","Kansas","7","2","1","0.75000","157","145","12"
"1947","Kansas","8","1","2","0.81818","304","102","202"
"1948","Navy (MD)","0","8","1","0.05556","77","227","-150"
"1949","Navy (MD)","3","5","1","0.38889","151","238","-87"
"1950","Baylor (TX)","7","3","0","0.70000","183","128","55"
"1951","Baylor (TX)","8","2","1","0.77273","245","131","114"
"1952","Baylor (TX)","4","4","2","0.50000","187","181","6"
"1953","Baylor (TX)","7","3","0","0.70000","219","166","53"
"1954","Baylor (TX)","7","4","0","0.63636","250","174","76"
"1955","Baylor (TX)","5","5","0","0.50000","146","143","3"
"1956","Baylor (TX)","9","2","0","0.81818","202","73","129"
"1957","Baylor (TX)","3","6","1","0.35000","80","125","-45"
"1958","Baylor (TX)","3","7","0","0.30000","159","181","-22"
"1953","Johns Hopkins (MD)","2","6","0","0.25000","50","209","-159"
"1954","Johns Hopkins (MD)","2","6","0","0.25000","66","177","-111"
"1955","Johns Hopkins (MD)","2","6","0","0.25000","108","127","-19"
"1956","Johns Hopkins (MD)","4","3","1","0.56250","107","60","47"
"1959","Baylor (TX)","4","6","0","0.40000","106","154","-48"
"1960","Baylor (TX)","8","3","0","0.72727","181","91","90"
"1961","Baylor (TX)","6","5","0","0.54545","212","173","39"
"1962","Baylor (TX)","4","6","0","0.40000","159","169","-10"
"1963","Baylor (TX)","8","3","0","0.72727","205","120","85"
"1964","Baylor (TX)","5","5","0","0.50000","162","176","-14"
"1965","Baylor (TX)","5","5","0","0.50000","156","171","-15"
"1966","Baylor (TX)","5","5","0","0.50000","168","140","28"
"1967","Baylor (TX)","1","8","1","0.15000","101","199","-98"
"1968","Baylor (TX)","3","7","0","0.30000","206","322","-116"
"1969","Baylor (TX)","0","10","0","0.00000","87","344","-257"
"1970","Baylor (TX)","2","9","0","0.18182","133","259","-126"
"1971","Baylor (TX)","1","9","0","0.10000","74","236","-162"
"1969","Angelo St. (TX)","6","4","0","0.60000","232","225","7"
"1970","Angelo St. (TX)","6","4","0","0.60000","277","155","122"
"1971","Angelo St. (TX)","7","3","0","0.70000","260","146","114"
"1972","Baylor (TX)","5","6","0","0.45455","180","156","24"
"1973","Baylor (TX)","2","9","0","0.18182","192","359","-167"
"1974","Baylor (TX)","8","4","0","0.66667","252","223","29"
"1975","Baylor (TX)","3","6","2","0.36364","181","235","-54"
"1976","Baylor (TX)","7","3","1","0.68182","209","183","26"
"1977","Baylor (TX)","5","6","0","0.45455","228","220","8"
"1978","Baylor (TX)","3","8","0","0.27273","225","242","-17"
"1979","Baylor (TX)","8","4","0","0.66667","258","187","71"
"1980","Baylor (TX)","10","2","0","0.83333","317","159","158"
"1981","Baylor (TX)","5","6","0","0.45455","252","245","7"
"1982","Baylor (TX)","4","6","1","0.40909","233","261","-28"
"1983","Baylor (TX)","7","4","1","0.62500","339","266","73"
"1984","Baylor (TX)","5","6","0","0.45455","248","261","-13"
"1985","Baylor (TX)","9","3","0","0.75000","293","152","141"
"1986","Baylor (TX)","9","3","0","0.75000","325","207","118"
"1987","Baylor (TX)","6","5","0","0.54545","221","228","-7"
"1988","Baylor (TX)","6","5","0","0.54545","232","196","36"
"1989","Baylor (TX)","5","6","0","0.45455","245","190","55"
"1990","Baylor (TX)","6","4","1","0.59091","225","202","23"
"1991","Baylor (TX)","8","4","0","0.66667","282","204","78"
"1992","Baylor (TX)","7","5","0","0.58333","344","278","66"
"1993","Baylor (TX)","5","6","0","0.45455","265","331","-66"
"1994","Baylor (TX)","7","5","0","0.58333","362","277","85"
"1995","Baylor (TX)","7","4","0","0.63636","273","166","107"
"1996","Baylor (TX)","4","7","0","0.36364","266","320","-54"
"1984","Western Kentucky","2","9","0","0.18182","193","345","-152"
"1985","Western Kentucky","4","7","0","0.36364","232","313","-81"
"1986","Western Kentucky","4","6","1","0.40909","228","258","-30"
"1987","Western Kentucky","7","4","0","0.63636","263","217","46"
"1988","Western Kentucky","9","4","0","0.69231","311","220","91"
"1989","Louisiana-Monroe","5","5","1","0.50000","201","257","-56"
"1990","Louisiana-Monroe","7","5","0","0.58333","208","218","-10"
"1991","Louisiana-Monroe","7","3","1","0.68182","237","175","62"
"1992","Louisiana-Monroe","10","3","0","0.76923","490","295","195"
"1993","Louisiana-Monroe","9","3","0","0.75000","462","275","187"
"1997","Baylor (TX)","2","9","0","0.18182","200","375","-175"
"1998","Baylor (TX)","2","9","0","0.18182","195","323","-128"
"1999","Baylor (TX)","1","10","0","0.09091","137","414","-277"
"2000","Baylor (TX)","2","9","0","0.18182","139","397","-258"
"2001","Baylor (TX)","3","8","0","0.27273","205","357","-152"
"2002","Baylor (TX)","3","9","0","0.25000","202","496","-294"
"2001","Kentucky","2","9","0","0.18182","259","367","-108"
"2002","Kentucky","7","5","0","0.58333","385","301","84"
"2003","Baylor (TX)","3","9","0","0.25000","191","455","-264"
"2004","Baylor (TX)","3","8","0","0.27273","224","406","-182"
"2005","Baylor (TX)","5","6","0","0.45455","236","291","-55"
"2006","Baylor (TX)","4","8","0","0.33333","283","391","-108"
"2007","Baylor (TX)","3","9","0","0.25000","218","444","-226"
"2003","Houston (TX)","7","6","0","0.53846","448","468","-20"
"2004","Houston (TX)","3","8","0","0.27273","230","354","-124"
"2005","Houston (TX)","6","6","0","0.50000","337","324","13"
"2006","Houston (TX)","10","4","0","0.71429","462","329","133"
"2007","Houston (TX)","8","4","0","0.66667","436","359","77"
"2008","Baylor (TX)","4","8","0","0.33333","336","352","-16"
"2009","Baylor (TX)","4","8","0","0.33333","249","327","-78"
"2010","Baylor (TX)","7","6","0","0.53846","405","396","9"
"2011","Baylor (TX)","10","3","0","0.76923","589","484","105"
"2012","Baylor (TX)","8","5","0","0.61538","578","484","94"
"2013","Baylor (TX)","11","2","0","0.84615","681","306","375"
"1963","Utah St.","8","2","0","0.80000","317","99","218"
"1964","Utah St.","5","4","1","0.55000","294","136","158"
"1965","Utah St.","8","2","0","0.80000","271","136","135"
"1966","Utah St.","4","6","0","0.40000","181","163","18"
"1968","Boise St. (ID)","8","2","0","0.80000","324","124","200"
"1969","Boise St. (ID)","9","1","0","0.90000","391","98","293"
"1970","Boise St. (ID)","8","3","0","0.72727","293","129","164"
"1971","Boise St. (ID)","10","2","0","0.83333","351","247","104"
"1972","Boise St. (ID)","7","4","0","0.63636","345","240","105"
"1973","Boise St. (ID)","10","3","0","0.76923","470","221","249"
"1974","Boise St. (ID)","10","2","0","0.83333","497","259","238"
"1975","Boise St. (ID)","9","2","1","0.79167","401","265","136"
"1976","Nevada-Las Vegas","9","3","0","0.75000","359","288","71"
"1977","Nevada-Las Vegas","9","2","0","0.81818","300","243","57"
"1978","Nevada-Las Vegas","7","4","0","0.63636","249","182","67"
"1979","Nevada-Las Vegas","9","1","2","0.83333","370","300","70"
"1980","Nevada-Las Vegas","7","4","0","0.63636","384","257","127"
"1981","Nevada-Las Vegas","6","6","0","0.50000","326","433","-107"
"1976","Boise St. (ID)","5","5","1","0.50000","283","197","86"
"1977","Boise St. (ID)","9","2","0","0.81818","317","181","136"
"1978","Boise St. (ID)","7","4","0","0.63636","269","182","87"
"1979","Boise St. (ID)","10","1","0","0.90909","347","140","207"
"1980","Boise St. (ID)","10","3","0","0.76923","317","179","138"
"1981","Boise St. (ID)","10","3","0","0.76923","317","213","104"
"1982","Boise St. (ID)","8","3","0","0.72727","252","211","41"
"1983","Iowa St.","4","7","0","0.36364","248","385","-137"
"1984","Iowa St.","2","7","2","0.27273","149","263","-114"
"1985","Iowa St.","5","6","0","0.45455","155","318","-163"
"1986","Iowa St.","6","5","0","0.54545","257","244","13"
"1983","Boise St. (ID)","6","5","0","0.54545","281","194","87"
"1984","Boise St. (ID)","6","5","0","0.54545","256","227","29"
"1985","Boise St. (ID)","7","4","0","0.63636","288","211","77"
"1986","Boise St. (ID)","5","6","0","0.45455","262","183","79"
"1987","Cal Poly-San Luis Obispo","7","3","0","0.70000","275","173","102"
"1988","Cal Poly-San Luis Obispo","5","4","1","0.55000","238","145","93"
"1989","Cal Poly-San Luis Obispo","5","5","0","0.50000","230","227","3"
"1990","Cal Poly-San Luis Obispo","10","2","0","0.83333","304","167","137"
"1991","Cal Poly-San Luis Obispo","4","6","0","0.40000","271","272","-1"
"1992","Cal Poly-San Luis Obispo","4","5","1","0.45000","253","217","36"
"1993","Cal Poly-San Luis Obispo","6","4","0","0.60000","365","201","164"
"1987","Boise St. (ID)","6","5","0","0.54545","361","261","100"
"1988","Boise St. (ID)","8","4","0","0.66667","280","274","6"
"1989","Boise St. (ID)","6","5","0","0.54545","261","245","16"
"1990","Boise St. (ID)","10","4","0","0.71429","382","258","124"
"1991","Boise St. (ID)","7","4","0","0.63636","355","197","158"
"1992","Boise St. (ID)","5","6","0","0.45455","220","286","-66"
"1986","Portland St. (OR)","6","5","0","0.54545","288","297","-9"
"1987","Portland St. (OR)","11","2","1","0.82143","406","166","240"
"1988","Portland St. (OR)","11","3","1","0.76667","474","265","209"
"1989","Portland St. (OR)","9","4","0","0.69231","381","294","87"
"1990","Portland St. (OR)","6","5","0","0.54545","305","227","78"
"1991","Portland St. (OR)","11","3","0","0.78571","471","359","112"
"1992","Portland St. (OR)","9","4","0","0.69231","502","321","181"
"1993","Boise St. (ID)","3","8","0","0.27273","210","319","-109"
"1994","Boise St. (ID)","13","2","0","0.86667","433","291","142"
"1995","Boise St. (ID)","7","4","0","0.63636","361","265","96"
"1996","Boise St. (ID)","1","1","0","0.50000","52","96","-44"
"1996","Boise St. (ID)","1","9","0","0.10000","188","363","-175"
"1993","Murray St. (KY)","4","7","0","0.36364","201","279","-78"
"1994","Murray St. (KY)","5","6","0","0.45455","262","321","-59"
"1995","Murray St. (KY)","11","1","0","0.91667","455","149","306"
"1996","Murray St. (KY)","11","2","0","0.84615","463","206","257"
"1997","Boise St. (ID)","5","6","0","0.45455","285","358","-73"
"1998","Arkansas","9","3","0","0.75000","390","227","163"
"1999","Arkansas","8","4","0","0.66667","353","214","139"
"2000","Arkansas","6","6","0","0.50000","278","289","-11"
"2001","Arkansas","7","5","0","0.58333","294","279","15"
"2002","Arkansas","9","5","0","0.64286","370","277","93"
"2003","Arkansas","9","4","0","0.69231","436","305","131"
"2004","Arkansas","5","6","0","0.45455","328","270","58"
"2005","Arkansas","4","7","0","0.36364","283","271","12"
"2006","Arkansas","10","4","0","0.71429","404","256","148"
"2007","Arkansas","8","4","0","0.66667","478","307","171"
"2008","Mississippi","9","4","0","0.69231","417","247","170"
"2009","Mississippi","9","4","0","0.69231","384","230","154"
"2010","Mississippi","4","8","0","0.33333","367","422","-55"
"2011","Mississippi","2","10","0","0.16667","193","385","-192"
"1998","Boise St. (ID)","6","5","0","0.54545","329","350","-21"
"1999","Boise St. (ID)","10","3","0","0.76923","430","277","153"
"2000","Boise St. (ID)","10","2","0","0.83333","532","274","258"
"2001","Arizona St.","4","7","0","0.36364","374","361","13"
"2002","Arizona St.","8","6","0","0.57143","452","407","45"
"2003","Arizona St.","5","7","0","0.41667","298","328","-30"
"2004","Arizona St.","9","3","0","0.75000","358","294","64"
"2005","Arizona St.","7","5","0","0.58333","442","359","83"
"2006","Arizona St.","7","6","0","0.53846","348","326","22"
"1993","Willamette (OR)","5","4","0","0.55556","293","281","12"
"1994","Willamette (OR)","8","2","0","0.80000","245","222","23"
"1995","Willamette (OR)","6","2","1","0.72222","314","171","143"
"1996","Willamette (OR)","9","2","0","0.81818","374","246","128"
"1997","Willamette (OR)","13","1","0","0.92857","470","167","303"
"2001","Boise St. (ID)","8","4","0","0.66667","411","280","131"
"2002","Boise St. (ID)","12","1","0","0.92308","593","240","353"
"2003","Boise St. (ID)","13","1","0","0.92857","602","239","363"
"2004","Boise St. (ID)","11","1","0","0.91667","587","308","279"
"2005","Boise St. (ID)","9","4","0","0.69231","469","317","152"
"2006","Colorado","2","10","0","0.16667","196","267","-71"
"2007","Colorado","6","7","0","0.46154","355","383","-28"
"2008","Colorado","5","7","0","0.41667","242","351","-109"
"2009","Colorado","3","9","0","0.25000","267","346","-79"
"2010","Colorado","3","6","0","0.33333","195","274","-79"
"2006","Boise St. (ID)","13","0","0","1.00000","516","229","287"
"2007","Boise St. (ID)","10","3","0","0.76923","551","281","270"
"2008","Boise St. (ID)","12","1","0","0.92308","489","164","325"
"2009","Boise St. (ID)","14","0","0","1.00000","591","240","351"
"2010","Boise St. (ID)","12","1","0","0.92308","586","166","420"
"2011","Boise St. (ID)","12","1","0","0.92308","575","243","332"
"2012","Boise St. (ID)","11","2","0","0.84615","393","205","188"
"2013","Boise St. (ID)","8","4","0","0.66667","465","285","180"
"2013","Boise St. (ID)","0","1","0","0.00000","23","38","-15"
"1893","Boston College (MA)","1","2","0","0.33333","10","22","-12"
"1894","Boston College (MA)","1","6","0","0.14286","20","116","-96"
"1895","Boston College (MA)","2","4","2","0.37500","36","106","-70"
"1896","Boston College (MA)","5","3","0","0.62500","54","64","-10"
"1897","Boston College (MA)","4","4","0","0.50000","58","58","0"
"1898","Boston College (MA)","2","5","1","0.31250","22","41","-19"
"1899","Boston College (MA)","8","1","1","0.85000","85","18","67"
"1901","Boston College (MA)","2","7","0","0.22222","28","108","-80"
"1885","Minnesota","0","2","0","0.00000","13","27","-14"
"1890","Kentucky","1","0","0","1.00000","8","2","6"
"1896","Saint John's (NY)","1","0","0","1.00000","6","0","6"
"1898","Emporia St. (KS)","0","2","0","0.00000","0","60","-60"
"1900","Boston College (MA)","1","0","0","1.00000","5","0","5"
"1901","Saint John's (NY)","0","1","0","0.00000","0","61","-61"
"1902","La Salle (PA)","0","4","0","0.00000","12","65","-53"
"1904","Louisiana-Lafayette","2","0","1","0.83333","28","4","24"
"1908","Saint John's (NY)","0","2","0","0.00000","0","18","-18"
"1909","North Carolina A&T","0","1","0","0.00000","0","11","-11"
"1910","Clarion (PA)","0","1","0","0.00000","0","39","-39"
"1917","Texas St.","1","0","0","1.00000","12","0","12"
"1924","Manhattan (NY)","4","4","0","0.50000","74","69","5"
"1929","Campbellsville (KY)","0","1","0","0.00000","6","54","-48"
"1943","William & Mary Freshmen (VA)","4","2","0","0.66667","157","56","101"
"1902","Boston College (MA)","0","9","0","0.00000","17","180","-163"
"1908","Boston College (MA)","2","4","2","0.37500","30","54","-24"
"1897","Georgia","2","1","0","0.66667","56","17","39"
"1898","Georgia","4","2","0","0.66667","70","70","0"
"1909","Boston College (MA)","3","4","1","0.43750","71","42","29"
"1910","Boston College (MA)","0","4","2","0.16667","16","73","-57"
"1911","Boston College (MA)","0","7","0","0.00000","3","97","-94"
"1912","Boston College (MA)","2","4","1","0.35714","33","157","-124"
"1913","Boston College (MA)","4","3","1","0.56250","166","72","94"
"1933","Canisius (NY)","6","1","1","0.81250","210","35","175"
"1934","Canisius (NY)","4","2","0","0.66667","62","37","25"
"1935","Canisius (NY)","3","3","1","0.50000","106","61","45"
"1936","Canisius (NY)","7","1","0","0.87500","199","27","172"
"1937","Canisius (NY)","4","4","1","0.50000","47","57","-10"
"1938","Canisius (NY)","2","6","0","0.25000","47","130","-83"
"1914","Boston College (MA)","5","4","0","0.55556","119","80","39"
"1915","Boston College (MA)","3","4","0","0.42857","45","69","-24"
"1915","Johns Hopkins (MD)","6","2","0","0.75000","220","66","154"
"1916","Boston College (MA)","6","2","0","0.75000","167","66","101"
"1917","Boston College (MA)","6","2","0","0.75000","208","33","175"
"1918","Boston College (MA)","5","2","0","0.71429","142","35","107"
"1898","Cincinnati (OH)","6","1","2","0.77778","141","28","113"
"1903","Holy Cross (MA)","8","2","0","0.80000","174","69","105"
"1904","Holy Cross (MA)","2","5","2","0.33333","65","135","-70"
"1905","Holy Cross (MA)","6","3","0","0.66667","119","73","46"
"1911","Dartmouth (NH)","8","2","0","0.80000","137","22","115"
"1912","Dartmouth (NH)","7","2","0","0.77778","281","34","247"
"1913","Dartmouth (NH)","7","1","0","0.87500","218","79","139"
"1914","Dartmouth (NH)","8","1","0","0.88889","347","25","322"
"1915","Dartmouth (NH)","7","1","1","0.83333","194","40","154"
"1916","Dartmouth (NH)","5","2","2","0.66667","206","47","159"
"1919","Boston College (MA)","5","3","0","0.62500","78","62","16"
"1920","Boston College (MA)","8","0","0","1.00000","181","16","165"
"1921","Boston College (MA)","4","3","1","0.56250","85","90","-5"
"1922","Boston College (MA)","6","2","1","0.72222","133","58","75"
"1923","Boston College (MA)","7","1","1","0.83333","167","14","153"
"1924","Boston College (MA)","6","3","0","0.66667","198","74","124"
"1925","Boston College (MA)","6","2","0","0.75000","152","53","99"
"1926","Boston College (MA)","6","0","2","0.87500","222","34","188"
"1927","Fordham (NY)","3","5","0","0.37500","82","139","-57"
"1928","Fordham (NY)","4","5","0","0.44444","121","130","-9"
"1929","Fordham (NY)","7","0","2","0.88889","176","19","157"
"1930","Fordham (NY)","8","1","0","0.88889","215","29","186"
"1931","Fordham (NY)","6","1","2","0.77778","205","36","169"
"1932","Fordham (NY)","6","2","0","0.75000","193","28","165"
"1927","Boston College (MA)","4","4","0","0.50000","101","105","-4"
"1928","Boston College (MA)","9","0","0","1.00000","263","39","224"
"1929","Boston College (MA)","7","2","1","0.75000","202","65","137"
"1930","Boston College (MA)","5","5","0","0.50000","167","70","97"
"1931","Boston College (MA)","6","4","0","0.60000","115","74","41"
"1932","Boston College (MA)","4","2","2","0.62500","73","59","14"
"1933","Boston College (MA)","8","1","0","0.88889","169","50","119"
"1934","Boston College (MA)","5","4","0","0.55556","64","72","-8"
"1935","Boston College (MA)","3","1","0","0.75000","50","33","17"
"1935","Boston College (MA)","3","2","0","0.60000","96","44","52"
"1906","North Dakota St.","5","0","0","1.00000","236","4","232"
"1907","North Dakota St.","3","0","0","1.00000","164","10","154"
"1908","Washington","6","0","1","0.92857","128","15","113"
"1909","Washington","7","0","0","1.00000","214","6","208"
"1910","Washington","6","0","0","1.00000","150","8","142"
"1911","Washington","7","0","0","1.00000","277","9","268"
"1912","Washington","6","0","0","1.00000","190","17","173"
"1913","Washington","7","0","0","1.00000","266","20","246"
"1914","Washington","6","0","1","0.92857","242","13","229"
"1915","Washington","7","0","0","1.00000","274","14","260"
"1916","Washington","6","0","1","0.92857","189","16","173"
"1917","Navy (MD)","7","1","0","0.87500","442","23","419"
"1918","Navy (MD)","4","1","0","0.80000","283","20","263"
"1919","Navy (MD)","7","1","0","0.87500","298","18","280"
"1920","Cornell (NY)","6","2","0","0.75000","231","68","163"
"1921","Cornell (NY)","8","0","0","1.00000","392","21","371"
"1922","Cornell (NY)","8","0","0","1.00000","339","27","312"
"1923","Cornell (NY)","8","0","0","1.00000","320","33","287"
"1924","Cornell (NY)","4","4","0","0.50000","209","71","138"
"1925","Cornell (NY)","6","2","0","0.75000","258","83","175"
"1926","Cornell (NY)","6","1","1","0.81250","191","64","127"
"1927","Cornell (NY)","3","3","2","0.50000","136","121","15"
"1928","Cornell (NY)","3","3","2","0.50000","72","86","-14"
"1929","Cornell (NY)","6","2","0","0.75000","204","60","144"
"1930","Cornell (NY)","6","2","0","0.75000","273","63","210"
"1931","Cornell (NY)","7","1","0","0.87500","239","20","219"
"1932","Cornell (NY)","5","2","1","0.68750","174","39","135"
"1933","Cornell (NY)","4","3","0","0.57143","116","89","27"
"1934","Cornell (NY)","2","5","0","0.28571","55","114","-59"
"1935","Cornell (NY)","0","6","1","0.07143","59","201","-142"
"1936","Boston College (MA)","6","1","2","0.77778","109","55","54"
"1937","Boston College (MA)","4","4","1","0.50000","109","68","41"
"1938","Boston College (MA)","6","1","2","0.77778","186","87","99"
"1939","Boston College (MA)","9","2","0","0.81818","219","46","173"
"1940","Boston College (MA)","11","0","0","1.00000","339","65","274"
"1941","Notre Dame (IN)","8","0","1","0.94444","189","64","125"
"1942","Notre Dame (IN)","7","2","2","0.72727","184","99","85"
"1943","Notre Dame (IN)","9","1","0","0.90000","340","69","271"
"1946","Notre Dame (IN)","8","0","1","0.94444","271","24","247"
"1947","Notre Dame (IN)","9","0","0","1.00000","291","52","239"
"1948","Notre Dame (IN)","9","0","1","0.95000","320","93","227"
"1949","Notre Dame (IN)","10","0","0","1.00000","360","86","274"
"1950","Notre Dame (IN)","4","4","1","0.50000","139","140","-1"
"1951","Notre Dame (IN)","7","2","1","0.75000","241","122","119"
"1952","Notre Dame (IN)","7","2","1","0.75000","183","108","75"
"1953","Notre Dame (IN)","9","0","1","0.95000","317","139","178"
"1941","Boston College (MA)","7","3","0","0.70000","235","106","129"
"1942","Boston College (MA)","8","2","0","0.80000","282","111","171"
"1946","Boston College (MA)","6","3","0","0.66667","234","123","111"
"1947","Boston College (MA)","5","4","0","0.55556","184","134","50"
"1948","Boston College (MA)","5","2","2","0.66667","152","134","18"
"1949","Boston College (MA)","4","4","1","0.50000","209","187","22"
"1950","Boston College (MA)","0","9","1","0.05000","78","270","-192"
"1943","Boston College (MA)","4","0","1","0.90000","156","18","138"
"1944","Boston College (MA)","4","3","0","0.57143","132","134","-2"
"1945","Boston College (MA)","3","4","0","0.42857","79","171","-92"
"1951","Boston College (MA)","3","6","0","0.33333","135","198","-63"
"1952","Boston College (MA)","4","4","1","0.50000","92","129","-37"
"1953","Boston College (MA)","5","3","1","0.61111","137","139","-2"
"1954","Boston College (MA)","8","1","0","0.88889","196","74","122"
"1955","Boston College (MA)","5","2","1","0.68750","176","79","97"
"1956","Boston College (MA)","5","4","0","0.55556","149","91","58"
"1957","Boston College (MA)","7","2","0","0.77778","158","129","29"
"1958","Boston College (MA)","7","3","0","0.70000","229","127","102"
"1959","Boston College (MA)","5","4","0","0.55556","162","143","19"
"1960","Boston College (MA)","3","6","1","0.35000","144","148","-4"
"1961","Boston College (MA)","4","6","0","0.40000","117","189","-72"
"1959","Detroit (MI)","6","4","0","0.60000","199","139","60"
"1960","Detroit (MI)","7","2","0","0.77778","181","136","45"
"1961","Detroit (MI)","5","4","0","0.55556","181","173","8"
"1962","Boston College (MA)","8","2","0","0.80000","251","123","128"
"1963","Boston College (MA)","6","3","0","0.66667","168","130","38"
"1964","Boston College (MA)","6","3","0","0.66667","112","110","2"
"1965","Boston College (MA)","6","4","0","0.60000","209","117","92"
"1966","Boston College (MA)","4","6","0","0.40000","133","202","-69"
"1967","Boston College (MA)","4","6","0","0.40000","227","212","15"
"1966","New Hampshire","2","6","0","0.25000","117","139","-22"
"1967","New Hampshire","5","3","0","0.62500","169","72","97"
"1968","Boston College (MA)","6","3","0","0.66667","253","196","57"
"1969","Boston College (MA)","5","4","0","0.55556","218","245","-27"
"1970","Boston College (MA)","8","2","0","0.80000","307","142","165"
"1971","Boston College (MA)","9","2","0","0.81818","259","117","142"
"1972","Boston College (MA)","4","7","0","0.36364","240","258","-18"
"1973","Boston College (MA)","7","4","0","0.63636","311","174","137"
"1974","Boston College (MA)","8","3","0","0.72727","375","154","221"
"1975","Boston College (MA)","7","4","0","0.63636","227","146","81"
"1976","Boston College (MA)","8","3","0","0.72727","239","125","114"
"1977","Boston College (MA)","6","5","0","0.54545","242","269","-27"
"1978","Dartmouth (NH)","6","3","0","0.66667","187","159","28"
"1979","Dartmouth (NH)","4","4","1","0.50000","98","86","12"
"1980","Dartmouth (NH)","4","6","0","0.40000","207","170","37"
"1981","Dartmouth (NH)","6","4","0","0.60000","208","137","71"
"1982","Dartmouth (NH)","5","5","0","0.50000","219","235","-16"
"1983","Dartmouth (NH)","4","5","1","0.45000","185","208","-23"
"1984","Dartmouth (NH)","2","7","0","0.22222","174","226","-52"
"1985","Dartmouth (NH)","2","7","1","0.25000","144","199","-55"
"1986","Dartmouth (NH)","3","6","1","0.35000","188","272","-84"
"1976","Eastern Michigan","2","9","0","0.18182","132","355","-223"
"1977","Eastern Michigan","8","3","0","0.72727","239","195","44"
"1978","Boston College (MA)","0","11","0","0.00000","153","294","-141"
"1979","Boston College (MA)","5","6","0","0.45455","215","217","-2"
"1980","Boston College (MA)","7","4","0","0.63636","199","186","13"
"1981","Kent St. (OH)","4","7","0","0.36364","144","172","-28"
"1982","Kent St. (OH)","0","11","0","0.00000","114","270","-156"
"1976","Maine","6","5","0","0.54545","171","190","-19"
"1977","Maine","3","7","0","0.30000","172","300","-128"
"1978","Maine","3","7","1","0.31818","151","338","-187"
"1979","Maine","2","9","0","0.18182","151","221","-70"
"1980","Maine","4","7","0","0.36364","149","213","-64"
"1981","Boston College (MA)","5","6","0","0.45455","243","298","-55"
"1982","Boston College (MA)","8","3","1","0.70833","294","219","75"
"1983","Boston College (MA)","9","3","0","0.75000","351","190","161"
"1984","Boston College (MA)","10","2","0","0.83333","449","296","153"
"1985","Boston College (MA)","4","8","0","0.33333","222","307","-85"
"1986","Boston College (MA)","9","3","0","0.75000","338","233","105"
"1987","Boston College (MA)","5","6","0","0.45455","244","281","-37"
"1988","Boston College (MA)","3","8","0","0.27273","237","326","-89"
"1989","Boston College (MA)","2","9","0","0.18182","207","253","-46"
"1990","Boston College (MA)","4","7","0","0.36364","190","288","-98"
"1991","Boston College (MA)","4","7","0","0.36364","247","246","1"
"1992","Boston College (MA)","8","3","1","0.70833","330","238","92"
"1993","Boston College (MA)","9","3","0","0.75000","408","240","168"
"1994","Boston College (MA)","7","4","1","0.62500","271","169","102"
"1995","Boston College (MA)","4","8","0","0.33333","207","322","-115"
"1996","Boston College (MA)","5","7","0","0.41667","264","364","-100"
"1997","Boston College (MA)","4","7","0","0.36364","237","314","-77"
"1998","Boston College (MA)","4","7","0","0.36364","273","311","-38"
"1999","Boston College (MA)","8","4","0","0.66667","297","308","-11"
"2000","Boston College (MA)","7","5","0","0.58333","378","277","101"
"2001","Boston College (MA)","8","4","0","0.66667","337","227","110"
"2002","Boston College (MA)","9","4","0","0.69231","392","253","139"
"2003","Boston College (MA)","8","5","0","0.61538","370","331","39"
"2004","Boston College (MA)","9","3","0","0.75000","296","203","93"
"2005","Boston College (MA)","9","3","0","0.75000","310","191","119"
"2006","Boston College (MA)","9","3","0","0.75000","313","180","133"
"2007","North Carolina St.","5","7","0","0.41667","249","339","-90"
"2008","North Carolina St.","6","7","0","0.46154","305","342","-37"
"2009","North Carolina St.","5","7","0","0.41667","364","374","-10"
"2010","North Carolina St.","9","4","0","0.69231","414","277","137"
"2011","North Carolina St.","8","5","0","0.61538","367","321","46"
"2012","North Carolina St.","7","5","0","0.58333","341","295","46"
"2007","Boston College (MA)","11","3","0","0.78571","396","285","111"
"2008","Boston College (MA)","9","5","0","0.64286","346","257","89"
"2006","Boston College (MA)","1","0","0","1.00000","25","24","1"
"2009","Boston College (MA)","8","5","0","0.61538","322","257","65"
"2010","Boston College (MA)","7","6","0","0.53846","240","254","-14"
"2011","Boston College (MA)","4","8","0","0.33333","218","282","-64"
"2012","Boston College (MA)","2","10","0","0.16667","238","356","-118"
"2011","Temple (PA)","9","4","0","0.69231","398","181","217"
"2012","Temple (PA)","4","7","0","0.36364","272","343","-71"
"2013","Boston College (MA)","7","6","0","0.53846","360","376","-16"
"1919","Bowling Green (OH)","0","3","0","0.00000","0","28","-28"
"1920","Bowling Green (OH)","1","4","0","0.20000","41","138","-97"
"1921","Bowling Green (OH)","3","1","1","0.70000","178","34","144"
"1922","Bowling Green (OH)","4","2","1","0.64286","98","46","52"
"1919","Chadron St. (NE)","2","3","0","0.40000","32","78","-46"
"1923","Bowling Green (OH)","3","5","0","0.37500","68","131","-63"
"1924","Bowling Green (OH)","3","4","0","0.42857","60","73","-13"
"1925","Bowling Green (OH)","3","1","3","0.64286","34","28","6"
"1926","Bowling Green (OH)","4","3","1","0.56250","88","70","18"
"1927","Bowling Green (OH)","5","1","1","0.78571","52","14","38"
"1928","Bowling Green (OH)","5","0","2","0.85714","84","18","66"
"1929","Bowling Green (OH)","4","2","1","0.64286","76","54","22"
"1930","Bowling Green (OH)","6","0","2","0.87500","107","38","69"
"1931","Bowling Green (OH)","3","1","4","0.62500","31","21","10"
"1932","Bowling Green (OH)","3","3","1","0.50000","33","77","-44"
"1933","Bowling Green (OH)","2","3","2","0.42857","44","91","-47"
"1934","Bowling Green (OH)","2","3","2","0.42857","36","54","-18"
"1935","Bowling Green (OH)","1","6","0","0.14286","25","246","-221"
"1936","Bowling Green (OH)","4","2","3","0.61111","66","60","6"
"1937","Bowling Green (OH)","3","4","1","0.43750","56","80","-24"
"1938","Bowling Green (OH)","3","2","3","0.56250","95","41","54"
"1939","Bowling Green (OH)","6","1","1","0.81250","159","46","113"
"1940","Bowling Green (OH)","3","4","1","0.43750","62","122","-60"
"1949","Eastern Michigan","0","8","0","0.00000","61","180","-119"
"1950","Eastern Michigan","3","6","0","0.33333","123","191","-68"
"1951","Eastern Michigan","4","5","0","0.44444","186","183","3"
"1941","Bowling Green (OH)","7","1","1","0.83333","173","40","133"
"1942","Bowling Green (OH)","6","2","1","0.72222","135","55","80"
"1943","Bowling Green (OH)","5","3","1","0.61111","194","104","90"
"1944","Bowling Green (OH)","5","3","0","0.62500","133","117","16"
"1945","Bowling Green (OH)","4","3","0","0.57143","79","81","-2"
"1946","Bowling Green (OH)","5","3","0","0.62500","95","39","56"
"1947","Bowling Green (OH)","5","5","0","0.50000","134","149","-15"
"1948","Bowling Green (OH)","8","0","1","0.94444","230","100","130"
"1949","Bowling Green (OH)","4","5","0","0.44444","206","161","45"
"1950","Bowling Green (OH)","3","4","2","0.44444","134","188","-54"
"1951","Bowling Green (OH)","4","4","1","0.50000","150","178","-28"
"1952","Bowling Green (OH)","7","2","0","0.77778","257","155","102"
"1953","Bowling Green (OH)","1","8","0","0.11111","119","252","-133"
"1954","Bowling Green (OH)","2","7","0","0.22222","125","196","-71"
"1955","Bowling Green (OH)","7","1","1","0.83333","224","53","171"
"1956","Bowling Green (OH)","8","0","1","0.94444","311","99","212"
"1957","Bowling Green (OH)","6","1","2","0.77778","167","55","112"
"1958","Bowling Green (OH)","7","2","0","0.77778","218","91","127"
"1959","Bowling Green (OH)","9","0","0","1.00000","274","83","191"
"1960","Bowling Green (OH)","8","1","0","0.88889","196","61","135"
"1961","Bowling Green (OH)","8","2","0","0.80000","194","78","116"
"1962","Bowling Green (OH)","7","1","1","0.83333","204","91","113"
"1963","Bowling Green (OH)","8","2","0","0.80000","201","116","85"
"1964","Bowling Green (OH)","9","1","0","0.90000","275","87","188"
"1965","Bowling Green (OH)","7","2","0","0.77778","123","107","16"
"1966","Bowling Green (OH)","6","3","0","0.66667","187","124","63"
"1967","Bowling Green (OH)","6","4","0","0.60000","131","130","1"
"1968","Bowling Green (OH)","6","3","1","0.65000","267","147","120"
"1969","Bowling Green (OH)","6","4","0","0.60000","179","146","33"
"1970","Bowling Green (OH)","2","6","1","0.27778","118","178","-60"
"1971","Bowling Green (OH)","6","4","0","0.60000","263","207","56"
"1972","Bowling Green (OH)","6","3","1","0.65000","184","127","57"
"1973","Bowling Green (OH)","7","3","0","0.70000","266","209","57"
"1974","Bowling Green (OH)","6","4","1","0.59091","249","203","46"
"1975","Bowling Green (OH)","8","3","0","0.72727","278","166","112"
"1976","Bowling Green (OH)","6","5","0","0.54545","292","249","43"
"1980","West Virginia","6","6","0","0.50000","305","289","16"
"1981","West Virginia","9","3","0","0.75000","284","155","129"
"1982","West Virginia","9","3","0","0.75000","284","182","102"
"1983","West Virginia","9","3","0","0.75000","322","189","133"
"1984","West Virginia","8","4","0","0.66667","259","170","89"
"1985","West Virginia","7","3","1","0.68182","189","158","31"
"1986","West Virginia","4","7","0","0.36364","210","286","-76"
"1987","West Virginia","6","6","0","0.50000","330","212","118"
"1988","West Virginia","11","1","0","0.91667","493","208","285"
"1989","West Virginia","8","3","1","0.70833","339","221","118"
"1990","West Virginia","4","7","0","0.36364","217","238","-21"
"1991","West Virginia","6","5","0","0.54545","187","224","-37"
"1992","West Virginia","5","4","2","0.54545","286","238","48"
"1993","West Virginia","11","1","0","0.91667","408","212","196"
"1994","West Virginia","7","6","0","0.53846","296","286","10"
"1995","West Virginia","5","6","0","0.45455","253","210","43"
"1996","West Virginia","8","4","0","0.66667","271","156","115"
"1997","West Virginia","7","5","0","0.58333","360","285","75"
"1998","West Virginia","8","4","0","0.66667","410","267","143"
"1999","West Virginia","4","7","0","0.36364","292","289","3"
"2000","West Virginia","7","5","0","0.58333","356","363","-7"
"1965","Alma (MI)","3","5","0","0.37500","79","147","-68"
"1966","Alma (MI)","4","5","0","0.44444","102","93","9"
"1967","Alma (MI)","8","0","0","1.00000","217","41","176"
"1968","Alma (MI)","8","0","0","1.00000","248","65","183"
"1969","Alma (MI)","6","3","0","0.66667","218","113","105"
"1970","Alma (MI)","5","3","0","0.62500","195","104","91"
"1973","Michigan St.","5","6","0","0.45455","114","164","-50"
"1974","Michigan St.","7","3","1","0.68182","270","196","74"
"1975","Michigan St.","7","4","0","0.63636","222","167","55"
"1977","Bowling Green (OH)","5","7","0","0.41667","275","296","-21"
"1978","Bowling Green (OH)","4","7","0","0.36364","277","267","10"
"1979","Bowling Green (OH)","4","7","0","0.36364","194","265","-71"
"1980","Bowling Green (OH)","4","7","0","0.36364","189","186","3"
"1981","Bowling Green (OH)","5","5","1","0.50000","155","132","23"
"1982","Bowling Green (OH)","7","5","0","0.58333","265","199","66"
"1983","Bowling Green (OH)","8","3","0","0.72727","277","242","35"
"1984","Bowling Green (OH)","8","3","0","0.72727","327","198","129"
"1985","Bowling Green (OH)","11","1","0","0.91667","355","223","132"
"1986","San Diego St. (CA)","8","4","0","0.66667","292","279","13"
"1987","San Diego St. (CA)","5","7","0","0.41667","357","428","-71"
"1988","San Diego St. (CA)","3","8","0","0.27273","204","384","-180"
"1986","Bowling Green (OH)","5","6","0","0.45455","148","222","-74"
"1987","Bowling Green (OH)","5","6","0","0.45455","215","249","-34"
"1988","Bowling Green (OH)","2","8","1","0.22727","159","333","-174"
"1989","Bowling Green (OH)","5","6","0","0.45455","233","319","-86"
"1990","Bowling Green (OH)","3","5","2","0.40000","138","163","-25"
"1991","Bowling Green (OH)","11","1","0","0.91667","279","168","111"
"1992","Bowling Green (OH)","10","2","0","0.83333","324","235","89"
"1993","Bowling Green (OH)","6","3","2","0.63636","268","173","95"
"1994","Bowling Green (OH)","9","2","0","0.81818","391","174","217"
"1995","Bowling Green (OH)","5","6","0","0.45455","226","228","-2"
"1996","Bowling Green (OH)","4","7","0","0.36364","176","240","-64"
"1997","Bowling Green (OH)","3","8","0","0.27273","191","341","-150"
"1998","Bowling Green (OH)","5","6","0","0.45455","292","312","-20"
"1999","Bowling Green (OH)","5","6","0","0.45455","296","312","-16"
"2000","Bowling Green (OH)","2","9","0","0.18182","174","289","-115"
"2001","Bowling Green (OH)","8","3","0","0.72727","333","215","118"
"2002","Bowling Green (OH)","9","3","0","0.75000","490","304","186"
"2003","Utah","10","2","0","0.83333","344","229","115"
"2004","Utah","11","0","0","1.00000","509","227","282"
"2005","Florida","9","3","0","0.75000","343","226","117"
"2006","Florida","13","1","0","0.92857","416","189","227"
"2007","Florida","9","4","0","0.69231","552","331","221"
"2008","Florida","13","1","0","0.92857","611","181","430"
"2009","Florida","13","1","0","0.92857","502","174","328"
"2010","Florida","8","5","0","0.61538","388","277","111"
"2012","Ohio St.","12","0","0","1.00000","446","274","172"
"2013","Ohio St.","12","2","0","0.85714","637","317","320"
"2003","Bowling Green (OH)","11","3","0","0.78571","470","304","166"
"2004","Bowling Green (OH)","9","3","0","0.75000","532","282","250"
"2005","Bowling Green (OH)","6","5","0","0.54545","372","304","68"
"2006","Bowling Green (OH)","4","8","0","0.33333","234","340","-106"
"2007","Bowling Green (OH)","8","5","0","0.61538","392","417","-25"
"2008","Bowling Green (OH)","6","6","0","0.50000","332","278","54"
"1999","Fordham (NY)","0","11","0","0.00000","170","410","-240"
"2000","Fordham (NY)","3","8","0","0.27273","211","318","-107"
"2001","Fordham (NY)","7","4","0","0.63636","329","245","84"
"2002","Fordham (NY)","10","3","0","0.76923","418","225","193"
"2003","Fordham (NY)","9","3","0","0.75000","386","251","135"
"2004","Richmond (VA)","3","8","0","0.27273","198","297","-99"
"2005","Richmond (VA)","9","4","0","0.69231","349","231","118"
"2006","Richmond (VA)","6","5","0","0.54545","272","199","73"
"2007","Richmond (VA)","11","3","0","0.78571","489","334","155"
"2009","Bowling Green (OH)","7","6","0","0.53846","370","357","13"
"2010","Bowling Green (OH)","2","10","0","0.16667","255","403","-148"
"2011","Bowling Green (OH)","5","7","0","0.41667","318","346","-28"
"2012","Bowling Green (OH)","8","5","0","0.61538","298","218","80"
"2013","Bowling Green (OH)","10","3","0","0.76923","460","192","268"
"2013","Bowling Green (OH)","0","1","0","0.00000","27","30","-3"
"1872","Stevens Tech (NJ)","0","1","0","0.00000","0","6","-6"
"1873","New York (NY)","3","3","0","0.50000","15","13","2"
"1874","Stevens Tech (NJ)","2","3","0","0.40000","10","20","-10"
"1875","Stevens Tech (NJ)","4","4","0","0.50000","21","20","1"
"1876","New York (NY)","2","3","1","0.41667","16","19","-3"
"1877","Stevens Tech (NJ)","3","1","2","0.66667","9","14","-5"
"1878","Stevens Tech (NJ)","3","3","3","0.50000","3","9","-6"
"1879","Stevens Tech (NJ)","2","3","5","0.45000","8","14","-6"
"1880","Stevens Tech (NJ)","1","5","0","0.16667","3","16","-13"
"1881","Stevens Tech (NJ)","3","8","3","0.32143","16","29","-13"
"1882","Lawrence (WI)","7","8","1","0.46875","17","25","-8"
"1883","Stevens Tech (NJ)","7","6","1","0.53571","187","128","59"
"1884","Fordham (NY)","9","10","0","0.47368","221","261","-40"
"1885","Georgetown (DC)","5","17","1","0.23913","359","612","-253"
"1886","New York (NY)","9","15","2","0.38462","180","565","-385"
"1887","Fordham (NY)","8","12","1","0.40476","157","445","-288"
"1888","Amherst (MA)","6","17","3","0.28846","192","791","-599"
"1889","New York (NY)","8","21","4","0.30303","278","647","-369"
"1890","New York (NY)","25","14","2","0.63415","727","538","189"
"1891","Delaware","32","30","7","0.51449","966","971","-5"
"1892","Beloit (WI)","29","31","3","0.48413","726","797","-71"
"1893","Marquette (WI)","39","34","3","0.53289","1091","885","206"
"1894","Manhattan (NY)","32","29","7","0.52206","853","692","161"
"1895","Delaware","44","35","6","0.55294","889","813","76"
"1896","Manhattan (NY)","51","49","6","0.50943","949","1164","-215"
"1897","Stevens Tech (NJ)","37","50","4","0.42857","661","1048","-387"
"1898","Manhattan (NY)","37","43","9","0.46629","781","1050","-269"
"1899","Manhattan (NY)","34","40","6","0.46250","594","1063","-469"
"1900","Manhattan (NY)","43","47","11","0.48020","991","1049","-58"
"1901","Ferris St. (MI)","51","44","7","0.53431","906","852","54"
"1902","Indiana St.","56","48","5","0.53670","1053","927","126"
"1903","Manhattan (NY)","30","49","7","0.38953","762","1319","-557"
"1904","Saint Francis (NY)","44","53","9","0.45755","787","1363","-576"
"1905","Bluffton (OH)","38","59","5","0.39706","850","1433","-583"
"1906","Ferris St. (MI)","32","43","12","0.43678","677","854","-177"
"1907","Ferris St. (MI)","32","48","10","0.41111","722","1208","-486"
"1908","Western Illinois","36","45","10","0.45055","760","1069","-309"
"1909","Delaware Valley (PA)","27","52","2","0.34568","682","1287","-605"
"1910","East Stroudsburg (PA)","23","31","3","0.42982","583","738","-155"
"1911","Western Illinois","32","44","7","0.42771","661","902","-241"
"1912","Indiana (PA)","36","56","7","0.39899","1134","1463","-329"
"1913","Saint Francis (NY)","52","67","8","0.44094","1672","2360","-688"
"1914","Delaware Valley (PA)","41","50","6","0.45361","1217","1585","-368"
"1915","Western Illinois","34","35","11","0.49375","932","1217","-285"
"1916","Morgan St. (MD)","44","43","7","0.50532","1493","1270","223"
"1917","Morgan St. (MD)","21","21","2","0.50000","408","883","-475"
"1918","Oklahoma Baptist University","7","16","2","0.32000","258","358","-100"
"1919","Western Illinois","53","41","8","0.55882","1478","1056","422"
"1920","Virginia Union","28","39","2","0.42029","506","893","-387"
"1921","Cooper Union (NY)","19","34","3","0.36607","441","1112","-671"
"1922","Cooper Union (NY)","27","34","6","0.44776","703","832","-129"
"1923","Cooper Union (NY)","31","45","2","0.41026","718","1112","-394"
"1924","East Stroudsburg (PA)","34","40","6","0.46250","946","1175","-229"
"1925","Saint Anselm (NH)","32","28","10","0.52857","847","802","45"
"1926","Saint Anselm (NH)","22","30","4","0.42857","515","702","-187"
"1927","Bethune-Cookman (FL)","20","29","8","0.42105","674","783","-109"
"1928","Saint Anselm (NH)","28","24","7","0.53390","564","1095","-531"
"1929","Saint Anselm (NH)","25","32","5","0.44355","616","843","-227"
"1930","Saint Anselm (NH)","31","27","10","0.52941","643","549","94"
"1931","Campbell (NC)","21","17","4","0.54762","465","428","37"
"1932","Campbell (NC)","7","30","3","0.21250","254","760","-506"
"1933","Campbell (NC)","11","13","3","0.46296","262","324","-62"
"1934","Bowie St. (MD)","4","7","2","0.38462","116","94","22"
"1935","Florida Southern","7","12","1","0.37500","170","162","8"
"1936","Bowie St. (MD)","5","2","1","0.68750","154","97","57"
"1937","Bowie St. (MD)","6","3","0","0.66667","98","87","11"
"1938","West Alabama","7","5","0","0.58333","151","88","63"
"1939","Elizabeth City St. (NC)","7","13","0","0.35000","150","307","-157"
"1940","Elizabeth City St. (NC)","6","5","4","0.53333","128","67","61"
"1941","Arkansas-Pine Bluff","3","9","5","0.32353","178","223","-45"
"1942","Brevard College (NC)","10","6","2","0.61111","225","189","36"
"1943","Clark Atlanta (GA)","6","8","0","0.42857","127","206","-79"
"1944","Abilene Christian (TX)","9","11","1","0.45238","158","255","-97"
"1945","Benedict (SC)","10","15","2","0.40741","299","296","3"
"1946","Elizabeth City St. (NC)","7","20","3","0.28333","144","540","-396"
"1947","Clark Atlanta (GA)","3","6","2","0.36364","49","230","-181"
"1948","Virginia-Lynchburg","4","6","1","0.40909","77","302","-225"
"1949","Virginia-Lynchburg","0","3","1","0.12500","7","70","-63"
"1950","Virginia-Lynchburg","2","3","0","0.40000","53","98","-45"
"1951","Lane (TN)","8","6","0","0.57143","295","234","61"
"1952","Lane (TN)","9","5","1","0.63333","220","206","14"
"1953","Lane (TN)","1","7","0","0.12500","58","215","-157"
"1954","Lane (TN)","2","6","0","0.25000","105","135","-30"
"1955","Lane (TN)","2","4","0","0.33333","83","129","-46"
"1957","Louisiana College","2","7","0","0.22222","106","179","-73"
"1959","Azusa Pacific (CA)","2","3","0","0.40000","117","90","27"
"1960","Azusa Pacific (CA)","4","3","1","0.56250","103","76","27"
"1961","Azusa Pacific (CA)","3","3","0","0.50000","123","147","-24"
"1963","San Francisco (CA)","2","5","0","0.28571","58","98","-40"
"1964","New York (NY)","0","2","0","0.00000","20","48","-28"
"1965","Adelphi (NY)","4","8","0","0.33333","198","216","-18"
"1966","Fairfield (CT)","18","22","2","0.45238","545","652","-107"
"1967","La Salle (PA)","25","31","0","0.44643","846","1080","-234"
"1968","Centenary (LA)","17","42","2","0.29508","726","1393","-667"
"1969","Bluffton (OH)","33","43","0","0.43421","1058","1548","-490"
"1970","Saint John's (NY)","35","54","1","0.39444","1379","1783","-404"
"1971","Bluffton (OH)","43","45","1","0.48876","1360","1384","-24"
"1972","Marquette (WI)","39","44","2","0.47059","1217","1351","-134"
"1973","Brooklyn (NY)","30","52","1","0.36747","1007","1611","-604"
"1974","Marquette (WI)","33","36","3","0.47917","959","1169","-210"
"1975","Marquette (WI)","31","22","4","0.57895","1042","932","110"
"1976","Bluffton (OH)","23","33","1","0.41228","862","1186","-324"
"1977","Manhattan (NY)","14","28","1","0.33721","568","923","-355"
"1978","Fairfield (CT)","5","7","1","0.42308","194","203","-9"
"1979","Fairfield (CT)","7","8","0","0.46667","247","260","-13"
"1980","Westfield St. (MA)","6","5","4","0.53333","184","196","-12"
"1981","San Francisco (CA)","17","14","0","0.54839","567","498","69"
"1982","Manhattan (NY)","18","16","0","0.52941","580","644","-64"
"1983","SUNY-Stony Brook (NY)","15","11","0","0.57692","474","453","21"
"1984","Stonehill (MA)","7","12","0","0.36842","231","439","-208"
"1985","Manhattan (NY)","10","10","0","0.50000","313","316","-3"
"1986","Marquette (WI)","13","17","0","0.43333","497","564","-67"
"1987","Marquette (WI)","10","17","0","0.37037","389","487","-98"
"1988","Marquette (WI)","1","5","0","0.16667","80","125","-45"
"1989","Marquette (WI)","4","4","0","0.50000","209","151","58"
"1990","Marquette (WI)","1","7","0","0.12500","80","180","-100"
"1991","Marquette (WI)","1","5","0","0.16667","106","182","-76"
"1992","Marquette (WI)","2","5","0","0.28571","81","129","-48"
"1993","Marquette (WI)","7","1","0","0.87500","212","126","86"
"1994","Marquette (WI)","1","6","0","0.14286","125","184","-59"
"1995","Marquette (WI)","3","4","0","0.42857","141","191","-50"
"1996","Marquette (WI)","3","5","0","0.37500","139","182","-43"
"1998","Madison College (WI)","2","15","0","0.11765","221","613","-392"
"1999","Marquette (WI)","0","7","0","0.00000","110","298","-188"
"2000","Marquette (WI)","1","5","0","0.16667","60","96","-36"
"2001","Marquette (WI)","2","6","0","0.25000","144","179","-35"
"2002","Marquette (WI)","3","4","0","0.42857","127","208","-81"
"2003","Marquette (WI)","1","6","0","0.14286","71","151","-80"
"2004","Marquette (WI)","0","6","0","0.00000","53","238","-185"
"2005","Marquette (WI)","2","5","0","0.28571","92","226","-134"
"2006","Marquette (WI)","1","6","0","0.14286","62","206","-144"
"2007","Marquette (WI)","2","5","0","0.28571","140","215","-75"
"2008","Marquette (WI)","0","7","0","0.00000","61","304","-243"
"2009","Marquette (WI)","0","1","0","0.00000","0","22","-22"
"1922","Brigham Young (UT)","1","5","0","0.16667","10","184","-174"
"1923","Brigham Young (UT)","2","5","0","0.28571","47","156","-109"
"1924","Brigham Young (UT)","2","3","1","0.41667","44","61","-17"
"1925","Brigham Young (UT)","3","3","0","0.50000","69","81","-12"
"1926","Brigham Young (UT)","1","5","1","0.21429","49","115","-66"
"1927","Brigham Young (UT)","2","4","1","0.35714","105","118","-13"
"1922","Montana St.","4","4","0","0.50000","128","127","1"
"1923","Montana St.","5","4","0","0.55556","272","76","196"
"1924","Montana St.","5","1","1","0.78571","274","18","256"
"1925","Montana St.","6","5","0","0.54545","291","84","207"
"1926","Montana St.","4","2","1","0.64286","52","43","9"
"1927","Montana St.","4","4","0","0.50000","77","104","-27"
"1928","Brigham Young (UT)","3","3","1","0.50000","75","56","19"
"1929","Brigham Young (UT)","6","3","1","0.65000","184","122","62"
"1930","Brigham Young (UT)","6","2","4","0.66667","207","179","28"
"1931","Brigham Young (UT)","4","4","0","0.50000","69","104","-35"
"1932","Brigham Young (UT)","8","1","0","0.88889","188","50","138"
"1933","Brigham Young (UT)","5","4","0","0.55556","81","67","14"
"1934","Brigham Young (UT)","4","5","0","0.44444","144","169","-25"
"1935","Brigham Young (UT)","4","4","0","0.50000","78","90","-12"
"1936","Brigham Young (UT)","4","5","0","0.44444","123","123","0"
"1937","Brigham Young (UT)","6","3","0","0.66667","164","41","123"
"1938","Brigham Young (UT)","4","3","1","0.56250","93","49","44"
"1939","Brigham Young (UT)","5","2","2","0.66667","110","90","20"
"1940","Brigham Young (UT)","2","4","2","0.37500","79","93","-14"
"1941","Brigham Young (UT)","4","3","2","0.55556","136","100","36"
"1946","Brigham Young (UT)","5","4","1","0.55000","94","119","-25"
"1947","Brigham Young (UT)","3","7","0","0.30000","168","182","-14"
"1948","Brigham Young (UT)","5","6","0","0.45455","135","199","-64"
"1942","Brigham Young (UT)","2","5","0","0.28571","55","133","-78"
"1949","Brigham Young (UT)","0","11","0","0.00000","105","372","-267"
"1950","Brigham Young (UT)","4","5","1","0.45000","169","292","-123"
"1951","Brigham Young (UT)","6","3","1","0.65000","215","184","31"
"1952","Brigham Young (UT)","4","6","0","0.40000","154","240","-86"
"1953","Brigham Young (UT)","2","7","1","0.25000","172","228","-56"
"1954","Brigham Young (UT)","1","8","0","0.11111","96","188","-92"
"1955","Brigham Young (UT)","1","9","0","0.10000","104","300","-196"
"1950","Rhode Island","3","5","0","0.37500","125","201","-76"
"1952","Rhode Island","7","1","0","0.87500","215","85","130"
"1953","Rhode Island","6","2","0","0.75000","148","100","48"
"1954","Rhode Island","6","2","0","0.75000","164","111","53"
"1955","Rhode Island","6","1","2","0.77778","162","67","95"
"1956","Brigham Young (UT)","2","7","1","0.25000","147","232","-85"
"1957","Brigham Young (UT)","5","3","2","0.60000","134","138","-4"
"1958","Brigham Young (UT)","6","4","0","0.60000","189","150","39"
"1972","Bentley (MA)","3","2","1","0.58333","72","50","22"
"1973","Bentley (MA)","2","3","0","0.40000","114","118","-4"
"1974","Bentley (MA)","3","3","0","0.50000","94","98","-4"
"1975","Bentley (MA)","1","6","0","0.14286","73","160","-87"
"1959","Brigham Young (UT)","3","7","0","0.30000","101","169","-68"
"1960","Brigham Young (UT)","3","8","0","0.27273","102","207","-105"
"1961","Brigham Young (UT)","2","8","0","0.20000","130","289","-159"
"1962","Brigham Young (UT)","4","6","0","0.40000","197","170","27"
"1963","Brigham Young (UT)","2","8","0","0.20000","91","222","-131"
"1964","Brigham Young (UT)","3","6","1","0.35000","173","210","-37"
"1965","Brigham Young (UT)","6","4","0","0.60000","229","178","51"
"1966","Brigham Young (UT)","8","2","0","0.80000","269","163","106"
"1967","Brigham Young (UT)","6","4","0","0.60000","278","215","63"
"1968","Brigham Young (UT)","2","8","0","0.20000","179","247","-68"
"1969","Brigham Young (UT)","6","4","0","0.60000","186","158","28"
"1970","Brigham Young (UT)","3","8","0","0.27273","138","255","-117"
"1971","Brigham Young (UT)","5","6","0","0.45455","227","199","28"
"1972","Texas-El Paso","1","3","0","0.25000","78","148","-70"
"1973","Texas-El Paso","0","11","0","0.00000","142","544","-402"
"1972","Brigham Young (UT)","7","4","0","0.63636","251","227","24"
"1973","Brigham Young (UT)","5","6","0","0.45455","334","248","86"
"1974","Brigham Young (UT)","7","4","1","0.62500","302","199","103"
"1975","Brigham Young (UT)","6","5","0","0.54545","244","228","16"
"1976","Brigham Young (UT)","9","3","0","0.75000","372","231","141"
"1977","Brigham Young (UT)","9","2","0","0.81818","433","165","268"
"1978","Brigham Young (UT)","9","4","0","0.69231","320","199","121"
"1979","Brigham Young (UT)","11","1","0","0.91667","484","163","321"
"1980","Brigham Young (UT)","12","1","0","0.92308","606","243","363"
"1981","Brigham Young (UT)","11","2","0","0.84615","503","256","247"
"1982","Brigham Young (UT)","8","4","0","0.66667","375","214","161"
"1983","Brigham Young (UT)","11","1","0","0.91667","505","247","258"
"1984","Brigham Young (UT)","13","0","0","1.00000","456","183","273"
"1985","Brigham Young (UT)","11","3","0","0.78571","442","186","256"
"1986","Brigham Young (UT)","8","5","0","0.61538","310","236","74"
"1987","Brigham Young (UT)","9","4","0","0.69231","350","293","57"
"1988","Brigham Young (UT)","9","4","0","0.69231","421","281","140"
"1989","Brigham Young (UT)","10","3","0","0.76923","523","369","154"
"1990","Brigham Young (UT)","10","3","0","0.76923","524","350","174"
"1991","Brigham Young (UT)","8","3","2","0.69231","433","321","112"
"1992","Brigham Young (UT)","8","5","0","0.61538","375","298","77"
"1993","Brigham Young (UT)","6","6","0","0.50000","411","435","-24"
"1994","Brigham Young (UT)","10","3","0","0.76923","385","300","85"
"1995","Brigham Young (UT)","7","4","0","0.63636","307","268","39"
"1996","Brigham Young (UT)","14","1","0","0.93333","590","277","313"
"1997","Brigham Young (UT)","6","5","0","0.54545","250","254","-4"
"1998","Brigham Young (UT)","9","5","0","0.64286","402","290","112"
"1999","Brigham Young (UT)","8","4","0","0.66667","335","251","84"
"2000","Brigham Young (UT)","6","6","0","0.50000","280","310","-30"
"1996","Louisiana Tech","6","5","0","0.54545","351","342","9"
"1997","Louisiana Tech","9","2","0","0.81818","364","281","83"
"1998","Louisiana Tech","6","6","0","0.50000","493","402","91"
"2001","Brigham Young (UT)","12","2","0","0.85714","618","424","194"
"2002","Brigham Young (UT)","5","7","0","0.41667","272","333","-61"
"2003","Brigham Young (UT)","4","8","0","0.33333","196","310","-114"
"2004","Brigham Young (UT)","5","6","0","0.45455","267","295","-28"
"2005","Brigham Young (UT)","6","6","0","0.50000","396","351","45"
"2006","Brigham Young (UT)","11","2","0","0.84615","478","191","287"
"2007","Brigham Young (UT)","11","2","0","0.84615","391","241","150"
"2008","Brigham Young (UT)","10","3","0","0.76923","445","285","160"
"2009","Brigham Young (UT)","11","2","0","0.84615","461","280","181"
"2010","Brigham Young (UT)","7","6","0","0.53846","340","281","59"
"2011","Brigham Young (UT)","10","3","0","0.76923","391","265","126"
"2012","Brigham Young (UT)","8","5","0","0.61538","373","182","191"
"2013","Brigham Young (UT)","8","5","0","0.61538","392","287","105"
"1897","Buffalo (NY)","8","0","0","1.00000","162","12","150"
"1869","Rutgers (NJ)","2","2","0","0.50000","18","18","0"
"1870","Rutgers (NJ)","2","2","0","0.50000","17","17","0"
"1872","Columbia (NY)","5","4","0","0.55556","22","16","6"
"1873","Rutgers (NJ)","7","4","1","0.62500","31","26","5"
"1874","Harvard (MA)","9","7","0","0.56250","54","41","13"
"1875","Harvard (MA)","12","6","2","0.65000","52","29","23"
"1876","Harvard (MA)","13","8","1","0.61364","45","29","16"
"1877","Harvard (MA)","9","7","3","0.55263","31","21","10"
"1878","Pennsylvania","14","9","5","0.58929","42","24","18"
"1879","Harvard (MA)","13","9","12","0.55882","46","27","19"
"1880","Harvard (MA)","18","11","4","0.60606","75","53","22"
"1881","Rutgers (NJ)","22","18","8","0.54167","70","47","23"
"1882","Rutgers (NJ)","41","28","2","0.59155","176","111","65"
"1883","Rutgers (NJ)","38","32","1","0.54225","1288","965","323"
"1884","Pennsylvania","47","29","5","0.61111","1728","1184","544"
"1885","Michigan","34","17","4","0.65455","1437","612","825"
"1886","Lehigh (PA)","48","21","4","0.68493","1850","637","1213"
"1887","California","67","35","3","0.65238","2660","935","1725"
"1888","Princeton (NJ)","70","56","6","0.55303","2468","1899","569"
"1889","Brown (RI)","82","51","11","0.60764","2879","1796","1083"
"1890","Brown (RI)","77","76","9","0.50309","3002","2455","547"
"1891","Southern California","94","76","13","0.54918","2813","2189","624"
"1892","Minnesota","93","80","9","0.53571","2972","2394","578"
"1893","Duke (NC)","79","94","9","0.45879","2176","2912","-736"
"1894","Colorado St.","50","62","4","0.44828","1161","1518","-357"
"1895","Boston (MA)","31","44","11","0.42442","692","1031","-339"
"1896","Rhode Island","54","62","12","0.46875","1126","1201","-75"
"1897","Boston (MA)","32","40","6","0.44872","792","785","7"
"1898","Miami (OH)","47","23","4","0.66216","921","644","277"
"1899","New Hampshire","33","32","6","0.50704","571","522","49"
"1900","New Hampshire","22","35","11","0.40441","442","686","-244"
"1901","Marshall (WV)","18","34","3","0.35455","302","917","-615"
"1902","Saint John's (MN)","9","22","4","0.31429","148","460","-312"
"1903","Wichita St. (KS)","14","25","2","0.36585","376","546","-170"
"1904","Oklahoma St.","11","14","1","0.44231","194","394","-200"
"1905","Miami (OH)","7","25","5","0.25676","245","494","-249"
"1906","Rensselaer Tech (NY)","3","7","4","0.35714","92","107","-15"
"1907","Marshall (WV)","5","10","2","0.35294","71","238","-167"
"1908","Fort Hays St. (KS)","5","6","1","0.45833","56","91","-35"
"1909","Fort Hays St. (KS)","1","3","1","0.30000","12","68","-56"
"1910","Texas St.","0","1","0","0.00000","0","19","-19"
"1912","Fort Hays St. (KS)","1","2","0","0.33333","20","132","-112"
"1913","Eureka (IL)","1","6","0","0.14286","39","203","-164"
"1914","Eureka (IL)","3","4","0","0.42857","57","201","-144"
"1915","Texas St.","1","1","1","0.50000","13","20","-7"
"1916","Texas St.","0","2","1","0.16667","0","106","-106"
"1917","Boston (MA)","4","4","0","0.50000","73","136","-63"
"1918","Monmouth (IL)","1","7","0","0.12500","26","137","-111"
"1930","Troy (AL)","1","2","0","0.33333","7","73","-66"
"2013","Grambling St. (LA)","0","1","0","0.00000","0","0","0"
"1903","Buffalo (NY)","4","4","0","0.50000","51","129","-78"
"1910","Franklin & Marshall (PA)","4","3","2","0.55556","88","46","42"
"1914","West Virginia Wesleyan","4","3","0","0.57143","88","101","-13"
"1915","Buffalo (NY)","4","3","0","0.57143","53","62","-9"
"1916","Buffalo (NY)","3","5","2","0.40000","24","88","-64"
"1917","Buffalo (NY)","4","4","0","0.50000","125","59","66"
"1918","Buffalo (NY)","6","1","0","0.85714","234","40","194"
"1919","Buffalo (NY)","0","5","1","0.08333","12","114","-102"
"1920","Buffalo (NY)","1","4","0","0.20000","17","60","-43"
"1921","Buffalo (NY)","2","3","2","0.42857","74","105","-31"
"1922","Buffalo (NY)","1","5","0","0.16667","38","86","-48"
"1923","Buffalo (NY)","2","5","1","0.31250","66","115","-49"
"1924","Buffalo (NY)","1","7","0","0.12500","27","139","-112"
"1925","Buffalo (NY)","3","4","1","0.43750","18","122","-104"
"1926","Buffalo (NY)","0","8","0","0.00000","26","237","-211"
"1927","Buffalo (NY)","0","6","1","0.07143","7","212","-205"
"1928","Buffalo (NY)","1","6","0","0.14286","18","178","-160"
"1929","Buffalo (NY)","5","2","0","0.71429","92","74","18"
"1930","Buffalo (NY)","3","5","0","0.37500","79","210","-131"
"1931","Buffalo (NY)","2","6","0","0.25000","64","171","-107"
"1932","Buffalo (NY)","1","5","1","0.21429","19","208","-189"
"1933","Buffalo (NY)","2","3","2","0.42857","38","95","-57"
"1939","Canisius (NY)","4","1","1","0.75000","66","21","45"
"1940","Canisius (NY)","5","3","0","0.62500","86","79","7"
"1941","Canisius (NY)","3","4","1","0.43750","98","137","-39"
"1942","Canisius (NY)","4","3","1","0.56250","117","66","51"
"1948","Canisius (NY)","7","2","1","0.75000","242","109","133"
"1949","Canisius (NY)","5","2","0","0.71429","132","110","22"
"1950","Buffalo (NY)","5","3","0","0.62500","191","129","62"
"1951","Buffalo (NY)","4","4","0","0.50000","144","189","-45"
"1931","Central Michigan","4","3","0","0.57143","95","58","37"
"1932","Central Michigan","3","4","1","0.43750","95","66","29"
"1933","Central Michigan","5","2","1","0.68750","164","58","106"
"1934","Buffalo (NY)","2","4","1","0.35714","35","106","-71"
"1935","Buffalo (NY)","2","6","0","0.25000","26","213","-187"
"1936","Buffalo (NY)","5","3","0","0.62500","121","127","-6"
"1937","Buffalo (NY)","4","4","0","0.50000","88","94","-6"
"1938","Buffalo (NY)","2","6","0","0.25000","81","158","-77"
"1939","Buffalo (NY)","0","7","0","0.00000","7","126","-119"
"1940","Buffalo (NY)","3","5","0","0.37500","47","116","-69"
"1941","Buffalo (NY)","3","4","1","0.43750","55","75","-20"
"1942","Buffalo (NY)","6","2","0","0.75000","215","52","163"
"1946","Buffalo (NY)","7","2","0","0.77778","224","91","133"
"1947","Buffalo (NY)","8","1","0","0.88889","258","79","179"
"1948","Buffalo (NY)","6","1","1","0.81250","235","105","130"
"1949","Buffalo (NY)","6","3","0","0.66667","183","93","90"
"1952","Buffalo (NY)","1","7","0","0.12500","59","201","-142"
"1953","Buffalo (NY)","1","5","1","0.21429","44","181","-137"
"1954","Buffalo (NY)","2","7","0","0.22222","72","247","-175"
"1955","Buffalo (NY)","4","4","1","0.50000","186","118","68"
"1956","Buffalo (NY)","5","3","0","0.62500","227","122","105"
"1957","Buffalo (NY)","5","4","0","0.55556","108","101","7"
"1958","Buffalo (NY)","8","1","0","0.88889","236","101","135"
"1959","Buffalo (NY)","8","1","0","0.88889","279","93","186"
"1960","Buffalo (NY)","4","6","0","0.40000","213","238","-25"
"1961","Buffalo (NY)","4","5","0","0.44444","136","163","-27"
"1962","Buffalo (NY)","6","3","0","0.66667","159","148","11"
"1963","Buffalo (NY)","5","3","1","0.61111","120","85","35"
"1964","Buffalo (NY)","4","4","1","0.50000","177","97","80"
"1965","Buffalo (NY)","5","3","2","0.60000","145","78","67"
"1966","Buffalo (NY)","5","5","0","0.50000","220","172","48"
"1967","Buffalo (NY)","6","4","0","0.60000","241","191","50"
"1968","Buffalo (NY)","7","3","0","0.70000","185","183","2"
"1969","Northern Illinois","3","7","0","0.30000","191","284","-93"
"1970","Northern Illinois","3","7","0","0.30000","168","281","-113"
"1969","Buffalo (NY)","6","3","0","0.66667","174","89","85"
"1970","Buffalo (NY)","2","9","0","0.18182","133","299","-166"
"1977","Buffalo (NY)","0","3","1","0.12500","36","87","-51"
"1978","Buffalo (NY)","3","6","0","0.33333","164","211","-47"
"1979","Buffalo (NY)","4","5","0","0.44444","117","177","-60"
"1980","Buffalo (NY)","6","5","0","0.54545","138","241","-103"
"1981","Buffalo (NY)","5","5","0","0.50000","187","168","19"
"1982","Buffalo (NY)","5","5","0","0.50000","291","180","111"
"1983","Buffalo (NY)","8","2","0","0.80000","232","150","82"
"1984","Buffalo (NY)","6","4","0","0.60000","192","140","52"
"1985","Buffalo (NY)","4","6","0","0.40000","188","206","-18"
"1986","Buffalo (NY)","9","2","0","0.81818","264","182","82"
"1987","Buffalo (NY)","3","7","0","0.30000","151","204","-53"
"1988","Buffalo (NY)","2","8","0","0.20000","148","237","-89"
"1989","Buffalo (NY)","4","6","0","0.40000","198","217","-19"
"1990","Buffalo (NY)","2","8","0","0.20000","188","330","-142"
"1991","Buffalo (NY)","3","7","0","0.30000","231","304","-73"
"1992","Buffalo (NY)","4","6","0","0.40000","319","395","-76"
"1993","Buffalo (NY)","2","9","0","0.18182","190","359","-169"
"1994","Buffalo (NY)","3","8","0","0.27273","156","331","-175"
"1995","Buffalo (NY)","3","8","0","0.27273","198","259","-61"
"1996","Buffalo (NY)","8","3","0","0.72727","271","241","30"
"1997","Buffalo (NY)","2","9","0","0.18182","229","421","-192"
"1998","Buffalo (NY)","4","7","0","0.36364","315","340","-25"
"1999","Buffalo (NY)","0","11","0","0.00000","130","426","-296"
"2000","Buffalo (NY)","2","9","0","0.18182","177","452","-275"
"1990","Cornell (NY)","7","3","0","0.70000","263","212","51"
"1991","Cornell (NY)","5","5","0","0.50000","181","218","-37"
"1992","Cornell (NY)","7","3","0","0.70000","263","183","80"
"1993","Cornell (NY)","4","6","0","0.40000","213","158","55"
"1994","Cornell (NY)","6","4","0","0.60000","193","190","3"
"1995","Cornell (NY)","6","4","0","0.60000","261","222","39"
"1996","Cornell (NY)","4","6","0","0.40000","221","280","-59"
"1997","Cornell (NY)","6","4","0","0.60000","269","261","8"
"2001","Buffalo (NY)","3","8","0","0.27273","205","286","-81"
"2002","Buffalo (NY)","1","11","0","0.08333","214","416","-202"
"2003","Buffalo (NY)","1","11","0","0.08333","177","445","-268"
"2004","Buffalo (NY)","2","9","0","0.18182","197","351","-154"
"2005","Buffalo (NY)","1","10","0","0.09091","110","327","-217"
"2006","Buffalo (NY)","2","10","0","0.16667","220","431","-211"
"2007","Buffalo (NY)","5","7","0","0.41667","291","331","-40"
"2008","Buffalo (NY)","8","6","0","0.57143","424","395","29"
"2009","Buffalo (NY)","5","7","0","0.41667","289","285","4"
"2010","Kansas","3","9","0","0.25000","205","413","-208"
"2011","Kansas","2","10","0","0.16667","268","525","-257"
"2012","Liberty (VA)","6","5","0","0.54545","299","244","55"
"2013","Liberty (VA)","8","4","0","0.66667","447","211","236"
"2006","Central Michigan","1","0","0","1.00000","31","14","17"
"2009","Cincinnati (OH)","0","1","0","0.00000","24","51","-27"
"2010","Buffalo (NY)","2","10","0","0.16667","170","334","-164"
"2011","Buffalo (NY)","3","9","0","0.25000","266","353","-87"
"2012","Buffalo (NY)","4","8","0","0.33333","255","342","-87"
"2013","Buffalo (NY)","8","5","0","0.61538","394","317","77"
"1885","California","6","2","1","0.72222","88","35","53"
"1886","California","4","0","0","1.00000","66","12","54"
"1869","Rutgers (NJ)","2","2","0","0.50000","18","18","0"
"1870","Rutgers (NJ)","2","2","0","0.50000","17","17","0"
"1872","Columbia (NY)","5","4","0","0.55556","22","16","6"
"1873","Rutgers (NJ)","7","4","1","0.62500","31","26","5"
"1874","Harvard (MA)","9","7","0","0.56250","54","41","13"
"1875","Harvard (MA)","12","6","2","0.65000","52","29","23"
"1876","Harvard (MA)","13","8","1","0.61364","45","29","16"
"1877","Harvard (MA)","9","7","3","0.55263","31","21","10"
"1878","Pennsylvania","14","9","5","0.58929","42","24","18"
"1879","Harvard (MA)","13","9","12","0.55882","46","27","19"
"1880","Harvard (MA)","18","11","4","0.60606","75","53","22"
"1881","Rutgers (NJ)","22","18","8","0.54167","70","47","23"
"1882","Rutgers (NJ)","41","28","2","0.59155","176","111","65"
"1883","Rutgers (NJ)","38","32","1","0.54225","1288","965","323"
"1884","Pennsylvania","47","29","5","0.61111","1728","1184","544"
"1885","Michigan","34","17","4","0.65455","1437","612","825"
"1886","Lehigh (PA)","48","21","4","0.68493","1850","637","1213"
"1887","California","67","35","3","0.65238","2660","935","1725"
"1888","Princeton (NJ)","70","56","6","0.55303","2468","1899","569"
"1889","Brown (RI)","82","51","11","0.60764","2879","1796","1083"
"1890","Brown (RI)","77","76","9","0.50309","3002","2455","547"
"1891","Southern California","94","76","13","0.54918","2813","2189","624"
"1892","Minnesota","93","80","9","0.53571","2972","2394","578"
"1893","Duke (NC)","79","94","9","0.45879","2176","2912","-736"
"1894","Colorado St.","50","62","4","0.44828","1161","1518","-357"
"1895","Boston (MA)","31","44","11","0.42442","692","1031","-339"
"1896","Rhode Island","54","62","12","0.46875","1126","1201","-75"
"1897","Boston (MA)","32","40","6","0.44872","792","785","7"
"1898","Miami (OH)","47","23","4","0.66216","921","644","277"
"1899","New Hampshire","33","32","6","0.50704","571","522","49"
"1900","New Hampshire","22","35","11","0.40441","442","686","-244"
"1901","Marshall (WV)","18","34","3","0.35455","302","917","-615"
"1902","Saint John's (MN)","9","22","4","0.31429","148","460","-312"
"1903","Wichita St. (KS)","14","25","2","0.36585","376","546","-170"
"1904","Oklahoma St.","11","14","1","0.44231","194","394","-200"
"1905","Miami (OH)","7","25","5","0.25676","245","494","-249"
"1906","Rensselaer Tech (NY)","3","7","4","0.35714","92","107","-15"
"1907","Marshall (WV)","5","10","2","0.35294","71","238","-167"
"1908","Fort Hays St. (KS)","5","6","1","0.45833","56","91","-35"
"1909","Fort Hays St. (KS)","1","3","1","0.30000","12","68","-56"
"1910","Texas St.","0","1","0","0.00000","0","19","-19"
"1912","Fort Hays St. (KS)","1","2","0","0.33333","20","132","-112"
"1913","Eureka (IL)","1","6","0","0.14286","39","203","-164"
"1914","Eureka (IL)","3","4","0","0.42857","57","201","-144"
"1915","Texas St.","1","1","1","0.50000","13","20","-7"
"1916","Texas St.","0","2","1","0.16667","0","106","-106"
"1917","Boston (MA)","4","4","0","0.50000","73","136","-63"
"1918","Monmouth (IL)","1","7","0","0.12500","26","137","-111"
"1930","Troy (AL)","1","2","0","0.33333","7","73","-66"
"2013","Grambling St. (LA)","0","1","0","0.00000","0","0","0"
"1892","California","2","1","1","0.62500","44","34","10"
"1893","California","4","1","1","0.75000","88","50","38"
"1894","Lehigh (PA)","5","9","0","0.35714","120","236","-116"
"1895","Minnesota","7","3","0","0.70000","136","58","78"
"1894","California","0","2","2","0.25000","12","46","-34"
"1908","New Hampshire","1","7","0","0.12500","31","97","-66"
"1895","California","3","1","1","0.70000","46","10","36"
"1896","California","6","2","2","0.70000","150","56","94"
"1897","Yale (CT)","9","0","2","0.90909","170","35","135"
"1898","Yale (CT)","9","2","0","0.81818","146","34","112"
"1897","California","0","3","2","0.20000","8","58","-50"
"1898","California","8","0","2","0.90000","221","5","216"
"1899","California","7","1","1","0.83333","142","2","140"
"1900","Navy (MD)","6","3","0","0.66667","106","51","55"
"1902","Princeton (NJ)","8","1","0","0.88889","164","17","147"
"1900","California","4","2","1","0.64286","53","7","46"
"1898","Oregon","3","1","0","0.75000","167","21","146"
"1899","Oregon","4","2","1","0.64286","108","17","91"
"1901","California","9","0","1","0.95000","106","15","91"
"1902","California","8","0","0","1.00000","168","12","156"
"1903","California","6","1","2","0.77778","128","12","116"
"1900","Nevada","4","2","1","0.64286","78","34","44"
"1904","California","6","1","1","0.81250","75","24","51"
"1905","California","4","1","2","0.71429","75","12","63"
"1915","California","8","5","0","0.61538","242","184","58"
"1909","Pennsylvania","7","1","2","0.80000","146","38","108"
"1910","Pennsylvania","9","1","1","0.86364","184","19","165"
"1911","Pennsylvania","7","4","0","0.63636","131","83","48"
"1912","Pennsylvania","7","4","0","0.63636","191","106","85"
"1913","Purdue (IN)","4","1","2","0.71429","171","20","151"
"1914","Purdue (IN)","5","2","0","0.71429","157","63","94"
"1915","Purdue (IN)","3","3","1","0.50000","62","62","0"
"1916","California","6","4","1","0.59091","192","103","89"
"1917","California","5","5","1","0.50000","149","104","45"
"1918","California","7","2","0","0.77778","187","62","125"
"1919","California","6","2","1","0.72222","147","64","83"
"1920","California","9","0","0","1.00000","510","14","496"
"1921","California","9","0","1","0.95000","312","33","279"
"1922","California","9","0","0","1.00000","398","34","364"
"1923","California","9","0","1","0.95000","182","7","175"
"1924","California","8","0","2","0.90000","162","51","111"
"1925","California","6","3","0","0.66667","192","49","143"
"1926","California","3","6","0","0.33333","105","167","-62"
"1927","California","7","3","0","0.70000","184","64","120"
"1928","California","6","2","2","0.70000","141","36","105"
"1929","California","7","1","1","0.83333","155","78","77"
"1930","California","4","5","0","0.44444","87","170","-83"
"1922","William & Mary (VA)","6","3","0","0.66667","171","80","91"
"1923","Indiana","3","4","0","0.42857","48","117","-69"
"1924","Indiana","4","4","0","0.50000","147","100","47"
"1925","Indiana","3","4","1","0.43750","102","115","-13"
"1926","Navy (MD)","9","0","1","0.95000","236","88","148"
"1927","Navy (MD)","6","3","0","0.66667","192","84","108"
"1928","Navy (MD)","5","3","1","0.61111","121","21","100"
"1929","Navy (MD)","6","2","2","0.70000","233","59","174"
"1930","Navy (MD)","6","5","0","0.54545","148","117","31"
"1931","California","8","2","0","0.80000","106","41","65"
"1932","California","7","3","2","0.66667","169","89","80"
"1933","California","6","3","2","0.63636","161","39","122"
"1934","California","6","6","0","0.50000","176","110","66"
"1920","Washington","1","5","0","0.16667","54","83","-29"
"1922","South Dakota","3","6","1","0.35000","69","167","-98"
"1923","South Dakota","4","3","1","0.56250","119","59","60"
"1924","South Dakota","6","2","0","0.75000","108","51","57"
"1925","South Dakota","3","5","0","0.37500","93","39","54"
"1926","South Dakota","5","3","1","0.61111","90","76","14"
"1935","California","9","1","0","0.90000","163","22","141"
"1936","California","6","5","0","0.54545","147","74","73"
"1937","California","10","0","1","0.95455","214","33","181"
"1938","California","10","1","0","0.90909","219","44","175"
"1939","California","3","7","0","0.30000","93","134","-41"
"1940","California","4","6","0","0.40000","84","128","-44"
"1941","California","4","5","0","0.44444","107","71","36"
"1942","California","5","5","0","0.50000","98","107","-9"
"1943","California","4","6","0","0.40000","99","143","-44"
"1944","California","3","6","1","0.35000","78","149","-71"
"1924","North Carolina St.","2","6","2","0.30000","43","147","-104"
"1925","Nevada","4","3","1","0.56250","107","115","-8"
"1926","Nevada","4","4","0","0.50000","116","119","-3"
"1927","Nevada","2","6","1","0.27778","54","209","-155"
"1928","Nevada","0","7","1","0.06250","31","170","-139"
"1936","Santa Clara (CA)","8","1","0","0.88889","139","36","103"
"1937","Santa Clara (CA)","9","0","0","1.00000","163","9","154"
"1938","Santa Clara (CA)","6","2","0","0.75000","97","26","71"
"1939","Santa Clara (CA)","5","1","3","0.72222","117","40","77"
"1940","Santa Clara (CA)","6","1","1","0.81250","154","46","108"
"1941","Santa Clara (CA)","6","3","0","0.66667","170","103","67"
"1942","Santa Clara (CA)","7","2","0","0.77778","101","52","49"
"1945","California","4","5","1","0.45000","93","107","-14"
"1956","Air Force (CO)","6","2","1","0.72222","293","101","192"
"1957","Air Force (CO)","3","6","1","0.35000","125","184","-59"
"1946","California","2","7","0","0.22222","112","169","-57"
"1929","Oklahoma St.","4","3","2","0.55556","107","79","28"
"1930","Oklahoma St.","7","2","1","0.75000","124","40","84"
"1931","Oklahoma St.","8","2","1","0.77273","183","52","131"
"1932","Oklahoma St.","9","1","2","0.83333","178","48","130"
"1933","Oklahoma St.","6","2","1","0.72222","132","57","75"
"1934","Kansas St.","7","2","1","0.75000","149","81","68"
"1935","Northwestern (IL)","4","3","1","0.56250","90","79","11"
"1936","Northwestern (IL)","7","1","0","0.87500","132","73","59"
"1937","Northwestern (IL)","4","4","0","0.50000","68","40","28"
"1938","Northwestern (IL)","4","2","2","0.62500","93","32","61"
"1939","Northwestern (IL)","3","4","1","0.43750","47","67","-20"
"1940","Northwestern (IL)","6","2","0","0.75000","170","64","106"
"1941","Northwestern (IL)","5","3","0","0.62500","173","67","106"
"1942","Northwestern (IL)","1","9","0","0.10000","96","209","-113"
"1943","Northwestern (IL)","6","2","0","0.75000","189","64","125"
"1944","Northwestern (IL)","1","7","1","0.16667","102","160","-58"
"1945","Northwestern (IL)","4","4","1","0.50000","127","148","-21"
"1946","Northwestern (IL)","4","4","1","0.50000","156","136","20"
"1947","California","9","1","0","0.90000","275","111","164"
"1948","California","10","1","0","0.90909","291","100","191"
"1949","California","10","1","0","0.90909","319","131","188"
"1950","California","9","1","1","0.86364","224","90","134"
"1951","California","8","2","0","0.80000","307","166","141"
"1952","California","7","3","0","0.70000","247","127","120"
"1953","California","4","4","2","0.50000","220","170","50"
"1954","California","5","5","0","0.50000","249","177","72"
"1955","California","2","7","1","0.25000","107","216","-109"
"1956","California","3","7","0","0.30000","135","181","-46"
"1956","Nebraska","4","6","0","0.40000","125","206","-81"
"1957","California","1","9","0","0.10000","109","176","-67"
"1958","California","7","4","0","0.63636","207","200","7"
"1959","California","2","8","0","0.20000","115","223","-108"
"1960","Illinois","5","4","0","0.55556","140","117","23"
"1961","Illinois","0","9","0","0.00000","53","289","-236"
"1962","Illinois","2","7","0","0.22222","75","234","-159"
"1963","Illinois","8","1","1","0.85000","170","96","74"
"1964","Illinois","6","3","0","0.66667","142","100","42"
"1965","Illinois","6","4","0","0.60000","235","118","117"
"1966","Illinois","4","6","0","0.40000","173","193","-20"
"1973","Miami (FL)","5","6","0","0.45455","163","240","-77"
"1974","Miami (FL)","6","5","0","0.54545","167","190","-23"
"1958","New Mexico","7","3","0","0.70000","210","185","25"
"1959","New Mexico","7","3","0","0.70000","260","135","125"
"1960","California","2","7","1","0.25000","93","195","-102"
"1961","California","1","8","1","0.15000","118","268","-150"
"1962","California","1","9","0","0.10000","143","247","-104"
"1963","California","4","5","1","0.45000","195","213","-18"
"1964","William & Mary (VA)","4","6","0","0.40000","138","194","-56"
"1965","William & Mary (VA)","6","4","0","0.60000","197","163","34"
"1966","William & Mary (VA)","5","4","1","0.55000","176","144","32"
"1967","William & Mary (VA)","5","4","1","0.55000","196","177","19"
"1968","William & Mary (VA)","3","7","0","0.30000","97","195","-98"
"1964","California","3","7","0","0.30000","152","187","-35"
"1965","California","5","5","0","0.50000","125","194","-69"
"1966","California","3","7","0","0.30000","131","197","-66"
"1967","California","5","5","0","0.50000","155","195","-40"
"1968","California","7","3","1","0.68182","243","114","129"
"1969","California","5","5","0","0.50000","180","182","-2"
"1970","California","6","5","0","0.54545","272","249","23"
"1971","California","6","5","0","0.54545","186","262","-76"
"1972","California","3","8","0","0.27273","228","314","-86"
"1973","California","4","7","0","0.36364","245","380","-135"
"1974","California","7","3","1","0.68182","276","213","63"
"1975","California","8","3","0","0.72727","330","233","97"
"1976","California","5","6","0","0.45455","230","226","4"
"1977","California","8","3","0","0.72727","300","211","89"
"1980","Illinois","3","7","1","0.31818","241","326","-85"
"1981","Illinois","7","4","0","0.63636","287","288","-1"
"1982","Illinois","7","5","0","0.58333","338","229","109"
"1983","Illinois","10","2","0","0.83333","347","213","134"
"1984","Illinois","7","4","0","0.63636","323","209","114"
"1985","Illinois","6","5","1","0.54167","304","334","-30"
"1986","Illinois","4","7","0","0.36364","189","299","-110"
"1987","Illinois","3","7","1","0.31818","153","208","-55"
"2013","Albany St. (GA)","6","4","0","0.60000","255","174","81"
"1978","California","6","5","0","0.54545","236","289","-53"
"1979","California","7","5","0","0.58333","257","194","63"
"1980","California","3","8","0","0.27273","194","328","-134"
"1981","California","2","9","0","0.18182","197","287","-90"
"1982","California","7","4","0","0.63636","220","233","-13"
"1983","California","5","5","1","0.50000","242","227","15"
"1984","California","2","9","0","0.18182","150","264","-114"
"1985","California","4","7","0","0.36364","233","265","-32"
"1986","California","2","9","0","0.18182","145","325","-180"
"1976","Utah St.","3","8","0","0.27273","170","263","-93"
"1977","Utah St.","4","7","0","0.36364","177","249","-72"
"1978","Utah St.","7","4","0","0.63636","269","214","55"
"1979","Utah St.","8","2","1","0.77273","347","270","77"
"1980","Utah St.","6","5","0","0.54545","290","255","35"
"1981","Utah St.","5","5","1","0.50000","204","210","-6"
"1982","Utah St.","5","6","0","0.45455","192","262","-70"
"1987","California","3","6","2","0.36364","239","267","-28"
"1988","California","5","5","1","0.50000","243","244","-1"
"1989","California","4","7","0","0.36364","200","288","-88"
"1990","California","7","4","1","0.62500","325","341","-16"
"1991","California","10","2","0","0.83333","443","239","204"
"1992","Arizona St.","6","5","0","0.54545","235","185","50"
"1993","Arizona St.","6","5","0","0.54545","282","248","34"
"1994","Arizona St.","3","8","0","0.27273","242","347","-105"
"1995","Arizona St.","6","5","0","0.54545","308","330","-22"
"1996","Arizona St.","11","1","0","0.91667","488","216","272"
"1997","Arizona St.","9","3","0","0.75000","324","210","114"
"1998","Arizona St.","5","6","0","0.45455","333","338","-5"
"1999","Arizona St.","7","5","0","0.58333","285","311","-26"
"2000","Arizona St.","6","6","0","0.50000","313","303","10"
"1986","Idaho","8","4","0","0.66667","307","244","63"
"1987","Idaho","9","3","0","0.75000","358","339","19"
"1988","Idaho","11","2","0","0.84615","392","305","87"
"1992","California","4","7","0","0.36364","284","284","0"
"1993","California","9","4","0","0.69231","411","303","108"
"1994","California","4","7","0","0.36364","212","248","-36"
"1995","California","3","8","0","0.27273","243","286","-43"
"2003","Washington","6","6","0","0.50000","312","316","-4"
"2004","Washington","1","10","0","0.09091","154","334","-180"
"1996","California","6","6","0","0.50000","382","407","-25"
"1997","California","3","8","0","0.27273","295","339","-44"
"1998","California","5","6","0","0.45455","183","251","-68"
"1999","California","0","11","0","0.00000","180","254","-74"
"2000","California","3","8","0","0.27273","246","295","-49"
"2001","California","1","10","0","0.09091","201","431","-230"
"2002","California","7","5","0","0.58333","427","318","109"
"2003","California","8","6","0","0.57143","457","341","116"
"2004","California","10","2","0","0.83333","441","192","249"
"2005","California","8","4","0","0.66667","395","254","141"
"2006","California","10","3","0","0.76923","427","251","176"
"2007","California","7","6","0","0.53846","381","348","33"
"2008","California","9","4","0","0.69231","424","259","165"
"2009","California","8","5","0","0.61538","378","331","47"
"2010","California","5","7","0","0.41667","310","271","39"
"2011","California","7","6","0","0.53846","368","314","54"
"2012","California","3","9","0","0.25000","276","397","-121"
"2010","Louisiana Tech","5","7","0","0.41667","321","368","-47"
"2011","Louisiana Tech","8","5","0","0.61538","391","301","90"
"2012","Louisiana Tech","9","3","0","0.75000","618","462","156"
"2013","California","1","11","0","0.08333","276","551","-275"
"1979","Central Florida","6","2","0","0.75000","104","96","8"
"1980","Central Florida","4","4","1","0.50000","155","175","-20"
"1981","Central Florida","4","6","0","0.40000","142","130","12"
"1982","Central Florida","0","10","0","0.00000","109","356","-247"
"1955","Northwestern (IL)","0","8","1","0.05556","66","241","-175"
"1957","Western Illinois","5","4","0","0.55556","154","150","4"
"1958","Western Illinois","6","1","1","0.81250","222","109","113"
"1959","Western Illinois","9","0","0","1.00000","303","104","199"
"1966","Maryland","4","6","0","0.40000","180","204","-24"
"1977","Miami (FL)","3","8","0","0.27273","125","245","-120"
"1978","Miami (FL)","6","5","0","0.54545","194","193","1"
"1979","Army (NY)","2","8","1","0.22727","96","308","-212"
"1983","Central Florida","5","6","0","0.45455","283","306","-23"
"1984","Central Florida","1","6","0","0.14286","154","270","-116"
"2001","Chowan (NC)","3","7","0","0.30000","241","281","-40"
"2002","Chowan (NC)","0","10","0","0.00000","69","274","-205"
"1984","Central Florida","1","3","0","0.25000","55","128","-73"
"1985","Central Florida","4","7","0","0.36364","266","386","-120"
"1986","Central Florida","6","5","0","0.54545","310","227","83"
"1987","Central Florida","9","4","0","0.69231","401","210","191"
"1988","Central Florida","6","5","0","0.54545","267","288","-21"
"1989","Central Florida","7","3","0","0.70000","256","168","88"
"1990","Central Florida","10","4","0","0.71429","444","280","164"
"1991","Central Florida","6","5","0","0.54545","278","230","48"
"1992","Central Florida","7","4","0","0.63636","416","249","167"
"1993","Central Florida","9","3","0","0.75000","413","277","136"
"1994","Central Florida","7","4","0","0.63636","399","263","136"
"1995","Central Florida","6","5","0","0.54545","283","280","3"
"1996","Central Florida","5","6","0","0.45455","277","261","16"
"1997","Central Florida","5","6","0","0.45455","374","303","71"
"1998","Central Florida","9","2","0","0.81818","393","209","184"
"1999","Central Florida","4","7","0","0.36364","277","318","-41"
"2000","Central Florida","7","4","0","0.63636","333","221","112"
"2001","Central Florida","6","5","0","0.54545","333","204","129"
"2002","Central Florida","7","5","0","0.58333","391","315","76"
"2003","Central Florida","3","7","0","0.30000","196","296","-100"
"2003","Central Florida","0","2","0","0.00000","28","77","-49"
"1994","Georgia Tech","0","3","0","0.00000","33","88","-55"
"1995","Georgia Tech","6","5","0","0.54545","260","243","17"
"1996","Georgia Tech","5","6","0","0.45455","220","236","-16"
"1997","Georgia Tech","7","5","0","0.58333","314","296","18"
"1998","Georgia Tech","10","2","0","0.83333","426","295","131"
"1999","Georgia Tech","8","4","0","0.66667","461","361","100"
"2000","Georgia Tech","9","3","0","0.75000","386","237","149"
"2001","Georgia Tech","7","5","0","0.58333","381","267","114"
"2004","Central Florida","0","11","0","0.00000","175","362","-187"
"2005","Central Florida","8","5","0","0.61538","373","373","0"
"2006","Central Florida","4","8","0","0.33333","232","345","-113"
"2007","Central Florida","10","4","0","0.71429","502","372","130"
"2008","Central Florida","4","8","0","0.33333","199","289","-90"
"2009","Central Florida","8","5","0","0.61538","340","293","47"
"2010","Central Florida","11","3","0","0.78571","449","240","209"
"2011","Central Florida","5","7","0","0.41667","325","220","105"
"2012","Central Florida","10","4","0","0.71429","496","309","187"
"2013","Central Florida","12","1","0","0.92308","450","277","173"
"1896","Central Michigan","3","1","0","0.75000","62","22","40"
"1897","Central Michigan","2","1","0","0.66667","16","18","-2"
"1898","Central Michigan","1","2","0","0.33333","37","32","5"
"1899","Central Michigan","3","2","0","0.60000","35","22","13"
"1872","Stevens Tech (NJ)","0","1","0","0.00000","0","6","-6"
"1873","New York (NY)","3","3","0","0.50000","15","13","2"
"1874","Stevens Tech (NJ)","2","3","0","0.40000","10","20","-10"
"1875","Stevens Tech (NJ)","4","4","0","0.50000","21","20","1"
"1876","New York (NY)","2","3","1","0.41667","16","19","-3"
"1877","Stevens Tech (NJ)","3","1","2","0.66667","9","14","-5"
"1878","Stevens Tech (NJ)","3","3","3","0.50000","3","9","-6"
"1879","Stevens Tech (NJ)","2","3","5","0.45000","8","14","-6"
"1880","Stevens Tech (NJ)","1","5","0","0.16667","3","16","-13"
"1881","Stevens Tech (NJ)","3","8","3","0.32143","16","29","-13"
"1882","Lawrence (WI)","7","8","1","0.46875","17","25","-8"
"1883","Stevens Tech (NJ)","7","6","1","0.53571","187","128","59"
"1884","Fordham (NY)","9","10","0","0.47368","221","261","-40"
"1885","Georgetown (DC)","5","17","1","0.23913","359","612","-253"
"1886","New York (NY)","9","15","2","0.38462","180","565","-385"
"1887","Fordham (NY)","8","12","1","0.40476","157","445","-288"
"1888","Amherst (MA)","6","17","3","0.28846","192","791","-599"
"1889","New York (NY)","8","21","4","0.30303","278","647","-369"
"1890","New York (NY)","25","14","2","0.63415","727","538","189"
"1891","Delaware","32","30","7","0.51449","966","971","-5"
"1892","Beloit (WI)","29","31","3","0.48413","726","797","-71"
"1893","Marquette (WI)","39","34","3","0.53289","1091","885","206"
"1894","Manhattan (NY)","32","29","7","0.52206","853","692","161"
"1895","Delaware","44","35","6","0.55294","889","813","76"
"1896","Manhattan (NY)","51","49","6","0.50943","949","1164","-215"
"1897","Stevens Tech (NJ)","37","50","4","0.42857","661","1048","-387"
"1898","Manhattan (NY)","37","43","9","0.46629","781","1050","-269"
"1899","Manhattan (NY)","34","40","6","0.46250","594","1063","-469"
"1900","Manhattan (NY)","43","47","11","0.48020","991","1049","-58"
"1901","Ferris St. (MI)","51","44","7","0.53431","906","852","54"
"1902","Indiana St.","56","48","5","0.53670","1053","927","126"
"1903","Manhattan (NY)","30","49","7","0.38953","762","1319","-557"
"1904","Saint Francis (NY)","44","53","9","0.45755","787","1363","-576"
"1905","Bluffton (OH)","38","59","5","0.39706","850","1433","-583"
"1906","Ferris St. (MI)","32","43","12","0.43678","677","854","-177"
"1907","Ferris St. (MI)","32","48","10","0.41111","722","1208","-486"
"1908","Western Illinois","36","45","10","0.45055","760","1069","-309"
"1909","Delaware Valley (PA)","27","52","2","0.34568","682","1287","-605"
"1910","East Stroudsburg (PA)","23","31","3","0.42982","583","738","-155"
"1911","Western Illinois","32","44","7","0.42771","661","902","-241"
"1912","Indiana (PA)","36","56","7","0.39899","1134","1463","-329"
"1913","Saint Francis (NY)","52","67","8","0.44094","1672","2360","-688"
"1914","Delaware Valley (PA)","41","50","6","0.45361","1217","1585","-368"
"1915","Western Illinois","34","35","11","0.49375","932","1217","-285"
"1916","Morgan St. (MD)","44","43","7","0.50532","1493","1270","223"
"1917","Morgan St. (MD)","21","21","2","0.50000","408","883","-475"
"1918","Oklahoma Baptist University","7","16","2","0.32000","258","358","-100"
"1919","Western Illinois","53","41","8","0.55882","1478","1056","422"
"1920","Virginia Union","28","39","2","0.42029","506","893","-387"
"1921","Cooper Union (NY)","19","34","3","0.36607","441","1112","-671"
"1922","Cooper Union (NY)","27","34","6","0.44776","703","832","-129"
"1923","Cooper Union (NY)","31","45","2","0.41026","718","1112","-394"
"1924","East Stroudsburg (PA)","34","40","6","0.46250","946","1175","-229"
"1925","Saint Anselm (NH)","32","28","10","0.52857","847","802","45"
"1926","Saint Anselm (NH)","22","30","4","0.42857","515","702","-187"
"1927","Bethune-Cookman (FL)","20","29","8","0.42105","674","783","-109"
"1928","Saint Anselm (NH)","28","24","7","0.53390","564","1095","-531"
"1929","Saint Anselm (NH)","25","32","5","0.44355","616","843","-227"
"1930","Saint Anselm (NH)","31","27","10","0.52941","643","549","94"
"1931","Campbell (NC)","21","17","4","0.54762","465","428","37"
"1932","Campbell (NC)","7","30","3","0.21250","254","760","-506"
"1933","Campbell (NC)","11","13","3","0.46296","262","324","-62"
"1934","Bowie St. (MD)","4","7","2","0.38462","116","94","22"
"1935","Florida Southern","7","12","1","0.37500","170","162","8"
"1936","Bowie St. (MD)","5","2","1","0.68750","154","97","57"
"1937","Bowie St. (MD)","6","3","0","0.66667","98","87","11"
"1938","West Alabama","7","5","0","0.58333","151","88","63"
"1939","Elizabeth City St. (NC)","7","13","0","0.35000","150","307","-157"
"1940","Elizabeth City St. (NC)","6","5","4","0.53333","128","67","61"
"1941","Arkansas-Pine Bluff","3","9","5","0.32353","178","223","-45"
"1942","Brevard College (NC)","10","6","2","0.61111","225","189","36"
"1943","Clark Atlanta (GA)","6","8","0","0.42857","127","206","-79"
"1944","Abilene Christian (TX)","9","11","1","0.45238","158","255","-97"
"1945","Benedict (SC)","10","15","2","0.40741","299","296","3"
"1946","Elizabeth City St. (NC)","7","20","3","0.28333","144","540","-396"
"1947","Clark Atlanta (GA)","3","6","2","0.36364","49","230","-181"
"1948","Virginia-Lynchburg","4","6","1","0.40909","77","302","-225"
"1949","Virginia-Lynchburg","0","3","1","0.12500","7","70","-63"
"1950","Virginia-Lynchburg","2","3","0","0.40000","53","98","-45"
"1951","Lane (TN)","8","6","0","0.57143","295","234","61"
"1952","Lane (TN)","9","5","1","0.63333","220","206","14"
"1953","Lane (TN)","1","7","0","0.12500","58","215","-157"
"1954","Lane (TN)","2","6","0","0.25000","105","135","-30"
"1955","Lane (TN)","2","4","0","0.33333","83","129","-46"
"1957","Louisiana College","2","7","0","0.22222","106","179","-73"
"1959","Azusa Pacific (CA)","2","3","0","0.40000","117","90","27"
"1960","Azusa Pacific (CA)","4","3","1","0.56250","103","76","27"
"1961","Azusa Pacific (CA)","3","3","0","0.50000","123","147","-24"
"1963","San Francisco (CA)","2","5","0","0.28571","58","98","-40"
"1964","New York (NY)","0","2","0","0.00000","20","48","-28"
"1965","Adelphi (NY)","4","8","0","0.33333","198","216","-18"
"1966","Fairfield (CT)","18","22","2","0.45238","545","652","-107"
"1967","La Salle (PA)","25","31","0","0.44643","846","1080","-234"
"1968","Centenary (LA)","17","42","2","0.29508","726","1393","-667"
"1969","Bluffton (OH)","33","43","0","0.43421","1058","1548","-490"
"1970","Saint John's (NY)","35","54","1","0.39444","1379","1783","-404"
"1971","Bluffton (OH)","43","45","1","0.48876","1360","1384","-24"
"1972","Marquette (WI)","39","44","2","0.47059","1217","1351","-134"
"1973","Brooklyn (NY)","30","52","1","0.36747","1007","1611","-604"
"1974","Marquette (WI)","33","36","3","0.47917","959","1169","-210"
"1975","Marquette (WI)","31","22","4","0.57895","1042","932","110"
"1976","Bluffton (OH)","23","33","1","0.41228","862","1186","-324"
"1977","Manhattan (NY)","14","28","1","0.33721","568","923","-355"
"1978","Fairfield (CT)","5","7","1","0.42308","194","203","-9"
"1979","Fairfield (CT)","7","8","0","0.46667","247","260","-13"
"1980","Westfield St. (MA)","6","5","4","0.53333","184","196","-12"
"1981","San Francisco (CA)","17","14","0","0.54839","567","498","69"
"1982","Manhattan (NY)","18","16","0","0.52941","580","644","-64"
"1983","SUNY-Stony Brook (NY)","15","11","0","0.57692","474","453","21"
"1984","Stonehill (MA)","7","12","0","0.36842","231","439","-208"
"1985","Manhattan (NY)","10","10","0","0.50000","313","316","-3"
"1986","Marquette (WI)","13","17","0","0.43333","497","564","-67"
"1987","Marquette (WI)","10","17","0","0.37037","389","487","-98"
"1988","Marquette (WI)","1","5","0","0.16667","80","125","-45"
"1989","Marquette (WI)","4","4","0","0.50000","209","151","58"
"1990","Marquette (WI)","1","7","0","0.12500","80","180","-100"
"1991","Marquette (WI)","1","5","0","0.16667","106","182","-76"
"1992","Marquette (WI)","2","5","0","0.28571","81","129","-48"
"1993","Marquette (WI)","7","1","0","0.87500","212","126","86"
"1994","Marquette (WI)","1","6","0","0.14286","125","184","-59"
"1995","Marquette (WI)","3","4","0","0.42857","141","191","-50"
"1996","Marquette (WI)","3","5","0","0.37500","139","182","-43"
"1998","Madison College (WI)","2","15","0","0.11765","221","613","-392"
"1999","Marquette (WI)","0","7","0","0.00000","110","298","-188"
"2000","Marquette (WI)","1","5","0","0.16667","60","96","-36"
"2001","Marquette (WI)","2","6","0","0.25000","144","179","-35"
"2002","Marquette (WI)","3","4","0","0.42857","127","208","-81"
"2003","Marquette (WI)","1","6","0","0.14286","71","151","-80"
"2004","Marquette (WI)","0","6","0","0.00000","53","238","-185"
"2005","Marquette (WI)","2","5","0","0.28571","92","226","-134"
"2006","Marquette (WI)","1","6","0","0.14286","62","206","-144"
"2007","Marquette (WI)","2","5","0","0.28571","140","215","-75"
"2008","Marquette (WI)","0","7","0","0.00000","61","304","-243"
"2009","Marquette (WI)","0","1","0","0.00000","0","22","-22"
"1902","Central Michigan","4","0","0","1.00000","82","0","82"
"1903","Central Michigan","6","0","0","1.00000","69","11","58"
"1904","Central Michigan","0","1","0","0.00000","6","60","-54"
"1905","Central Michigan","7","1","0","0.87500","132","14","118"
"1918","Central Michigan","1","0","0","1.00000","41","6","35"
"1907","Central Michigan","2","4","0","0.33333","18","164","-146"
"1913","Wyoming","0","5","0","0.00000","0","183","-183"
"1914","Wyoming","1","5","0","0.16667","31","158","-127"
"1915","Lake Forest (IL)","2","4","0","0.33333","77","86","-9"
"1908","Central Michigan","4","3","0","0.57143","43","22","21"
"1909","Central Michigan","4","3","0","0.57143","63","58","5"
"1910","Central Michigan","6","1","1","0.81250","112","33","79"
"1911","Central Michigan","3","3","0","0.50000","26","29","-3"
"1912","Central Michigan","1","2","1","0.37500","6","112","-106"
"1916","Alma (MI)","5","4","0","0.55556","160","127","33"
"1917","Alma (MI)","6","1","0","0.85714","163","31","132"
"1916","Central Michigan","1","5","0","0.16667","39","139","-100"
"1911","South Dakota St.","4","4","0","0.50000","60","89","-29"
"1917","Central Michigan","1","2","0","0.33333","7","70","-63"
"1919","Central Michigan","2","2","3","0.50000","88","89","-1"
"1920","Central Michigan","4","3","1","0.56250","166","41","125"
"1921","Central Michigan","7","2","1","0.75000","188","21","167"
"1922","Central Michigan","6","0","2","0.87500","179","11","168"
"1923","Central Michigan","5","1","2","0.75000","160","24","136"
"1926","Central Michigan","3","4","1","0.43750","66","90","-24"
"1927","Central Michigan","7","1","0","0.87500","124","37","87"
"1928","Central Michigan","6","3","0","0.66667","126","63","63"
"1922","Memphis (TN)","5","2","3","0.65000","174","26","148"
"1923","Memphis (TN)","6","3","0","0.66667","77","55","22"
"1924","Central Michigan","7","1","0","0.87500","158","19","139"
"1925","Central Michigan","4","1","3","0.68750","93","20","73"
"1929","Central Michigan","2","3","2","0.42857","71","80","-9"
"1930","Central Michigan","5","2","1","0.68750","102","81","21"
"1931","Central Michigan","4","3","0","0.57143","95","58","37"
"1932","Central Michigan","3","4","1","0.43750","95","66","29"
"1933","Central Michigan","5","2","1","0.68750","164","58","106"
"1934","Buffalo (NY)","2","4","1","0.35714","35","106","-71"
"1935","Buffalo (NY)","2","6","0","0.25000","26","213","-187"
"1934","Central Michigan","5","3","0","0.62500","81","82","-1"
"1935","Central Michigan","1","6","0","0.14286","32","101","-69"
"1936","Central Michigan","3","4","1","0.43750","89","135","-46"
"1937","Central Michigan","6","2","0","0.75000","202","41","161"
"1938","Central Michigan","7","1","0","0.87500","270","44","226"
"1939","Central Michigan","8","1","0","0.88889","167","40","127"
"1940","Central Michigan","4","3","1","0.56250","88","60","28"
"1941","Central Michigan","4","3","0","0.57143","44","76","-32"
"1942","Central Michigan","6","0","0","1.00000","93","21","72"
"1943","Central Michigan","2","3","0","0.40000","20","69","-49"
"1944","Central Michigan","5","2","0","0.71429","150","106","44"
"1945","Central Michigan","6","1","0","0.85714","98","26","72"
"1946","Central Michigan","6","2","0","0.75000","240","67","173"
"1947","Central Michigan","2","5","1","0.31250","136","105","31"
"1948","Central Michigan","3","6","0","0.33333","127","139","-12"
"1949","Central Michigan","3","4","0","0.42857","106","109","-3"
"1950","Central Michigan","6","4","0","0.60000","209","125","84"
"1964","Boston (MA)","2","7","0","0.22222","77","213","-136"
"1965","Boston (MA)","5","3","1","0.61111","140","140","0"
"1966","Boston (MA)","5","5","0","0.50000","182","155","27"
"1967","Boston (MA)","3","6","0","0.33333","114","151","-37"
"1968","Boston (MA)","5","3","1","0.61111","117","125","-8"
"1951","Central Michigan","5","3","0","0.62500","231","158","73"
"1952","Central Michigan","7","2","0","0.77778","285","85","200"
"1953","Central Michigan","7","1","1","0.83333","244","129","115"
"1954","Central Michigan","8","2","0","0.80000","321","107","214"
"1955","Central Michigan","8","1","0","0.88889","327","79","248"
"1956","Central Michigan","9","0","0","1.00000","313","92","221"
"1957","Central Michigan","4","6","0","0.40000","220","222","-2"
"1958","Central Michigan","7","3","0","0.70000","216","204","12"
"1959","Central Michigan","7","3","0","0.70000","233","155","78"
"1960","Central Michigan","3","5","0","0.37500","161","165","-4"
"1961","Central Michigan","2","8","0","0.20000","95","214","-119"
"1962","Central Michigan","6","4","0","0.60000","191","171","20"
"1963","Central Michigan","4","5","1","0.45000","209","195","14"
"1964","Central Michigan","4","5","0","0.44444","117","148","-31"
"1965","Central Michigan","5","5","0","0.50000","193","144","49"
"1966","Central Michigan","5","5","0","0.50000","213","159","54"
"1967","Central Michigan","8","2","0","0.80000","207","84","123"
"1968","Central Michigan","7","2","0","0.77778","256","132","124"
"1969","Central Michigan","7","3","0","0.70000","254","147","107"
"1970","Central Michigan","7","3","0","0.70000","263","190","73"
"1971","Central Michigan","5","5","0","0.50000","183","181","2"
"1972","Central Michigan","5","5","1","0.50000","265","190","75"
"1973","Central Michigan","7","4","0","0.63636","197","151","46"
"1974","Central Michigan","12","1","0","0.92308","450","127","323"
"1975","Central Michigan","8","2","1","0.77273","309","102","207"
"1976","Central Michigan","7","4","0","0.63636","223","219","4"
"1977","Central Michigan","10","1","0","0.90909","317","155","162"
"1978","Central Michigan","9","2","0","0.81818","331","119","212"
"1979","Central Michigan","10","0","1","0.95455","291","133","158"
"1980","Central Michigan","9","2","0","0.81818","218","127","91"
"1981","Central Michigan","7","4","0","0.63636","223","131","92"
"1982","Central Michigan","6","4","1","0.59091","228","199","29"
"1983","Central Michigan","8","3","0","0.72727","257","136","121"
"1984","Central Michigan","8","2","1","0.77273","282","141","141"
"1985","Central Michigan","7","3","0","0.70000","194","143","51"
"1986","Central Michigan","5","5","0","0.50000","258","284","-26"
"1987","Central Michigan","5","5","1","0.50000","222","203","19"
"1988","Central Michigan","7","4","0","0.63636","287","176","111"
"1989","Central Michigan","5","5","1","0.50000","228","182","46"
"1990","Central Michigan","8","3","1","0.70833","283","146","137"
"1991","Central Michigan","6","1","4","0.72727","205","157","48"
"1992","Central Michigan","5","6","0","0.45455","247","170","77"
"1993","Central Michigan","5","6","0","0.45455","275","244","31"
"1994","Central Michigan","9","3","0","0.75000","400","315","85"
"1995","Central Michigan","4","7","0","0.36364","255","276","-21"
"1996","Central Michigan","5","6","0","0.45455","351","353","-2"
"1997","Central Michigan","2","9","0","0.18182","282","479","-197"
"1998","Central Michigan","6","5","0","0.54545","229","253","-24"
"1999","Central Michigan","4","7","0","0.36364","229","344","-115"
"2000","Central Michigan","2","9","0","0.18182","137","376","-239"
"2001","Central Michigan","3","8","0","0.27273","251","346","-95"
"2002","Central Michigan","4","8","0","0.33333","267","384","-117"
"2003","Central Michigan","3","9","0","0.25000","277","428","-151"
"1991","Grand Valley St. (MI)","9","3","0","0.75000","313","166","147"
"1992","Grand Valley St. (MI)","8","3","0","0.72727","249","219","30"
"1993","Grand Valley St. (MI)","6","3","2","0.63636","271","227","44"
"1994","Grand Valley St. (MI)","8","4","0","0.66667","387","239","148"
"1995","Grand Valley St. (MI)","8","3","0","0.72727","407","211","196"
"1996","Grand Valley St. (MI)","8","3","0","0.72727","272","165","107"
"1997","Grand Valley St. (MI)","9","2","0","0.81818","330","237","93"
"1998","Grand Valley St. (MI)","9","3","0","0.75000","462","322","140"
"1999","Grand Valley St. (MI)","5","5","0","0.50000","259","273","-14"
"2000","Grand Valley St. (MI)","7","4","0","0.63636","337","284","53"
"2001","Grand Valley St. (MI)","13","1","0","0.92857","707","231","476"
"2002","Grand Valley St. (MI)","14","0","0","1.00000","654","231","423"
"2003","Grand Valley St. (MI)","14","1","0","0.93333","551","200","351"
"2004","Central Michigan","4","7","0","0.36364","260","378","-118"
"2005","Central Michigan","6","5","0","0.54545","260","260","0"
"2006","Central Michigan","10","4","0","0.71429","412","322","90"
"2007","Cincinnati (OH)","10","3","0","0.76923","472","244","228"
"2008","Cincinnati (OH)","11","3","0","0.78571","362","282","80"
"2009","Cincinnati (OH)","12","0","0","1.00000","478","249","229"
"2010","Notre Dame (IN)","8","5","0","0.61538","342","263","79"
"2011","Notre Dame (IN)","8","5","0","0.61538","380","269","111"
"2012","Notre Dame (IN)","12","1","0","0.92308","335","166","169"
"2013","Notre Dame (IN)","9","4","0","0.69231","354","291","63"
"2006","Central Michigan","1","0","0","1.00000","31","14","17"
"2009","Cincinnati (OH)","0","1","0","0.00000","24","51","-27"
"2010","Buffalo (NY)","2","10","0","0.16667","170","334","-164"
"2011","Buffalo (NY)","3","9","0","0.25000","266","353","-87"
"2012","Buffalo (NY)","4","8","0","0.33333","255","342","-87"
"2013","Buffalo (NY)","8","5","0","0.61538","394","317","77"
"2007","Central Michigan","8","6","0","0.57143","487","517","-30"
"2008","Central Michigan","8","5","0","0.61538","384","393","-9"
"2009","Central Michigan","11","2","0","0.84615","431","224","207"
"2010","Cincinnati (OH)","4","8","0","0.33333","325","336","-11"
"2011","Cincinnati (OH)","10","3","0","0.76923","433","264","169"
"2012","Cincinnati (OH)","9","3","0","0.75000","372","206","166"
"2013","Tennessee","5","7","0","0.41667","286","348","-62"
"2009","Central Michigan","1","0","0","1.00000","44","41","3"
"2012","Cincinnati (OH)","1","0","0","1.00000","48","34","14"
"2010","Central Michigan","3","9","0","0.25000","293","312","-19"
"2011","Central Michigan","3","9","0","0.25000","271","400","-129"
"2012","Central Michigan","7","6","0","0.53846","375","421","-46"
"2013","Central Michigan","6","6","0","0.50000","279","343","-64"
"1869","Rutgers (NJ)","2","2","0","0.50000","18","18","0"
"1870","Rutgers (NJ)","2","2","0","0.50000","17","17","0"
"1872","Columbia (NY)","5","4","0","0.55556","22","16","6"
"1873","Rutgers (NJ)","7","4","1","0.62500","31","26","5"
"1874","Harvard (MA)","9","7","0","0.56250","54","41","13"
"1875","Harvard (MA)","12","6","2","0.65000","52","29","23"
"1876","Harvard (MA)","13","8","1","0.61364","45","29","16"
"1877","Harvard (MA)","9","7","3","0.55263","31","21","10"
"1878","Pennsylvania","14","9","5","0.58929","42","24","18"
"1879","Harvard (MA)","13","9","12","0.55882","46","27","19"
"1880","Harvard (MA)","18","11","4","0.60606","75","53","22"
"1881","Rutgers (NJ)","22","18","8","0.54167","70","47","23"
"1882","Rutgers (NJ)","41","28","2","0.59155","176","111","65"
"1883","Rutgers (NJ)","38","32","1","0.54225","1288","965","323"
"1884","Pennsylvania","47","29","5","0.61111","1728","1184","544"
"1885","Michigan","34","17","4","0.65455","1437","612","825"
"1886","Lehigh (PA)","48","21","4","0.68493","1850","637","1213"
"1887","California","67","35","3","0.65238","2660","935","1725"
"1888","Princeton (NJ)","70","56","6","0.55303","2468","1899","569"
"1889","Brown (RI)","82","51","11","0.60764","2879","1796","1083"
"1890","Brown (RI)","77","76","9","0.50309","3002","2455","547"
"1891","Southern California","94","76","13","0.54918","2813","2189","624"
"1892","Minnesota","93","80","9","0.53571","2972","2394","578"
"1893","Duke (NC)","79","94","9","0.45879","2176","2912","-736"
"1894","Colorado St.","50","62","4","0.44828","1161","1518","-357"
"1895","Boston (MA)","31","44","11","0.42442","692","1031","-339"
"1896","Rhode Island","54","62","12","0.46875","1126","1201","-75"
"1897","Boston (MA)","32","40","6","0.44872","792","785","7"
"1898","Miami (OH)","47","23","4","0.66216","921","644","277"
"1899","New Hampshire","33","32","6","0.50704","571","522","49"
"1900","New Hampshire","22","35","11","0.40441","442","686","-244"
"1901","Marshall (WV)","18","34","3","0.35455","302","917","-615"
"1902","Saint John's (MN)","9","22","4","0.31429","148","460","-312"
"1903","Wichita St. (KS)","14","25","2","0.36585","376","546","-170"
"1904","Oklahoma St.","11","14","1","0.44231","194","394","-200"
"1905","Miami (OH)","7","25","5","0.25676","245","494","-249"
"1906","Rensselaer Tech (NY)","3","7","4","0.35714","92","107","-15"
"1907","Marshall (WV)","5","10","2","0.35294","71","238","-167"
"1908","Fort Hays St. (KS)","5","6","1","0.45833","56","91","-35"
"1909","Fort Hays St. (KS)","1","3","1","0.30000","12","68","-56"
"1910","Texas St.","0","1","0","0.00000","0","19","-19"
"1912","Fort Hays St. (KS)","1","2","0","0.33333","20","132","-112"
"1913","Eureka (IL)","1","6","0","0.14286","39","203","-164"
"1914","Eureka (IL)","3","4","0","0.42857","57","201","-144"
"1915","Texas St.","1","1","1","0.50000","13","20","-7"
"1916","Texas St.","0","2","1","0.16667","0","106","-106"
"1917","Boston (MA)","4","4","0","0.50000","73","136","-63"
"1918","Monmouth (IL)","1","7","0","0.12500","26","137","-111"
"1930","Troy (AL)","1","2","0","0.33333","7","73","-66"
"2013","Grambling St. (LA)","0","1","0","0.00000","0","0","0"
"1894","Cincinnati (OH)","3","3","0","0.50000","64","46","18"
"1895","Cincinnati (OH)","3","3","0","0.50000","54","46","8"
"1891","Rutgers (NJ)","8","6","0","0.57143","265","137","128"
"1896","Cincinnati (OH)","4","3","1","0.56250","88","68","20"
"1897","North Carolina","7","3","0","0.70000","150","53","97"
"1898","North Carolina","9","0","0","1.00000","187","8","179"
"1899","North Carolina","7","3","1","0.68182","173","58","115"
"1900","North Carolina","4","1","3","0.68750","163","22","141"
"1897","Cincinnati (OH)","9","1","1","0.86364","136","22","114"
"1904","Penn St.","6","4","0","0.60000","195","72","123"
"1905","Penn St.","8","3","0","0.72727","195","34","161"
"1906","Penn St.","8","1","1","0.85000","94","10","84"
"1907","Penn St.","6","4","0","0.60000","251","64","187"
"1908","Penn St.","5","5","0","0.50000","153","51","102"
"1898","Cincinnati (OH)","6","1","2","0.77778","141","28","113"
"1903","Holy Cross (MA)","8","2","0","0.80000","174","69","105"
"1904","Holy Cross (MA)","2","5","2","0.33333","65","135","-70"
"1905","Holy Cross (MA)","6","3","0","0.66667","119","73","46"
"1911","Dartmouth (NH)","8","2","0","0.80000","137","22","115"
"1912","Dartmouth (NH)","7","2","0","0.77778","281","34","247"
"1913","Dartmouth (NH)","7","1","0","0.87500","218","79","139"
"1914","Dartmouth (NH)","8","1","0","0.88889","347","25","322"
"1915","Dartmouth (NH)","7","1","1","0.83333","194","40","154"
"1916","Dartmouth (NH)","5","2","2","0.66667","206","47","159"
"1919","Boston College (MA)","5","3","0","0.62500","78","62","16"
"1920","Boston College (MA)","8","0","0","1.00000","181","16","165"
"1921","Boston College (MA)","4","3","1","0.56250","85","90","-5"
"1922","Boston College (MA)","6","2","1","0.72222","133","58","75"
"1923","Boston College (MA)","7","1","1","0.83333","167","14","153"
"1924","Boston College (MA)","6","3","0","0.66667","198","74","124"
"1925","Boston College (MA)","6","2","0","0.75000","152","53","99"
"1926","Boston College (MA)","6","0","2","0.87500","222","34","188"
"1927","Fordham (NY)","3","5","0","0.37500","82","139","-57"
"1928","Fordham (NY)","4","5","0","0.44444","121","130","-9"
"1929","Fordham (NY)","7","0","2","0.88889","176","19","157"
"1930","Fordham (NY)","8","1","0","0.88889","215","29","186"
"1931","Fordham (NY)","6","1","2","0.77778","205","36","169"
"1932","Fordham (NY)","6","2","0","0.75000","193","28","165"
"1899","Cincinnati (OH)","5","2","0","0.71429","81","60","21"
"1900","Cincinnati (OH)","3","5","1","0.38889","51","166","-115"
"1903","Penn St.","5","3","0","0.62500","182","77","105"
"1910","Cornell (NY)","5","2","1","0.68750","165","44","121"
"1911","Cornell (NY)","7","3","0","0.70000","101","52","49"
"1901","Cincinnati (OH)","1","4","1","0.25000","10","63","-53"
"1900","Wabash (IN)","5","4","0","0.55556","80","94","-14"
"1901","DePauw (IN)","8","3","0","0.72727","197","73","124"
"1902","Cincinnati (OH)","4","2","2","0.62500","58","45","13"
"1903","Cincinnati (OH)","1","8","0","0.11111","39","141","-102"
"1904","West Virginia","6","3","0","0.66667","99","233","-134"
"1904","Cincinnati (OH)","7","1","0","0.87500","182","10","172"
"1905","Cincinnati (OH)","5","3","0","0.62500","92","91","1"
"1906","Nebraska","6","4","0","0.60000","164","73","91"
"1907","Miami (OH)","6","1","0","0.85714","120","37","83"
"1908","Miami (OH)","7","0","0","1.00000","113","10","103"
"1906","Cincinnati (OH)","0","7","2","0.11111","5","162","-157"
"1907","Cincinnati (OH)","0","2","0","0.00000","5","39","-34"
"1908","Cincinnati (OH)","1","4","1","0.25000","59","104","-45"
"1909","Cincinnati (OH)","4","3","1","0.56250","69","74","-5"
"1910","Cincinnati (OH)","6","3","0","0.66667","122","59","63"
"1911","Cincinnati (OH)","6","2","1","0.72222","79","34","45"
"1912","Cincinnati (OH)","3","4","1","0.43750","251","145","106"
"1913","Cincinnati (OH)","5","3","1","0.61111","177","61","116"
"1914","Cincinnati (OH)","6","3","0","0.66667","164","44","120"
"1915","Cincinnati (OH)","4","5","0","0.44444","110","158","-48"
"1916","Miami (OH)","7","0","1","0.93750","238","12","226"
"1919","Miami (OH)","7","1","0","0.87500","147","32","115"
"1920","Miami (OH)","5","2","1","0.68750","114","38","76"
"1921","Miami (OH)","8","0","0","1.00000","238","13","225"
"1924","Michigan","6","2","0","0.75000","155","54","101"
"1925","Wisconsin","6","1","1","0.81250","131","50","81"
"1926","Wisconsin","5","2","1","0.68750","122","72","50"
"1914","South Dakota","5","2","1","0.68750","111","75","36"
"1915","South Dakota","4","2","2","0.62500","86","39","47"
"1916","Cincinnati (OH)","0","8","1","0.05556","10","199","-189"
"1925","North Dakota St.","5","0","2","0.85714","111","33","78"
"1926","North Dakota St.","5","3","0","0.62500","119","54","65"
"1927","North Dakota St.","3","5","0","0.37500","64","97","-33"
"1917","Cincinnati (OH)","0","6","0","0.00000","0","189","-189"
"1909","Marshall (WV)","3","2","1","0.58333","107","95","12"
"1910","Marshall (WV)","5","1","1","0.78571","91","14","77"
"1911","Marshall (WV)","4","1","1","0.75000","122","22","100"
"1912","Marshall (WV)","3","4","0","0.42857","197","94","103"
"1913","Marshall (WV)","4","4","0","0.50000","85","101","-16"
"1914","Marshall (WV)","5","5","0","0.50000","231","168","63"
"1915","Marshall (WV)","1","8","0","0.11111","86","257","-171"
"1916","Marshall (WV)","7","2","1","0.75000","267","102","165"
"1918","Cincinnati (OH)","3","0","2","0.80000","45","13","32"
"1919","Cincinnati (OH)","3","4","1","0.43750","73","102","-29"
"1920","Cincinnati (OH)","4","5","0","0.44444","125","96","29"
"1921","Cincinnati (OH)","3","6","0","0.33333","181","114","67"
"1919","Emporia St. (KS)","1","6","2","0.22222","60","101","-41"
"1920","Arkansas","3","2","2","0.57143","42","22","20"
"1921","Arkansas","5","3","1","0.61111","144","48","96"
"1922","Cincinnati (OH)","1","7","1","0.16667","35","175","-140"
"1923","Cincinnati (OH)","6","3","0","0.66667","157","71","86"
"1924","Cincinnati (OH)","2","6","1","0.27778","54","164","-110"
"1925","Cincinnati (OH)","4","5","0","0.44444","65","122","-57"
"1926","Cincinnati (OH)","3","5","1","0.38889","96","152","-56"
"1927","Wyoming","4","5","0","0.44444","122","105","17"
"1928","Wyoming","2","7","0","0.22222","106","224","-118"
"1929","Wyoming","1","7","0","0.12500","33","160","-127"
"1926","Akron (OH)","5","2","2","0.66667","107","74","33"
"1927","Cincinnati (OH)","2","5","2","0.33333","81","105","-24"
"1928","Cincinnati (OH)","1","8","0","0.11111","32","241","-209"
"1929","Cincinnati (OH)","4","4","1","0.50000","75","133","-58"
"1930","Cincinnati (OH)","5","4","0","0.55556","91","138","-47"
"1931","Cincinnati (OH)","5","4","0","0.55556","187","115","72"
"1932","Cincinnati (OH)","7","2","0","0.77778","151","69","82"
"1933","Cincinnati (OH)","7","2","0","0.77778","112","22","90"
"1934","Cincinnati (OH)","6","2","1","0.72222","163","71","92"
"1928","Louisiana St.","6","2","1","0.72222","180","45","135"
"1929","Louisiana St.","6","3","0","0.66667","246","118","128"
"1930","Louisiana St.","6","4","0","0.60000","296","72","224"
"1931","Louisiana St.","5","4","0","0.55556","137","90","47"
"1935","Cincinnati (OH)","7","2","0","0.77778","241","49","192"
"1936","Cincinnati (OH)","1","5","3","0.27778","57","124","-67"
"1937","Cincinnati (OH)","0","5","0","0.00000","6","108","-102"
"1937","Cincinnati (OH)","0","5","0","0.00000","12","106","-94"
"1938","Cincinnati (OH)","4","5","0","0.44444","81","128","-47"
"1939","Cincinnati (OH)","4","3","2","0.55556","87","65","22"
"1940","Cincinnati (OH)","5","3","1","0.61111","132","48","84"
"1941","Cincinnati (OH)","6","3","0","0.66667","194","45","149"
"1942","Cincinnati (OH)","8","2","0","0.80000","197","95","102"
"1945","Cincinnati (OH)","4","4","0","0.50000","132","88","44"
"1946","Cincinnati (OH)","9","2","0","0.81818","221","93","128"
"1947","Cincinnati (OH)","7","3","0","0.70000","182","168","14"
"1948","Cincinnati (OH)","3","6","1","0.35000","106","193","-87"
"1944","Miami (OH)","8","1","0","0.88889","185","74","111"
"1945","Miami (OH)","7","2","0","0.77778","207","75","132"
"1946","Miami (OH)","7","3","0","0.70000","220","72","148"
"1947","Miami (OH)","9","0","1","0.95000","240","97","143"
"1949","Cincinnati (OH)","7","4","0","0.63636","237","181","56"
"1950","Cincinnati (OH)","8","4","0","0.66667","258","169","89"
"1951","Cincinnati (OH)","10","1","0","0.90909","345","112","233"
"1952","Cincinnati (OH)","8","1","1","0.85000","275","72","203"
"1953","Cincinnati (OH)","9","1","0","0.90000","354","58","296"
"1954","Cincinnati (OH)","8","2","0","0.80000","249","107","142"
"1948","Miami (OH)","7","1","1","0.83333","249","90","159"
"1955","Cincinnati (OH)","1","6","2","0.22222","97","199","-102"
"1956","Cincinnati (OH)","4","5","0","0.44444","156","140","16"
"1957","Cincinnati (OH)","5","4","1","0.55000","130","101","29"
"1958","Cincinnati (OH)","6","2","2","0.70000","139","104","35"
"1959","Cincinnati (OH)","5","4","1","0.55000","193","148","45"
"1960","Cincinnati (OH)","4","6","0","0.40000","113","150","-37"
"1965","Virginia","4","6","0","0.40000","170","189","-19"
"1966","Virginia","4","6","0","0.40000","214","235","-21"
"1967","Virginia","5","5","0","0.50000","172","169","3"
"1968","Virginia","7","3","0","0.70000","328","222","106"
"1969","Virginia","3","7","0","0.30000","115","170","-55"
"1970","Virginia","5","6","0","0.45455","240","187","53"
"1960","Massachusetts","7","2","0","0.77778","173","121","52"
"1961","Cincinnati (OH)","3","7","0","0.30000","97","142","-45"
"1962","Cincinnati (OH)","2","8","0","0.20000","142","202","-60"
"1963","Cincinnati (OH)","6","4","0","0.60000","238","138","100"
"1964","Cincinnati (OH)","8","2","0","0.80000","211","99","112"
"1965","Cincinnati (OH)","5","5","0","0.50000","163","172","-9"
"1966","Cincinnati (OH)","3","7","0","0.30000","141","201","-60"
"1967","Cincinnati (OH)","3","6","0","0.33333","111","189","-78"
"1968","Cincinnati (OH)","5","4","1","0.55000","300","327","-27"
"1976","Rice (TX)","3","8","0","0.27273","236","417","-181"
"1977","Rice (TX)","1","10","0","0.09091","151","458","-307"
"1969","Cincinnati (OH)","4","6","0","0.40000","192","329","-137"
"1970","Cincinnati (OH)","7","4","0","0.63636","229","108","121"
"1971","Cincinnati (OH)","7","4","0","0.63636","225","188","37"
"1972","Cincinnati (OH)","2","9","0","0.18182","138","323","-185"
"1973","Cincinnati (OH)","4","7","0","0.36364","210","109","101"
"1974","Cincinnati (OH)","7","4","0","0.63636","227","175","52"
"1975","Cincinnati (OH)","6","5","0","0.54545","209","182","27"
"1976","Cincinnati (OH)","9","2","0","0.81818","204","114","90"
"1977","Arizona","5","7","0","0.41667","256","250","6"
"1978","Arizona","5","6","0","0.45455","245","205","40"
"1979","Arizona","6","5","1","0.54167","244","243","1"
"1977","Cincinnati (OH)","5","4","2","0.54545","250","121","129"
"1978","Cincinnati (OH)","5","6","0","0.45455","279","224","55"
"1979","Cincinnati (OH)","2","9","0","0.18182","156","281","-125"
"1980","Cincinnati (OH)","2","9","0","0.18182","122","271","-149"
"1978","Murray St. (KY)","4","7","0","0.36364","236","237","-1"
"1979","Murray St. (KY)","9","2","1","0.79167","272","144","128"
"1980","Murray St. (KY)","9","2","0","0.81818","230","100","130"
"1981","Cincinnati (OH)","6","5","0","0.54545","171","187","-16"
"1982","Cincinnati (OH)","6","5","0","0.54545","276","206","70"
"1983","Kansas","4","6","1","0.40909","296","320","-24"
"1984","Kansas","5","6","0","0.45455","218","298","-80"
"1985","Kansas","6","6","0","0.50000","294","281","13"
"1986","Pittsburgh (PA)","6","4","1","0.59091","253","209","44"
"1987","Pittsburgh (PA)","8","4","0","0.66667","230","146","84"
"1988","Pittsburgh (PA)","6","5","0","0.54545","300","183","117"
"1989","Pittsburgh (PA)","7","3","1","0.68182","302","240","62"
"1979","Austin Peay St. (TN)","7","4","0","0.63636","198","150","48"
"1980","Austin Peay St. (TN)","7","4","0","0.63636","217","148","69"
"1983","Cincinnati (OH)","4","6","1","0.40909","208","234","-26"
"1984","Rice (TX)","1","10","0","0.09091","213","382","-169"
"1985","Rice (TX)","3","8","0","0.27273","233","404","-171"
"1986","Vanderbilt (TN)","1","10","0","0.09091","193","347","-154"
"1987","Vanderbilt (TN)","4","7","0","0.36364","286","355","-69"
"1988","Vanderbilt (TN)","3","8","0","0.27273","202","277","-75"
"1989","Vanderbilt (TN)","1","10","0","0.09091","162","265","-103"
"1990","Vanderbilt (TN)","1","10","0","0.09091","227","457","-230"
"1995","Alabama-Birmingham","5","6","0","0.45455","273","261","12"
"1996","Alabama-Birmingham","5","6","0","0.45455","266","279","-13"
"1997","Alabama-Birmingham","5","6","0","0.45455","222","238","-16"
"1998","Alabama-Birmingham","4","7","0","0.36364","237","308","-71"
"1999","Alabama-Birmingham","5","6","0","0.45455","248","279","-31"
"2000","Alabama-Birmingham","7","4","0","0.63636","238","192","46"
"2001","Alabama-Birmingham","6","5","0","0.54545","265","206","59"
"2002","Alabama-Birmingham","5","7","0","0.41667","268","370","-102"
"2003","Alabama-Birmingham","5","7","0","0.41667","245","287","-42"
"2004","Alabama-Birmingham","7","5","0","0.58333","372","351","21"
"2005","Alabama-Birmingham","5","6","0","0.45455","307","264","43"
"2006","Alabama-Birmingham","3","9","0","0.25000","225","297","-72"
"2007","Tennessee Tech","4","7","0","0.36364","329","352","-23"
"2008","Tennessee Tech","3","9","0","0.25000","240","420","-180"
"2009","Tennessee Tech","6","5","0","0.54545","267","286","-19"
"2010","Tennessee Tech","5","6","0","0.45455","264","317","-53"
"2011","Tennessee Tech","7","4","0","0.63636","355","279","76"
"2012","Tennessee Tech","3","8","0","0.27273","347","433","-86"
"2013","Tennessee Tech","5","7","0","0.41667","313","353","-40"
"1977","Cal St.-Long Beach","4","6","0","0.40000","234","252","-18"
"1978","Cal St.-Long Beach","5","6","0","0.45455","219","230","-11"
"1979","Cal St.-Long Beach","7","4","0","0.63636","205","245","-40"
"1980","Cal St.-Long Beach","8","3","0","0.72727","249","220","29"
"1981","Cal St.-Long Beach","2","8","0","0.20000","150","232","-82"
"1982","Cal St.-Long Beach","6","5","0","0.54545","243","294","-51"
"1983","Cal St.-Long Beach","8","4","0","0.66667","261","188","73"
"1984","Cincinnati (OH)","2","9","0","0.18182","198","424","-226"
"1985","Cincinnati (OH)","5","6","0","0.45455","199","261","-62"
"1986","Cincinnati (OH)","5","6","0","0.45455","267","345","-78"
"1987","Cincinnati (OH)","4","7","0","0.36364","234","314","-80"
"1988","Cincinnati (OH)","3","8","0","0.27273","201","379","-178"
"1987","Maine","8","4","0","0.66667","352","294","58"
"1988","Maine","7","4","0","0.63636","319","229","90"
"1989","Cincinnati (OH)","1","9","1","0.13636","111","379","-268"
"1990","Cincinnati (OH)","1","10","0","0.09091","172","460","-288"
"1991","Cincinnati (OH)","4","7","0","0.36364","201","323","-122"
"1992","Cincinnati (OH)","3","8","0","0.27273","199","276","-77"
"1993","Cincinnati (OH)","8","3","0","0.72727","302","197","105"
"1994","Harvard (MA)","4","6","0","0.40000","209","254","-45"
"1995","Harvard (MA)","2","8","0","0.20000","183","258","-75"
"1996","Harvard (MA)","4","6","0","0.40000","163","164","-1"
"1997","Harvard (MA)","9","1","0","0.90000","301","123","178"
"1998","Harvard (MA)","4","6","0","0.40000","136","211","-75"
"1999","Harvard (MA)","5","5","0","0.50000","254","191","63"
"2000","Harvard (MA)","5","5","0","0.50000","327","255","72"
"2001","Harvard (MA)","9","0","0","1.00000","293","184","109"
"2002","Harvard (MA)","7","3","0","0.70000","267","230","37"
"2003","Harvard (MA)","7","3","0","0.70000","317","221","96"
"2004","Harvard (MA)","10","0","0","1.00000","339","134","205"
"2005","Harvard (MA)","7","3","0","0.70000","310","224","86"
"2006","Harvard (MA)","7","3","0","0.70000","267","192","75"
"2007","Harvard (MA)","8","2","0","0.80000","266","156","110"
"2008","Harvard (MA)","9","1","0","0.90000","274","178","96"
"2009","Harvard (MA)","7","3","0","0.70000","252","172","80"
"2010","Harvard (MA)","7","3","0","0.70000","273","187","86"
"2011","Harvard (MA)","9","1","0","0.90000","374","171","203"
"2012","Harvard (MA)","8","2","0","0.80000","394","174","220"
"2013","Harvard (MA)","9","1","0","0.90000","371","227","144"
"1994","Cincinnati (OH)","2","8","1","0.22727","159","301","-142"
"1995","Cincinnati (OH)","6","5","0","0.54545","252","197","55"
"1996","Cincinnati (OH)","6","5","0","0.54545","228","212","16"
"1997","Cincinnati (OH)","8","4","0","0.66667","321","252","69"
"1998","Cincinnati (OH)","2","9","0","0.18182","259","456","-197"
"1999","Cincinnati (OH)","3","8","0","0.27273","275","289","-14"
"2000","Cincinnati (OH)","7","5","0","0.58333","289","285","4"
"2001","Cincinnati (OH)","7","5","0","0.58333","336","290","46"
"2002","Cincinnati (OH)","7","7","0","0.50000","409","329","80"
"2003","Cincinnati (OH)","5","7","0","0.41667","303","319","-16"
"2009","Marshall (WV)","1","0","0","1.00000","21","17","4"
"2004","Cincinnati (OH)","7","5","0","0.58333","344","320","24"
"2005","Cincinnati (OH)","4","7","0","0.36364","192","345","-153"
"2006","Cincinnati (OH)","7","5","0","0.58333","247","231","16"
"2007","Michigan St.","7","6","0","0.53846","430","346","84"
"2008","Michigan St.","9","4","0","0.69231","326","287","39"
"2009","Michigan St.","6","7","0","0.46154","386","342","44"
"2010","Michigan St.","11","2","0","0.84615","383","290","93"
"2011","Michigan St.","11","3","0","0.78571","434","257","177"
"2012","Michigan St.","7","6","0","0.53846","260","212","48"
"2013","Michigan St.","13","1","0","0.92857","411","185","226"
"1991","Grand Valley St. (MI)","9","3","0","0.75000","313","166","147"
"1992","Grand Valley St. (MI)","8","3","0","0.72727","249","219","30"
"1993","Grand Valley St. (MI)","6","3","2","0.63636","271","227","44"
"1994","Grand Valley St. (MI)","8","4","0","0.66667","387","239","148"
"1995","Grand Valley St. (MI)","8","3","0","0.72727","407","211","196"
"1996","Grand Valley St. (MI)","8","3","0","0.72727","272","165","107"
"1997","Grand Valley St. (MI)","9","2","0","0.81818","330","237","93"
"1998","Grand Valley St. (MI)","9","3","0","0.75000","462","322","140"
"1999","Grand Valley St. (MI)","5","5","0","0.50000","259","273","-14"
"2000","Grand Valley St. (MI)","7","4","0","0.63636","337","284","53"
"2001","Grand Valley St. (MI)","13","1","0","0.92857","707","231","476"
"2002","Grand Valley St. (MI)","14","0","0","1.00000","654","231","423"
"2003","Grand Valley St. (MI)","14","1","0","0.93333","551","200","351"
"2004","Central Michigan","4","7","0","0.36364","260","378","-118"
"2005","Central Michigan","6","5","0","0.54545","260","260","0"
"2006","Central Michigan","10","4","0","0.71429","412","322","90"
"2007","Cincinnati (OH)","10","3","0","0.76923","472","244","228"
"2008","Cincinnati (OH)","11","3","0","0.78571","362","282","80"
"2009","Cincinnati (OH)","12","0","0","1.00000","478","249","229"
"2010","Notre Dame (IN)","8","5","0","0.61538","342","263","79"
"2011","Notre Dame (IN)","8","5","0","0.61538","380","269","111"
"2012","Notre Dame (IN)","12","1","0","0.92308","335","166","169"
"2013","Notre Dame (IN)","9","4","0","0.69231","354","291","63"
"2006","Central Michigan","1","0","0","1.00000","31","14","17"
"2009","Cincinnati (OH)","0","1","0","0.00000","24","51","-27"
"2010","Buffalo (NY)","2","10","0","0.16667","170","334","-164"
"2011","Buffalo (NY)","3","9","0","0.25000","266","353","-87"
"2012","Buffalo (NY)","4","8","0","0.33333","255","342","-87"
"2013","Buffalo (NY)","8","5","0","0.61538","394","317","77"
"2007","Central Michigan","8","6","0","0.57143","487","517","-30"
"2008","Central Michigan","8","5","0","0.61538","384","393","-9"
"2009","Central Michigan","11","2","0","0.84615","431","224","207"
"2010","Cincinnati (OH)","4","8","0","0.33333","325","336","-11"
"2011","Cincinnati (OH)","10","3","0","0.76923","433","264","169"
"2012","Cincinnati (OH)","9","3","0","0.75000","372","206","166"
"2013","Tennessee","5","7","0","0.41667","286","348","-62"
"2009","Central Michigan","1","0","0","1.00000","44","41","3"
"2012","Cincinnati (OH)","1","0","0","1.00000","48","34","14"
"1995","Mississippi","6","5","0","0.54545","209","208","1"
"1996","Mississippi","5","6","0","0.45455","203","270","-67"
"1997","Mississippi","8","4","0","0.66667","267","240","27"
"1998","Mississippi","6","5","0","0.54545","245","256","-11"
"1999","Auburn (AL)","5","6","0","0.45455","233","236","-3"
"2000","Auburn (AL)","9","4","0","0.69231","316","266","50"
"2001","Auburn (AL)","7","5","0","0.58333","254","281","-27"
"2002","Auburn (AL)","9","4","0","0.69231","388","231","157"
"2003","Auburn (AL)","8","5","0","0.61538","342","212","130"
"2004","Auburn (AL)","13","0","0","1.00000","417","147","270"
"2005","Auburn (AL)","9","3","0","0.75000","386","186","200"
"2006","Auburn (AL)","11","2","0","0.84615","322","181","141"
"2007","Auburn (AL)","9","4","0","0.69231","315","220","95"
"2008","Auburn (AL)","5","7","0","0.41667","208","216","-8"
"2010","Texas Tech","8","5","0","0.61538","430","402","28"
"2011","Texas Tech","5","7","0","0.41667","406","471","-65"
"2012","Texas Tech","7","5","0","0.58333","453","382","71"
"2013","Cincinnati (OH)","9","4","0","0.69231","417","273","144"
"1896","Clemson (SC)","2","1","0","0.66667","36","18","18"
"1899","Clemson (SC)","4","2","0","0.66667","95","50","45"
"1897","Clemson (SC)","2","2","0","0.50000","30","58","-28"
"1898","Clemson (SC)","3","1","0","0.75000","110","20","90"
"1893","Akron (OH)","5","2","0","0.71429","276","82","194"
"1894","Akron (OH)","1","0","0","1.00000","12","6","6"
"1895","Auburn (AL)","2","1","0","0.66667","70","15","55"
"1896","Auburn (AL)","3","1","0","0.75000","135","18","117"
"1897","Auburn (AL)","2","0","1","0.83333","40","4","36"
"1898","Auburn (AL)","2","1","0","0.66667","47","47","0"
"1899","Auburn (AL)","3","1","1","0.70000","148","11","137"
"1900","Clemson (SC)","6","0","0","1.00000","222","10","212"
"1901","Clemson (SC)","3","1","1","0.70000","190","38","152"
"1902","Clemson (SC)","6","1","0","0.85714","152","22","130"
"1903","Clemson (SC)","4","1","1","0.75000","167","22","145"
"1904","Georgia Tech","8","1","1","0.85000","287","34","253"
"1905","Georgia Tech","7","0","1","0.93750","233","33","200"
"1906","Georgia Tech","6","3","1","0.65000","140","69","71"
"1907","Georgia Tech","4","4","0","0.50000","148","100","48"
"1908","Georgia Tech","6","3","0","0.66667","147","74","73"
"1909","Georgia Tech","7","2","0","0.77778","217","44","173"
"1910","Georgia Tech","5","3","0","0.62500","197","50","147"
"1911","Georgia Tech","6","2","1","0.72222","150","21","129"
"1912","Georgia Tech","5","3","1","0.61111","100","86","14"
"1913","Georgia Tech","7","2","0","0.77778","250","43","207"
"1914","Georgia Tech","6","2","0","0.75000","206","40","166"
"1915","Georgia Tech","7","0","1","0.93750","233","24","209"
"1916","Georgia Tech","8","0","1","0.94444","421","20","401"
"1917","Georgia Tech","9","0","0","1.00000","491","17","474"
"1918","Georgia Tech","6","1","0","0.85714","466","32","434"
"1919","Georgia Tech","7","3","0","0.70000","256","33","223"
"1920","Pennsylvania","6","4","0","0.60000","167","133","34"
"1921","Pennsylvania","4","3","2","0.55556","164","135","29"
"1922","Pennsylvania","6","3","0","0.66667","100","44","56"
"1924","Rice (TX)","4","4","0","0.50000","85","70","15"
"1925","Rice (TX)","4","4","1","0.50000","85","79","6"
"1926","Rice (TX)","4","4","1","0.50000","84","81","3"
"1927","Rice (TX)","2","6","1","0.27778","64","160","-96"
"1904","Clemson (SC)","3","3","1","0.50000","50","45","5"
"1902","North Dakota St.","4","0","0","1.00000","168","0","168"
"1903","North Dakota St.","5","1","0","0.83333","331","49","282"
"1905","Clemson (SC)","3","2","1","0.58333","81","63","18"
"1914","Maine","6","3","0","0.66667","221","70","151"
"1902","South Carolina","6","1","0","0.85714","195","16","179"
"1903","South Carolina","8","2","0","0.80000","239","35","204"
"1904","Davidson (NC)","6","1","1","0.81250","115","8","107"
"1905","Davidson (NC)","3","3","0","0.50000","93","28","65"
"1906","Clemson (SC)","4","0","3","0.78571","38","4","34"
"1907","Virginia Tech","7","2","0","0.77778","157","30","127"
"1909","Clemson (SC)","6","3","0","0.66667","93","43","50"
"1913","Clemson (SC)","4","4","0","0.50000","112","98","14"
"1914","Clemson (SC)","6","3","1","0.65000","197","123","74"
"1915","Clemson (SC)","2","4","2","0.37500","113","48","65"
"1907","Clemson (SC)","4","4","0","0.50000","67","45","22"
"1908","Clemson (SC)","1","6","0","0.14286","26","104","-78"
"1910","Clemson (SC)","4","3","1","0.56250","106","54","52"
"1911","Clemson (SC)","3","5","0","0.37500","70","109","-39"
"1912","Clemson (SC)","4","4","0","0.50000","177","126","51"
"1913","Richmond (VA)","5","3","1","0.61111","102","138","-36"
"1914","Richmond (VA)","5","4","0","0.55556","114","152","-38"
"1915","Richmond (VA)","4","4","1","0.50000","109","122","-13"
"1916","Richmond (VA)","5","4","2","0.54545","130","91","39"
"1917","Richmond (VA)","4","2","1","0.64286","161","55","106"
"1918","South Carolina","2","1","1","0.62500","33","51","-18"
"1919","Richmond (VA)","5","2","2","0.66667","94","35","59"
"1920","Richmond (VA)","6","2","0","0.75000","160","49","111"
"1921","Richmond (VA)","4","3","1","0.56250","140","76","64"
"1922","Richmond (VA)","6","2","1","0.72222","160","64","96"
"1923","Richmond (VA)","3","5","0","0.37500","39","149","-110"
"1924","Richmond (VA)","2","6","1","0.27778","40","123","-83"
"1925","Richmond (VA)","3","6","0","0.33333","41","81","-40"
"1926","Richmond (VA)","2","7","0","0.22222","54","100","-46"
"1927","Richmond (VA)","4","4","1","0.50000","50","168","-118"
"1928","Richmond (VA)","3","4","2","0.44444","146","76","70"
"1929","Richmond (VA)","3","5","1","0.38889","63","142","-79"
"1930","Richmond (VA)","2","4","2","0.37500","45","57","-12"
"1931","Richmond (VA)","4","5","0","0.44444","48","99","-51"
"1932","Richmond (VA)","4","2","2","0.62500","44","49","-5"
"1933","Richmond (VA)","5","4","0","0.55556","100","55","45"
"1936","Maryland","6","5","0","0.54545","117","59","58"
"1937","Maryland","8","2","0","0.80000","127","65","62"
"1938","Maryland","2","7","0","0.22222","86","235","-149"
"1939","Maryland","2","7","0","0.22222","64","106","-42"
"1916","Clemson (SC)","3","6","0","0.33333","81","147","-66"
"1917","Clemson (SC)","6","2","0","0.75000","183","64","119"
"1918","Clemson (SC)","5","2","0","0.71429","198","101","97"
"1919","Clemson (SC)","6","2","2","0.70000","152","55","97"
"1920","Clemson (SC)","4","6","1","0.40909","98","146","-48"
"1907","Mount Union (OH)","9","2","0","0.81818","265","23","242"
"1909","Allegheny (PA)","2","4","1","0.35714","41","115","-74"
"1910","Allegheny (PA)","4","1","1","0.75000","81","29","52"
"1913","Oregon St.","3","2","3","0.56250","59","75","-16"
"1914","Oregon St.","7","0","2","0.88889","172","15","157"
"1915","Oregon St.","5","3","0","0.62500","166","73","93"
"1916","Nebraska","6","2","0","0.75000","145","51","94"
"1917","Nebraska","5","2","0","0.71429","228","33","195"
"1921","Clemson (SC)","1","6","2","0.22222","48","187","-139"
"1922","Clemson (SC)","5","4","0","0.55556","170","109","61"
"1923","Texas","8","0","1","0.94444","241","21","220"
"1924","Texas","5","3","1","0.61111","109","64","45"
"1925","Texas","6","2","1","0.72222","157","51","106"
"1926","Texas","5","4","0","0.55556","146","69","77"
"1927","Texas-El Paso","2","2","2","0.50000","69","69","0"
"1928","Texas-El Paso","3","4","1","0.43750","100","103","-3"
"1923","Clemson (SC)","5","2","1","0.68750","91","65","26"
"1924","Clemson (SC)","2","6","0","0.25000","80","96","-16"
"1925","Clemson (SC)","1","7","0","0.12500","27","160","-133"
"1926","Clemson (SC)","2","7","0","0.22222","20","169","-149"
"1920","Mercer (GA)","2","7","0","0.22222","97","179","-82"
"1921","Mercer (GA)","3","6","0","0.33333","92","145","-53"
"1922","Mercer (GA)","5","6","0","0.45455","134","201","-67"
"1927","Clemson (SC)","5","3","1","0.61111","74","84","-10"
"1928","Clemson (SC)","8","3","0","0.72727","192","77","115"
"1929","Clemson (SC)","8","3","0","0.72727","236","110","126"
"1930","Clemson (SC)","8","2","0","0.80000","239","82","157"
"1936","Florida","4","6","0","0.40000","99","125","-26"
"1937","Florida","4","7","0","0.36364","86","89","-3"
"1938","Florida","4","6","1","0.40909","112","149","-37"
"1939","Florida","5","5","1","0.50000","78","66","12"
"1955","Temple (PA)","0","8","0","0.00000","49","223","-174"
"1931","Clemson (SC)","1","6","2","0.22222","19","164","-145"
"1932","Clemson (SC)","3","5","1","0.38889","89","111","-22"
"1933","Clemson (SC)","3","6","2","0.36364","50","98","-48"
"1934","Clemson (SC)","5","4","0","0.55556","89","85","4"
"1935","Clemson (SC)","6","3","0","0.66667","147","99","48"
"1936","Clemson (SC)","5","5","0","0.50000","98","95","3"
"1937","Clemson (SC)","4","4","1","0.50000","128","64","64"
"1938","Clemson (SC)","7","1","1","0.83333","145","56","89"
"1939","Clemson (SC)","9","1","0","0.90000","165","45","120"
"1940","Rice (TX)","7","3","0","0.70000","131","78","53"
"1941","Rice (TX)","6","3","1","0.65000","167","121","46"
"1942","Rice (TX)","7","2","1","0.75000","177","74","103"
"1943","Rice (TX)","3","7","0","0.30000","60","183","-123"
"1944","Rice (TX)","5","6","0","0.45455","143","163","-20"
"1945","Rice (TX)","5","6","0","0.45455","130","153","-23"
"1946","Rice (TX)","9","2","0","0.81818","245","62","183"
"1947","Rice (TX)","6","3","1","0.65000","202","74","128"
"1948","Rice (TX)","5","4","1","0.55000","168","119","49"
"1949","Rice (TX)","10","1","0","0.90909","276","97","179"
"1950","Rice (TX)","6","4","0","0.60000","168","196","-28"
"1951","Rice (TX)","5","5","0","0.50000","149","144","5"
"1952","Rice (TX)","5","5","0","0.50000","152","175","-23"
"1953","Rice (TX)","9","2","0","0.81818","295","105","190"
"1954","Rice (TX)","7","3","0","0.70000","205","148","57"
"1955","Rice (TX)","2","7","1","0.25000","110","179","-69"
"1956","Rice (TX)","4","6","0","0.40000","160","169","-9"
"1957","Rice (TX)","7","4","0","0.63636","175","121","54"
"1958","Rice (TX)","5","5","0","0.50000","178","156","22"
"1959","Rice (TX)","1","7","2","0.20000","86","197","-111"
"1960","Rice (TX)","7","4","0","0.63636","174","72","102"
"1961","Rice (TX)","7","4","0","0.63636","183","158","25"
"1962","Rice (TX)","2","6","2","0.30000","119","173","-54"
"1963","Rice (TX)","6","4","0","0.60000","145","114","31"
"1964","Rice (TX)","4","5","1","0.45000","117","111","6"
"1965","Rice (TX)","2","8","0","0.20000","123","248","-125"
"1966","Rice (TX)","2","8","0","0.20000","154","211","-57"
"1940","Clemson (SC)","6","2","1","0.72222","182","73","109"
"1941","Clemson (SC)","7","2","0","0.77778","233","90","143"
"1942","Clemson (SC)","3","6","1","0.35000","100","138","-38"
"1943","Clemson (SC)","2","6","0","0.25000","94","185","-91"
"1944","Clemson (SC)","4","5","0","0.44444","165","179","-14"
"1945","Clemson (SC)","6","3","1","0.65000","211","73","138"
"1946","Clemson (SC)","4","5","0","0.44444","147","174","-27"
"1947","Clemson (SC)","4","5","0","0.44444","206","146","60"
"1948","Clemson (SC)","11","0","0","1.00000","274","76","198"
"1949","Clemson (SC)","4","4","2","0.50000","232","216","16"
"1950","Clemson (SC)","9","0","1","0.95000","344","76","268"
"1951","Clemson (SC)","7","3","0","0.70000","196","97","99"
"1952","Clemson (SC)","2","6","1","0.27778","112","157","-45"
"1953","Clemson (SC)","3","5","1","0.38889","139","172","-33"
"1954","Clemson (SC)","5","5","0","0.50000","193","121","72"
"1955","Clemson (SC)","7","3","0","0.70000","206","144","62"
"1956","Clemson (SC)","7","2","2","0.72727","167","101","66"
"1957","Clemson (SC)","7","3","0","0.70000","216","78","138"
"1958","Clemson (SC)","8","3","0","0.72727","169","138","31"
"1959","Clemson (SC)","9","2","0","0.81818","285","103","182"
"1960","Clemson (SC)","6","4","0","0.60000","197","124","73"
"1961","Clemson (SC)","5","5","0","0.50000","199","126","73"
"1962","Clemson (SC)","6","4","0","0.60000","168","130","38"
"1963","Clemson (SC)","5","4","1","0.55000","181","140","41"
"1964","Clemson (SC)","3","7","0","0.30000","105","135","-30"
"1965","Clemson (SC)","5","5","0","0.50000","117","137","-20"
"1966","Clemson (SC)","6","4","0","0.60000","174","177","-3"
"1967","Clemson (SC)","6","4","0","0.60000","166","128","38"
"1968","Clemson (SC)","4","5","1","0.45000","184","179","5"
"1969","Clemson (SC)","4","6","0","0.40000","178","250","-72"
"1970","Clemson (SC)","3","8","0","0.27273","164","313","-149"
"1971","Clemson (SC)","5","6","0","0.45455","155","202","-47"
"1972","Clemson (SC)","4","7","0","0.36364","143","245","-102"
"1961","Arkansas-Monticello","2","8","0","0.20000","81","243","-162"
"1962","Arkansas-Monticello","3","6","1","0.35000","124","131","-7"
"1963","Arkansas-Monticello","9","1","0","0.90000","203","68","135"
"1964","Arkansas-Monticello","8","2","0","0.80000","187","101","86"
"1965","Arkansas-Monticello","7","2","1","0.75000","198","123","75"
"1966","Citadel (SC)","4","6","0","0.40000","120","178","-58"
"1967","Citadel (SC)","5","5","0","0.50000","155","144","11"
"1968","Citadel (SC)","5","5","0","0.50000","177","200","-23"
"1969","Citadel (SC)","7","3","0","0.70000","262","194","68"
"1970","Citadel (SC)","5","6","0","0.45455","259","241","18"
"1971","Citadel (SC)","8","3","0","0.72727","366","272","94"
"1972","Citadel (SC)","5","6","0","0.45455","192","183","9"
"1973","Clemson (SC)","5","6","0","0.45455","231","263","-32"
"1974","Clemson (SC)","7","4","0","0.63636","246","250","-4"
"1975","Clemson (SC)","2","9","0","0.18182","177","381","-204"
"1976","Clemson (SC)","3","6","2","0.36364","172","237","-65"
"1981","Southern Arkansas","7","3","0","0.70000","239","175","64"
"1982","Delta St. (MS)","6","4","0","0.60000","244","176","68"
"1983","Delta St. (MS)","5","5","0","0.50000","242","273","-31"
"1984","Delta St. (MS)","7","3","1","0.68182","287","187","100"
"1985","Delta St. (MS)","4","6","1","0.40909","157","227","-70"
"1986","Delta St. (MS)","6","4","1","0.59091","244","246","-2"
"1987","Delta St. (MS)","6","4","1","0.59091","227","220","7"
"1996","Ouachita Baptist (AR)","3","7","0","0.30000","168","297","-129"
"1997","Ouachita Baptist (AR)","4","6","0","0.40000","205","244","-39"
"1998","Ouachita Baptist (AR)","3","7","0","0.30000","169","223","-54"
"1969","Jacksonville St. (AL)","3","6","0","0.33333","127","211","-84"
"1970","Jacksonville St. (AL)","10","0","0","1.00000","325","104","221"
"1971","Jacksonville St. (AL)","6","3","0","0.66667","297","142","155"
"1972","Jacksonville St. (AL)","7","2","1","0.75000","239","109","130"
"1973","Jacksonville St. (AL)","7","2","0","0.77778","319","137","182"
"1977","Clemson (SC)","8","3","1","0.70833","228","163","65"
"1978","Clemson (SC)","10","1","0","0.90909","351","116","235"
"1979","Florida","0","10","1","0.04545","106","265","-159"
"1980","Florida","8","4","0","0.66667","256","186","70"
"1981","Florida","7","5","0","0.58333","284","166","118"
"1982","Florida","8","4","0","0.66667","296","228","68"
"1983","Florida","9","2","1","0.79167","304","156","148"
"1984","Florida","1","1","1","0.50000","104","74","30"
"1978","Clemson (SC)","1","0","0","1.00000","17","15","2"
"1979","Clemson (SC)","8","4","0","0.66667","205","116","89"
"1980","Clemson (SC)","6","5","0","0.54545","217","222","-5"
"1981","Clemson (SC)","12","0","0","1.00000","338","105","233"
"1982","Clemson (SC)","9","1","1","0.86364","289","147","142"
"1983","Clemson (SC)","9","1","1","0.86364","338","200","138"
"1984","Clemson (SC)","7","4","0","0.63636","346","215","131"
"1985","Clemson (SC)","6","6","0","0.50000","244","222","22"
"1986","Clemson (SC)","8","2","2","0.75000","296","187","109"
"1987","Clemson (SC)","10","2","0","0.83333","333","176","157"
"1988","Clemson (SC)","10","2","0","0.83333","342","157","185"
"1989","Clemson (SC)","10","2","0","0.83333","368","138","230"
"1993","Arkansas","6","4","1","0.59091","165","208","-43"
"1994","Arkansas","4","7","0","0.36364","212","213","-1"
"1995","Arkansas","8","5","0","0.61538","284","283","1"
"1996","Arkansas","4","7","0","0.36364","174","267","-93"
"1997","Arkansas","4","7","0","0.36364","181","284","-103"
"1979","Air Force (CO)","2","9","0","0.18182","127","253","-126"
"1980","Air Force (CO)","2","9","1","0.20833","161","290","-129"
"1981","Air Force (CO)","4","7","0","0.36364","171","252","-81"
"1982","Air Force (CO)","8","5","0","0.61538","395","367","28"
"1983","Air Force (CO)","10","2","0","0.83333","367","221","146"
"1984","Arkansas","7","4","1","0.62500","268","159","109"
"1985","Arkansas","10","2","0","0.83333","323","146","177"
"1986","Arkansas","9","3","0","0.75000","311","184","127"
"1987","Arkansas","9","4","0","0.69231","300","219","81"
"1988","Arkansas","10","2","0","0.83333","349","190","159"
"1989","Arkansas","10","2","0","0.83333","385","230","155"
"1990","Clemson (SC)","10","2","0","0.83333","333","109","224"
"1991","Clemson (SC)","9","2","1","0.79167","317","185","132"
"1992","Clemson (SC)","5","6","0","0.45455","261","213","48"
"1993","Clemson (SC)","8","3","0","0.72727","184","179","5"
"1994","Rice (TX)","5","6","0","0.45455","206","203","3"
"1995","Rice (TX)","2","8","1","0.22727","215","284","-69"
"1996","Rice (TX)","7","4","0","0.63636","296","312","-16"
"1997","Rice (TX)","7","4","0","0.63636","306","285","21"
"1998","Rice (TX)","5","6","0","0.45455","235","257","-22"
"1999","Rice (TX)","5","6","0","0.45455","237","261","-24"
"2000","Rice (TX)","3","8","0","0.27273","237","322","-85"
"2001","Rice (TX)","8","4","0","0.66667","333","335","-2"
"2002","Rice (TX)","4","7","0","0.36364","253","296","-43"
"2003","Rice (TX)","5","7","0","0.41667","343","378","-35"
"2004","Rice (TX)","3","8","0","0.27273","279","377","-98"
"2005","Rice (TX)","1","10","0","0.09091","241","447","-206"
"1993","Clemson (SC)","5","7","0","0.41667","264","389","-125"
"1994","Clemson (SC)","5","6","0","0.45455","164","188","-24"
"1995","Clemson (SC)","8","4","0","0.66667","303","219","84"
"1996","Clemson (SC)","7","5","0","0.58333","245","241","4"
"1997","Clemson (SC)","7","5","0","0.58333","292","219","73"
"1998","Clemson (SC)","3","8","0","0.27273","218","272","-54"
"2001","Memphis (TN)","5","6","0","0.45455","294","281","13"
"2002","Memphis (TN)","3","9","0","0.25000","303","327","-24"
"2003","Memphis (TN)","9","4","0","0.69231","393","250","143"
"2004","Memphis (TN)","8","4","0","0.66667","430","375","55"
"2005","Memphis (TN)","7","5","0","0.58333","326","276","50"
"2006","Memphis (TN)","2","10","0","0.16667","281","365","-84"
"2007","Memphis (TN)","7","6","0","0.53846","380","419","-39"
"2008","Memphis (TN)","6","7","0","0.46154","353","353","0"
"2009","Memphis (TN)","2","10","0","0.16667","262","418","-156"
"1997","Tulane (LA)","7","4","0","0.63636","375","225","150"
"1998","Tulane (LA)","11","0","0","1.00000","499","268","231"
"1999","Clemson (SC)","6","6","0","0.50000","322","253","69"
"2000","Clemson (SC)","9","3","0","0.75000","416","253","163"
"2001","Clemson (SC)","7","5","0","0.58333","369","339","30"
"2002","Clemson (SC)","7","6","0","0.53846","330","349","-19"
"2003","Clemson (SC)","9","4","0","0.69231","365","250","115"
"2004","Clemson (SC)","6","5","0","0.54545","236","229","7"
"2005","Clemson (SC)","8","4","0","0.66667","316","211","105"
"2006","Clemson (SC)","8","5","0","0.61538","425","210","215"
"2007","Clemson (SC)","9","4","0","0.69231","430","243","187"
"2008","Clemson (SC)","3","3","0","0.50000","160","92","68"
"2008","Clemson (SC)","4","3","0","0.57143","167","133","34"
"2009","Clemson (SC)","9","5","0","0.64286","436","286","150"
"2010","Clemson (SC)","6","7","0","0.46154","312","244","68"
"2011","Clemson (SC)","10","4","0","0.71429","470","410","60"
"2012","Clemson (SC)","11","2","0","0.84615","533","323","210"
"2013","Clemson (SC)","11","2","0","0.84615","522","288","234"
"1869","Rutgers (NJ)","2","2","0","0.50000","18","18","0"
"1870","Rutgers (NJ)","2","2","0","0.50000","17","17","0"
"1872","Columbia (NY)","5","4","0","0.55556","22","16","6"
"1873","Rutgers (NJ)","7","4","1","0.62500","31","26","5"
"1874","Harvard (MA)","9","7","0","0.56250","54","41","13"
"1875","Harvard (MA)","12","6","2","0.65000","52","29","23"
"1876","Harvard (MA)","13","8","1","0.61364","45","29","16"
"1877","Harvard (MA)","9","7","3","0.55263","31","21","10"
"1878","Pennsylvania","14","9","5","0.58929","42","24","18"
"1879","Harvard (MA)","13","9","12","0.55882","46","27","19"
"1880","Harvard (MA)","18","11","4","0.60606","75","53","22"
"1881","Rutgers (NJ)","22","18","8","0.54167","70","47","23"
"1882","Rutgers (NJ)","41","28","2","0.59155","176","111","65"
"1883","Rutgers (NJ)","38","32","1","0.54225","1288","965","323"
"1884","Pennsylvania","47","29","5","0.61111","1728","1184","544"
"1885","Michigan","34","17","4","0.65455","1437","612","825"
"1886","Lehigh (PA)","48","21","4","0.68493","1850","637","1213"
"1887","California","67","35","3","0.65238","2660","935","1725"
"1888","Princeton (NJ)","70","56","6","0.55303","2468","1899","569"
"1889","Brown (RI)","82","51","11","0.60764","2879","1796","1083"
"1890","Brown (RI)","77","76","9","0.50309","3002","2455","547"
"1891","Southern California","94","76","13","0.54918","2813","2189","624"
"1892","Minnesota","93","80","9","0.53571","2972","2394","578"
"1893","Duke (NC)","79","94","9","0.45879","2176","2912","-736"
"1894","Colorado St.","50","62","4","0.44828","1161","1518","-357"
"1895","Boston (MA)","31","44","11","0.42442","692","1031","-339"
"1896","Rhode Island","54","62","12","0.46875","1126","1201","-75"
"1897","Boston (MA)","32","40","6","0.44872","792","785","7"
"1898","Miami (OH)","47","23","4","0.66216","921","644","277"
"1899","New Hampshire","33","32","6","0.50704","571","522","49"
"1900","New Hampshire","22","35","11","0.40441","442","686","-244"
"1901","Marshall (WV)","18","34","3","0.35455","302","917","-615"
"1902","Saint John's (MN)","9","22","4","0.31429","148","460","-312"
"1903","Wichita St. (KS)","14","25","2","0.36585","376","546","-170"
"1904","Oklahoma St.","11","14","1","0.44231","194","394","-200"
"1905","Miami (OH)","7","25","5","0.25676","245","494","-249"
"1906","Rensselaer Tech (NY)","3","7","4","0.35714","92","107","-15"
"1907","Marshall (WV)","5","10","2","0.35294","71","238","-167"
"1908","Fort Hays St. (KS)","5","6","1","0.45833","56","91","-35"
"1909","Fort Hays St. (KS)","1","3","1","0.30000","12","68","-56"
"1910","Texas St.","0","1","0","0.00000","0","19","-19"
"1912","Fort Hays St. (KS)","1","2","0","0.33333","20","132","-112"
"1913","Eureka (IL)","1","6","0","0.14286","39","203","-164"
"1914","Eureka (IL)","3","4","0","0.42857","57","201","-144"
"1915","Texas St.","1","1","1","0.50000","13","20","-7"
"1916","Texas St.","0","2","1","0.16667","0","106","-106"
"1917","Boston (MA)","4","4","0","0.50000","73","136","-63"
"1918","Monmouth (IL)","1","7","0","0.12500","26","137","-111"
"1930","Troy (AL)","1","2","0","0.33333","7","73","-66"
"2013","Grambling St. (LA)","0","1","0","0.00000","0","0","0"
"1894","Colorado","8","1","0","0.88889","286","48","238"
"1900","Colorado","6","4","0","0.60000","150","78","72"
"1901","Alma (MI)","3","2","0","0.60000","28","33","-5"
"1903","Colorado","8","2","0","0.80000","197","54","143"
"1904","Colorado","6","2","1","0.72222","187","58","129"
"1904","North Carolina St.","3","1","2","0.66667","89","11","78"
"1905","Colorado","8","1","0","0.88889","359","28","331"
"1906","North Carolina","1","4","2","0.28571","18","83","-65"
"1907","Auburn (AL)","6","2","1","0.72222","185","30","155"
"1909","Washington St.","4","1","0","0.80000","159","17","142"
"1906","Colorado","2","3","4","0.44444","28","32","-4"
"1907","Colorado","5","3","0","0.62500","127","64","63"
"1895","Colorado","4","1","0","0.80000","122","32","90"
"1896","Colorado","5","0","0","1.00000","171","6","165"
"1897","Colorado","7","1","0","0.87500","188","10","178"
"1898","Colorado","4","4","0","0.50000","150","73","77"
"1899","Colorado","7","2","0","0.77778","210","34","176"
"1901","Colorado","5","2","1","0.68750","56","32","24"
"1902","Colorado","5","1","0","0.83333","87","22","65"
"1903","Dartmouth (NH)","9","1","0","0.90000","242","23","219"
"1904","Dartmouth (NH)","7","0","1","0.93750","143","13","130"
"1905","Dartmouth (NH)","7","1","2","0.80000","150","34","116"
"1906","Dartmouth (NH)","6","3","1","0.65000","72","87","-15"
"1908","Colorado","5","2","0","0.71429","96","35","61"
"1909","Colorado","6","0","0","1.00000","141","0","141"
"1910","Colorado","6","0","0","1.00000","119","3","116"
"1911","Colorado","6","0","0","1.00000","88","5","83"
"1912","Colorado","6","3","0","0.66667","147","81","66"
"1913","Colorado","5","1","1","0.78571","82","33","49"
"1914","Colorado","5","1","0","0.83333","111","22","89"
"1915","Colorado","1","6","0","0.14286","45","168","-123"
"1916","Colorado","1","5","1","0.21429","40","162","-122"
"1917","Colorado","6","2","0","0.75000","114","56","58"
"1919","Stanford (CA)","4","3","0","0.57143","130","46","84"
"1908","Baylor (TX)","3","5","0","0.37500","48","164","-116"
"1909","Baylor (TX)","5","3","0","0.62500","112","41","71"
"1918","Colorado","2","3","0","0.40000","43","42","1"
"1919","Colorado","2","3","1","0.41667","87","96","-9"
"1906","Purdue (IN)","0","5","0","0.00000","5","86","-81"
"1920","Colorado","4","1","2","0.71429","99","28","71"
"1921","Colorado","4","1","1","0.75000","65","63","2"
"1922","Colorado","4","4","0","0.50000","56","79","-23"
"1923","Colorado","9","0","0","1.00000","280","27","253"
"1924","Colorado","8","1","1","0.85000","237","13","224"
"1925","Colorado","6","3","0","0.66667","156","45","111"
"1926","Colorado","3","5","1","0.38889","77","103","-26"
"1927","Colorado","4","5","0","0.44444","136","195","-59"
"1928","Colorado","5","1","0","0.83333","110","57","53"
"1929","Colorado","5","1","1","0.78571","78","69","9"
"1930","Colorado","6","1","1","0.81250","120","68","52"
"1931","Colorado","5","3","0","0.62500","111","94","17"
"1928","Northern Colorado","4","4","0","0.50000","184","86","98"
"1929","Northern Colorado","4","3","0","0.57143","61","70","-9"
"1930","Northern Colorado","2","2","3","0.50000","48","73","-25"
"1931","Northern Colorado","2","4","1","0.35714","52","69","-17"
"1932","Colorado","2","4","0","0.33333","63","46","17"
"1933","Colorado","7","2","0","0.77778","183","51","132"
"1934","Colorado","6","1","2","0.77778","167","40","127"
"1936","Denver (CO)","7","1","1","0.83333","141","88","53"
"1937","Denver (CO)","6","3","0","0.66667","122","61","61"
"1938","Denver (CO)","4","4","1","0.50000","65","86","-21"
"1931","Montana","1","6","0","0.14286","56","155","-99"
"1932","Montana","2","7","0","0.22222","84","224","-140"
"1933","Montana","3","4","0","0.42857","91","85","6"
"1934","Montana","2","5","1","0.31250","90","82","8"
"1935","Colorado","5","4","0","0.55556","140","47","93"
"1936","Colorado","4","3","0","0.57143","99","43","56"
"1937","Colorado","8","1","0","0.88889","262","54","208"
"1938","Colorado","3","4","1","0.43750","78","78","0"
"1939","Colorado","5","3","0","0.62500","106","110","-4"
"1941","Wyoming","2","7","1","0.25000","44","233","-189"
"1942","Wyoming","3","5","0","0.37500","106","115","-9"
"1946","Wyoming","1","8","1","0.15000","44","192","-148"
"1940","Colorado","5","3","1","0.61111","182","106","76"
"1944","Colorado","6","2","0","0.75000","201","72","129"
"1945","Colorado","5","3","0","0.62500","111","58","53"
"1935","Fort Hays St. (KS)","8","2","0","0.80000","171","62","109"
"1937","Iowa St.","3","6","0","0.33333","50","161","-111"
"1938","Iowa St.","7","1","1","0.83333","125","64","61"
"1939","Iowa St.","2","7","0","0.22222","50","117","-67"
"1940","Iowa St.","4","5","0","0.44444","118","132","-14"
"1941","Colorado","3","4","1","0.43750","97","161","-64"
"1942","Colorado","7","2","0","0.77778","251","73","178"
"1943","Colorado","5","2","0","0.71429","134","47","87"
"1946","Colorado","5","4","1","0.55000","91","147","-56"
"1947","Colorado","4","5","0","0.44444","90","162","-72"
"1948","Colorado","3","6","0","0.33333","168","164","4"
"1949","Colorado","3","7","0","0.30000","129","184","-55"
"1950","Colorado","5","4","1","0.55000","227","172","55"
"1951","Colorado","7","3","0","0.70000","289","229","60"
"1952","Colorado","6","2","2","0.70000","246","158","88"
"1953","Colorado","6","4","0","0.60000","201","194","7"
"1954","Colorado","7","2","1","0.75000","283","91","192"
"1955","Colorado","6","4","0","0.60000","203","149","54"
"1956","Colorado","8","2","1","0.77273","294","143","151"
"1957","Colorado","6","3","1","0.65000","250","137","113"
"1958","Colorado","6","4","0","0.60000","207","122","85"
"1959","Colorado","5","5","0","0.50000","144","177","-33"
"1960","Colorado","7","3","0","0.70000","140","133","7"
"1961","Colorado","9","2","0","0.81818","184","104","80"
"1962","Colorado","2","8","0","0.20000","122","346","-224"
"1963","Colorado","2","8","0","0.20000","100","245","-145"
"1964","Colorado","2","8","0","0.20000","101","156","-55"
"1965","Colorado","6","2","2","0.70000","163","106","57"
"1966","Colorado","7","3","0","0.70000","191","132","59"
"1967","Colorado","9","2","0","0.81818","245","113","132"
"1968","Colorado","4","6","0","0.40000","220","244","-24"
"1969","Colorado","8","3","0","0.72727","276","227","49"
"1970","Colorado","6","5","0","0.54545","309","206","103"
"1971","Colorado","10","2","0","0.83333","370","220","150"
"1972","Colorado","8","4","0","0.66667","313","206","107"
"1973","Colorado","5","6","0","0.45455","240","250","-10"
"1969","Miami (OH)","7","3","0","0.70000","231","139","92"
"1970","Miami (OH)","7","3","0","0.70000","187","112","75"
"1971","Miami (OH)","7","3","0","0.70000","207","117","90"
"1972","Miami (OH)","7","3","0","0.70000","232","116","116"
"1973","Miami (OH)","11","0","0","1.00000","223","76","147"
"1974","Colorado","5","6","0","0.45455","226","307","-81"
"1975","Colorado","9","3","0","0.75000","331","251","80"
"1976","Colorado","8","4","0","0.66667","305","225","80"
"1977","Colorado","7","3","1","0.68182","266","174","92"
"1978","Colorado","6","5","0","0.54545","230","206","24"
"1980","Northern Illinois","7","4","0","0.63636","216","175","41"
"1981","Northern Illinois","3","8","0","0.27273","160","217","-57"
"1982","Northern Illinois","5","5","0","0.50000","137","136","1"
"1983","Northern Illinois","10","2","0","0.83333","314","203","111"
"1984","Indiana","0","11","0","0.00000","185","338","-153"
"1985","Indiana","4","7","0","0.36364","251","340","-89"
"1986","Indiana","6","6","0","0.50000","273","227","46"
"1987","Indiana","8","4","0","0.66667","283","238","45"
"1988","Indiana","8","3","1","0.70833","396","235","161"
"1989","Indiana","5","6","0","0.45455","289","262","27"
"1990","Indiana","6","5","1","0.54167","329","238","91"
"1991","Indiana","7","4","1","0.62500","305","224","81"
"1992","Indiana","5","6","0","0.45455","177","197","-20"
"1993","Indiana","8","4","0","0.66667","259","197","62"
"1994","Indiana","7","4","0","0.63636","294","285","9"
"1995","Indiana","2","9","0","0.18182","159","326","-167"
"1996","Indiana","3","8","0","0.27273","242","291","-49"
"1967","Oklahoma","10","1","0","0.90909","290","92","198"
"1968","Oklahoma","7","4","0","0.63636","343","225","118"
"1969","Oklahoma","6","4","0","0.60000","285","289","-4"
"1970","Oklahoma","7","4","1","0.62500","305","239","66"
"1971","Oklahoma","11","1","0","0.91667","534","217","317"
"1972","Oklahoma","8","4","0","0.66667","399","74","325"
"1979","Colorado","3","8","0","0.27273","168","274","-106"
"1980","Colorado","1","10","0","0.09091","160","451","-291"
"1981","Colorado","3","8","0","0.27273","141","322","-181"
"1982","Colorado","2","8","1","0.22727","160","301","-141"
"1983","Colorado","4","7","0","0.36364","252","342","-90"
"1984","Colorado","1","10","0","0.09091","172","364","-192"
"1985","Colorado","7","5","0","0.58333","228","174","54"
"1986","Colorado","6","6","0","0.50000","242","193","49"
"1987","Colorado","7","4","0","0.63636","268","180","88"
"1988","Colorado","8","4","0","0.66667","322","196","126"
"1989","Colorado","11","1","0","0.91667","458","171","287"
"1990","Colorado","11","1","1","0.88462","399","229","170"
"1991","Colorado","8","3","1","0.70833","329","180","149"
"1992","Colorado","9","2","1","0.79167","340","224","116"
"1993","Colorado","8","3","1","0.70833","368","250","118"
"1994","Colorado","11","1","0","0.91667","439","235","204"
"1995","Colorado","10","2","0","0.83333","444","240","204"
"1996","Colorado","10","2","0","0.83333","352","220","132"
"1997","Colorado","5","6","0","0.45455","300","295","5"
"1998","Colorado","8","4","0","0.66667","302","253","49"
"1999","Washington","7","5","0","0.58333","331","302","29"
"2000","Washington","11","1","0","0.91667","387","270","117"
"2001","Washington","8","4","0","0.66667","353","370","-17"
"2002","Washington","7","6","0","0.53846","398","342","56"
"2008","UCLA","4","8","0","0.33333","212","348","-136"
"2009","UCLA","7","6","0","0.53846","286","276","10"
"2010","UCLA","4","8","0","0.33333","242","364","-122"
"2011","UCLA","6","7","0","0.46154","309","419","-110"
"1992","Northwestern (IL)","3","8","0","0.27273","170","373","-203"
"1993","Northwestern (IL)","2","9","0","0.18182","185","335","-150"
"1994","Northwestern (IL)","4","6","1","0.40909","210","351","-141"
"1995","Northwestern (IL)","10","2","0","0.83333","311","181","130"
"1996","Northwestern (IL)","9","3","0","0.75000","336","278","58"
"1997","Northwestern (IL)","5","7","0","0.41667","243","288","-45"
"1998","Northwestern (IL)","3","9","0","0.25000","214","337","-123"
"1999","Colorado","7","5","0","0.58333","405","311","94"
"2000","Colorado","3","8","0","0.27273","252","284","-32"
"2001","Colorado","10","3","0","0.76923","412","318","94"
"2002","Colorado","9","5","0","0.64286","398","325","73"
"2003","Colorado","5","7","0","0.41667","319","398","-79"
"2004","Colorado","8","5","0","0.61538","304","332","-28"
"2005","Colorado","7","5","0","0.58333","295","288","7"
"2003","Arizona","1","6","0","0.14286","99","243","-144"
"2005","Colorado","0","1","0","0.00000","10","19","-9"
"1993","Willamette (OR)","5","4","0","0.55556","293","281","12"
"1994","Willamette (OR)","8","2","0","0.80000","245","222","23"
"1995","Willamette (OR)","6","2","1","0.72222","314","171","143"
"1996","Willamette (OR)","9","2","0","0.81818","374","246","128"
"1997","Willamette (OR)","13","1","0","0.92857","470","167","303"
"2001","Boise St. (ID)","8","4","0","0.66667","411","280","131"
"2002","Boise St. (ID)","12","1","0","0.92308","593","240","353"
"2003","Boise St. (ID)","13","1","0","0.92857","602","239","363"
"2004","Boise St. (ID)","11","1","0","0.91667","587","308","279"
"2005","Boise St. (ID)","9","4","0","0.69231","469","317","152"
"2006","Colorado","2","10","0","0.16667","196","267","-71"
"2007","Colorado","6","7","0","0.46154","355","383","-28"
"2008","Colorado","5","7","0","0.41667","242","351","-109"
"2009","Colorado","3","9","0","0.25000","267","346","-79"
"2010","Colorado","3","6","0","0.33333","195","274","-79"
"2010","Colorado","2","1","0","0.66667","95","95","0"
"2011","Colorado","3","10","0","0.23077","257","475","-218"
"2012","Colorado","1","11","0","0.08333","214","552","-338"
"2010","San Jose St. (CA)","1","12","0","0.07692","209","451","-242"
"2011","San Jose St. (CA)","5","7","0","0.41667","294","364","-70"
"2012","San Jose St. (CA)","10","2","0","0.83333","423","257","166"
"2013","Colorado","4","8","0","0.33333","305","459","-154"
"1869","Rutgers (NJ)","2","2","0","0.50000","18","18","0"
"1870","Rutgers (NJ)","2","2","0","0.50000","17","17","0"
"1872","Columbia (NY)","5","4","0","0.55556","22","16","6"
"1873","Rutgers (NJ)","7","4","1","0.62500","31","26","5"
"1874","Harvard (MA)","9","7","0","0.56250","54","41","13"
"1875","Harvard (MA)","12","6","2","0.65000","52","29","23"
"1876","Harvard (MA)","13","8","1","0.61364","45","29","16"
"1877","Harvard (MA)","9","7","3","0.55263","31","21","10"
"1878","Pennsylvania","14","9","5","0.58929","42","24","18"
"1879","Harvard (MA)","13","9","12","0.55882","46","27","19"
"1880","Harvard (MA)","18","11","4","0.60606","75","53","22"
"1881","Rutgers (NJ)","22","18","8","0.54167","70","47","23"
"1882","Rutgers (NJ)","41","28","2","0.59155","176","111","65"
"1883","Rutgers (NJ)","38","32","1","0.54225","1288","965","323"
"1884","Pennsylvania","47","29","5","0.61111","1728","1184","544"
"1885","Michigan","34","17","4","0.65455","1437","612","825"
"1886","Lehigh (PA)","48","21","4","0.68493","1850","637","1213"
"1887","California","67","35","3","0.65238","2660","935","1725"
"1888","Princeton (NJ)","70","56","6","0.55303","2468","1899","569"
"1889","Brown (RI)","82","51","11","0.60764","2879","1796","1083"
"1890","Brown (RI)","77","76","9","0.50309","3002","2455","547"
"1891","Southern California","94","76","13","0.54918","2813","2189","624"
"1892","Minnesota","93","80","9","0.53571","2972","2394","578"
"1893","Duke (NC)","79","94","9","0.45879","2176","2912","-736"
"1894","Colorado St.","50","62","4","0.44828","1161","1518","-357"
"1895","Boston (MA)","31","44","11","0.42442","692","1031","-339"
"1896","Rhode Island","54","62","12","0.46875","1126","1201","-75"
"1897","Boston (MA)","32","40","6","0.44872","792","785","7"
"1898","Miami (OH)","47","23","4","0.66216","921","644","277"
"1899","New Hampshire","33","32","6","0.50704","571","522","49"
"1900","New Hampshire","22","35","11","0.40441","442","686","-244"
"1901","Marshall (WV)","18","34","3","0.35455","302","917","-615"
"1902","Saint John's (MN)","9","22","4","0.31429","148","460","-312"
"1903","Wichita St. (KS)","14","25","2","0.36585","376","546","-170"
"1904","Oklahoma St.","11","14","1","0.44231","194","394","-200"
"1905","Miami (OH)","7","25","5","0.25676","245","494","-249"
"1906","Rensselaer Tech (NY)","3","7","4","0.35714","92","107","-15"
"1907","Marshall (WV)","5","10","2","0.35294","71","238","-167"
"1908","Fort Hays St. (KS)","5","6","1","0.45833","56","91","-35"
"1909","Fort Hays St. (KS)","1","3","1","0.30000","12","68","-56"
"1910","Texas St.","0","1","0","0.00000","0","19","-19"
"1912","Fort Hays St. (KS)","1","2","0","0.33333","20","132","-112"
"1913","Eureka (IL)","1","6","0","0.14286","39","203","-164"
"1914","Eureka (IL)","3","4","0","0.42857","57","201","-144"
"1915","Texas St.","1","1","1","0.50000","13","20","-7"
"1916","Texas St.","0","2","1","0.16667","0","106","-106"
"1917","Boston (MA)","4","4","0","0.50000","73","136","-63"
"1918","Monmouth (IL)","1","7","0","0.12500","26","137","-111"
"1930","Troy (AL)","1","2","0","0.33333","7","73","-66"
"2013","Grambling St. (LA)","0","1","0","0.00000","0","0","0"
"1899","Colorado St.","1","2","1","0.37500","22","117","-95"
"1900","Colorado St.","1","4","0","0.20000","16","110","-94"
"1901","Colorado St.","1","0","0","1.00000","1","0","1"
"1901","Colorado St.","1","2","0","0.33333","56","32","24"
"1902","Colorado St.","1","3","2","0.33333","47","62","-15"
"1903","Colorado St.","5","1","0","0.83333","67","24","43"
"1904","Colorado St.","0","4","1","0.10000","6","125","-119"
"1905","Colorado St.","3","4","0","0.42857","67","95","-28"
"1908","Montana St.","2","1","2","0.60000","40","25","15"
"1909","Montana St.","0","6","1","0.07143","11","85","-74"
"1910","Montana St.","1","3","2","0.33333","2","43","-41"
"1906","Colorado St.","1","2","1","0.37500","4","21","-17"
"1907","Colorado St.","0","4","0","0.00000","17","77","-60"
"1908","Colorado St.","1","3","0","0.25000","30","58","-28"
"1909","Colorado St.","1","2","0","0.33333","38","91","-53"
"1928","Rice (TX)","2","7","0","0.22222","83","174","-91"
"1910","Colorado St.","0","5","0","0.00000","6","110","-104"
"1911","Colorado St.","1","6","0","0.14286","75","216","-141"
"1912","Colorado St.","3","2","0","0.60000","68","40","28"
"1913","Colorado St.","3","2","0","0.60000","115","43","72"
"1914","Colorado St.","3","5","0","0.37500","127","109","18"
"1915","Colorado St.","7","0","0","1.00000","243","31","212"
"1916","Colorado St.","6","0","1","0.92857","172","45","127"
"1917","Colorado St.","1","7","1","0.16667","71","155","-84"
"1918","Colorado St.","1","2","0","0.33333","20","30","-10"
"1919","Colorado St.","7","1","0","0.87500","218","57","161"
"1920","Colorado St.","6","1","1","0.81250","152","14","138"
"1921","Colorado St.","2","3","1","0.41667","76","108","-32"
"1922","Colorado St.","5","2","1","0.68750","179","38","141"
"1923","Colorado St.","5","2","1","0.68750","121","35","86"
"1924","Colorado St.","4","2","0","0.66667","81","63","18"
"1925","Colorado St.","9","1","0","0.90000","228","79","149"
"1926","Colorado St.","6","2","1","0.72222","149","44","105"
"1927","Colorado St.","7","1","0","0.87500","176","26","150"
"1928","Colorado St.","6","2","0","0.75000","151","70","81"
"1929","Colorado St.","5","4","0","0.55556","118","87","31"
"1930","Colorado St.","3","5","1","0.38889","67","104","-37"
"1931","Colorado St.","5","4","0","0.55556","137","138","-1"
"1932","Colorado St.","4","3","1","0.56250","100","45","55"
"1933","Colorado St.","5","1","1","0.78571","78","26","52"
"1934","Colorado St.","6","2","1","0.72222","173","67","106"
"1935","Colorado St.","3","4","1","0.43750","58","75","-17"
"1936","Colorado St.","4","4","1","0.50000","67","74","-7"
"1937","Colorado St.","1","7","0","0.12500","6","182","-176"
"1938","Colorado St.","1","5","2","0.25000","37","103","-66"
"1939","Colorado St.","2","7","0","0.22222","89","128","-39"
"1940","Colorado St.","3","4","2","0.44444","85","131","-46"
"1941","Colorado St.","4","2","1","0.64286","109","77","32"
"1946","Colorado St.","0","4","0","0.00000","18","76","-58"
"1942","Colorado St.","4","3","0","0.57143","97","99","-2"
"1945","Colorado St.","2","5","1","0.31250","89","179","-90"
"1946","Colorado St.","2","3","0","0.40000","32","107","-75"
"1947","Colorado St.","5","4","1","0.55000","159","182","-23"
"1948","Colorado St.","8","3","0","0.72727","244","138","106"
"1949","Colorado St.","9","1","0","0.90000","206","86","120"
"1950","Colorado St.","6","3","0","0.66667","215","141","74"
"1951","Colorado St.","5","4","1","0.55000","242","158","84"
"1952","Colorado St.","6","4","0","0.60000","177","137","40"
"1953","Colorado St.","4","5","0","0.44444","157","149","8"
"1954","Colorado St.","3","7","0","0.30000","93","248","-155"
"1955","Colorado St.","8","2","0","0.80000","175","108","67"
"1956","Colorado St.","2","7","1","0.25000","156","314","-158"
"1957","Colorado St.","3","7","0","0.30000","109","224","-115"
"1958","Colorado St.","6","4","0","0.60000","178","110","68"
"1959","Colorado St.","6","4","0","0.60000","123","147","-24"
"1960","Colorado St.","2","8","0","0.20000","92","240","-148"
"1961","Colorado St.","0","10","0","0.00000","74","249","-175"
"1962","Colorado St.","0","10","0","0.00000","66","269","-203"
"1963","Colorado St.","3","7","0","0.30000","118","299","-181"
"1964","Colorado St.","5","6","0","0.45455","111","199","-88"
"1965","Colorado St.","4","6","0","0.40000","264","264","0"
"1966","Colorado St.","7","3","0","0.70000","275","178","97"
"1967","Colorado St.","4","5","1","0.45000","229","149","80"
"1968","Colorado St.","2","8","0","0.20000","133","262","-129"
"1969","Colorado St.","4","6","0","0.40000","218","288","-70"
"1970","Colorado St.","4","7","0","0.36364","206","246","-40"
"1971","Colorado St.","3","8","0","0.27273","177","276","-99"
"1972","Colorado St.","1","10","0","0.09091","128","413","-285"
"1965","Weber St. (UT)","8","1","0","0.88889","270","102","168"
"1966","Weber St. (UT)","6","3","0","0.66667","321","166","155"
"1967","Weber St. (UT)","6","4","0","0.60000","193","192","1"
"1968","Weber St. (UT)","7","2","0","0.77778","243","166","77"
"1969","Weber St. (UT)","6","4","0","0.60000","277","160","117"
"1970","Weber St. (UT)","5","5","1","0.50000","337","227","110"
"1971","Weber St. (UT)","7","2","1","0.75000","273","144","129"
"1972","Weber St. (UT)","5","5","0","0.50000","164","174","-10"
"1973","Colorado St.","5","6","0","0.45455","250","333","-83"
"1974","Colorado St.","4","6","1","0.40909","295","266","29"
"1975","Colorado St.","6","5","0","0.54545","172","234","-62"
"1976","Colorado St.","6","5","0","0.54545","205","186","19"
"1977","Colorado St.","9","2","1","0.79167","301","206","95"
"1978","Colorado St.","5","6","0","0.45455","238","247","-9"
"1979","Colorado St.","4","7","1","0.37500","177","241","-64"
"1980","Colorado St.","6","4","1","0.59091","232","330","-98"
"1981","Colorado St.","0","6","0","0.00000","71","210","-139"
"1972","Pacific (CA)","8","3","0","0.72727","232","176","56"
"1973","Pacific (CA)","7","2","1","0.75000","279","110","169"
"1974","Pacific (CA)","6","5","0","0.54545","238","248","-10"
"1975","Pacific (CA)","5","6","1","0.45833","231","276","-45"
"1976","Pacific (CA)","2","9","0","0.18182","190","301","-111"
"1977","Pacific (CA)","6","5","0","0.54545","230","161","69"
"1978","Pacific (CA)","4","8","0","0.33333","222","306","-84"
"1981","Colorado St.","0","6","0","0.00000","93","292","-199"
"1982","Colorado St.","4","7","0","0.36364","220","267","-47"
"1983","Colorado St.","5","7","0","0.41667","222","350","-128"
"1984","Colorado St.","3","8","0","0.27273","230","360","-130"
"1985","Colorado St.","5","7","0","0.41667","251","330","-79"
"1986","Colorado St.","6","5","0","0.54545","266","237","29"
"1987","Colorado St.","1","11","0","0.08333","245","370","-125"
"1988","Colorado St.","1","10","0","0.09091","192","348","-156"
"1973","Iowa St.","4","7","0","0.36364","245","236","9"
"1974","Iowa St.","4","7","0","0.36364","186","198","-12"
"1975","Iowa St.","4","7","0","0.36364","161","263","-102"
"1976","Iowa St.","8","3","0","0.72727","369","216","153"
"1977","Iowa St.","8","4","0","0.66667","249","178","71"
"1978","Iowa St.","8","4","0","0.66667","219","188","31"
"1979","Ohio St.","11","1","0","0.91667","390","126","264"
"1980","Ohio St.","9","3","0","0.75000","387","181","206"
"1981","Ohio St.","9","3","0","0.75000","387","253","134"
"1982","Ohio St.","9","3","0","0.75000","348","208","140"
"1983","Ohio St.","9","3","0","0.75000","410","206","204"
"1984","Ohio St.","9","3","0","0.75000","391","200","191"
"1985","Ohio St.","9","3","0","0.75000","325","212","113"
"1986","Ohio St.","10","3","0","0.76923","347","179","168"
"1987","Ohio St.","6","4","1","0.59091","224","181","43"
"1988","Northern Iowa","5","6","0","0.45455","292","239","53"
"1989","Colorado St.","5","5","1","0.50000","350","303","47"
"1990","Colorado St.","9","4","0","0.69231","372","302","70"
"1991","Colorado St.","3","8","0","0.27273","265","375","-110"
"1992","Colorado St.","5","7","0","0.41667","281","334","-53"
"1978","Montana St.","8","2","0","0.80000","287","209","78"
"1979","Montana St.","6","4","0","0.60000","202","170","32"
"1980","Montana St.","4","6","0","0.40000","153","162","-9"
"1981","Montana St.","3","7","0","0.30000","192","273","-81"
"1993","Colorado St.","5","6","0","0.45455","230","268","-38"
"1994","Colorado St.","10","2","0","0.83333","400","269","131"
"1995","Colorado St.","8","4","0","0.66667","339","254","85"
"1996","Colorado St.","7","5","0","0.58333","380","336","44"
"1997","Colorado St.","11","2","0","0.84615","477","203","274"
"1998","Colorado St.","8","4","0","0.66667","345","263","82"
"1999","Colorado St.","8","4","0","0.66667","345","269","76"
"2000","Colorado St.","10","2","0","0.83333","363","225","138"
"2001","Colorado St.","7","5","0","0.58333","298","274","24"
"2002","Colorado St.","10","4","0","0.71429","418","332","86"
"2003","Colorado St.","7","6","0","0.53846","381","318","63"
"2004","Colorado St.","4","7","0","0.36364","261","325","-64"
"2005","Colorado St.","6","6","0","0.50000","321","369","-48"
"2006","Colorado St.","4","8","0","0.33333","202","263","-61"
"2007","Colorado St.","3","9","0","0.25000","304","369","-65"
"2008","Colorado St.","7","6","0","0.53846","327","393","-66"
"2009","Colorado St.","3","9","0","0.25000","260","358","-98"
"2010","Colorado St.","3","9","0","0.25000","198","416","-218"
"2011","Colorado St.","3","9","0","0.25000","257","375","-118"
"2012","Colorado St.","4","8","0","0.33333","254","363","-109"
"2013","Colorado St.","8","6","0","0.57143","507","417","90"
"1869","Rutgers (NJ)","2","2","0","0.50000","18","18","0"
"1870","Rutgers (NJ)","2","2","0","0.50000","17","17","0"
"1872","Columbia (NY)","5","4","0","0.55556","22","16","6"
"1873","Rutgers (NJ)","7","4","1","0.62500","31","26","5"
"1874","Harvard (MA)","9","7","0","0.56250","54","41","13"
"1875","Harvard (MA)","12","6","2","0.65000","52","29","23"
"1876","Harvard (MA)","13","8","1","0.61364","45","29","16"
"1877","Harvard (MA)","9","7","3","0.55263","31","21","10"
"1878","Pennsylvania","14","9","5","0.58929","42","24","18"
"1879","Harvard (MA)","13","9","12","0.55882","46","27","19"
"1880","Harvard (MA)","18","11","4","0.60606","75","53","22"
"1881","Rutgers (NJ)","22","18","8","0.54167","70","47","23"
"1882","Rutgers (NJ)","41","28","2","0.59155","176","111","65"
"1883","Rutgers (NJ)","38","32","1","0.54225","1288","965","323"
"1884","Pennsylvania","47","29","5","0.61111","1728","1184","544"
"1885","Michigan","34","17","4","0.65455","1437","612","825"
"1886","Lehigh (PA)","48","21","4","0.68493","1850","637","1213"
"1887","California","67","35","3","0.65238","2660","935","1725"
"1888","Princeton (NJ)","70","56","6","0.55303","2468","1899","569"
"1889","Brown (RI)","82","51","11","0.60764","2879","1796","1083"
"1890","Brown (RI)","77","76","9","0.50309","3002","2455","547"
"1891","Southern California","94","76","13","0.54918","2813","2189","624"
"1892","Minnesota","93","80","9","0.53571","2972","2394","578"
"1893","Duke (NC)","79","94","9","0.45879","2176","2912","-736"
"1894","Colorado St.","50","62","4","0.44828","1161","1518","-357"
"1895","Boston (MA)","31","44","11","0.42442","692","1031","-339"
"1896","Rhode Island","54","62","12","0.46875","1126","1201","-75"
"1897","Boston (MA)","32","40","6","0.44872","792","785","7"
"1898","Miami (OH)","47","23","4","0.66216","921","644","277"
"1899","New Hampshire","33","32","6","0.50704","571","522","49"
"1900","New Hampshire","22","35","11","0.40441","442","686","-244"
"1901","Marshall (WV)","18","34","3","0.35455","302","917","-615"
"1902","Saint John's (MN)","9","22","4","0.31429","148","460","-312"
"1903","Wichita St. (KS)","14","25","2","0.36585","376","546","-170"
"1904","Oklahoma St.","11","14","1","0.44231","194","394","-200"
"1905","Miami (OH)","7","25","5","0.25676","245","494","-249"
"1906","Rensselaer Tech (NY)","3","7","4","0.35714","92","107","-15"
"1907","Marshall (WV)","5","10","2","0.35294","71","238","-167"
"1908","Fort Hays St. (KS)","5","6","1","0.45833","56","91","-35"
"1909","Fort Hays St. (KS)","1","3","1","0.30000","12","68","-56"
"1910","Texas St.","0","1","0","0.00000","0","19","-19"
"1912","Fort Hays St. (KS)","1","2","0","0.33333","20","132","-112"
"1913","Eureka (IL)","1","6","0","0.14286","39","203","-164"
"1914","Eureka (IL)","3","4","0","0.42857","57","201","-144"
"1915","Texas St.","1","1","1","0.50000","13","20","-7"
"1916","Texas St.","0","2","1","0.16667","0","106","-106"
"1917","Boston (MA)","4","4","0","0.50000","73","136","-63"
"1918","Monmouth (IL)","1","7","0","0.12500","26","137","-111"
"1930","Troy (AL)","1","2","0","0.33333","7","73","-66"
"2013","Grambling St. (LA)","0","1","0","0.00000","0","0","0"
"1898","Connecticut","0","3","0","0.00000","0","89","-89"
"1899","Connecticut","6","2","0","0.75000","107","62","45"
"1900","Connecticut","4","3","1","0.56250","103","45","58"
"1901","Connecticut","8","2","0","0.80000","143","67","76"
"1894","DePauw (IN)","4","4","0","0.50000","139","144","-5"
"1902","Connecticut","4","3","0","0.57143","84","66","18"
"1903","Connecticut","4","5","0","0.44444","92","90","2"
"1904","Connecticut","6","3","1","0.65000","99","85","14"
"1905","Connecticut","2","2","0","0.50000","27","59","-32"
"1906","Connecticut","2","4","0","0.33333","50","75","-25"
"1907","Connecticut","2","5","0","0.28571","71","158","-87"
"1908","Connecticut","4","3","1","0.56250","150","49","101"
"1909","Connecticut","3","5","0","0.37500","104","190","-86"
"1910","Connecticut","1","5","1","0.21429","12","117","-105"
"1911","Connecticut","1","7","0","0.12500","16","199","-183"
"1912","Connecticut","5","5","0","0.50000","74","124","-50"
"1913","Connecticut","6","3","0","0.66667","200","122","78"
"1914","Connecticut","3","0","0","1.00000","48","9","39"
"1915","Connecticut","1","7","0","0.12500","40","107","-67"
"1916","Connecticut","1","7","0","0.12500","36","110","-74"
"1919","Connecticut","2","6","0","0.25000","28","174","-146"
"1920","Connecticut","1","6","1","0.18750","69","126","-57"
"1921","Connecticut","3","2","3","0.56250","115","75","40"
"1922","Connecticut","2","6","1","0.27778","77","108","-31"
"1923","William & Mary (VA)","7","3","0","0.70000","224","115","109"
"1924","William & Mary (VA)","6","2","1","0.72222","170","61","109"
"1925","William & Mary (VA)","7","4","0","0.63636","235","86","149"
"1926","William & Mary (VA)","7","3","0","0.70000","169","87","82"
"1927","William & Mary (VA)","4","5","1","0.45000","111","118","-7"
"1931","Rutgers (NJ)","4","3","1","0.56250","111","100","11"
"1932","Rutgers (NJ)","6","3","1","0.65000","159","58","101"
"1933","Rutgers (NJ)","6","3","1","0.65000","146","94","52"
"1934","Rutgers (NJ)","5","3","1","0.61111","184","68","116"
"1935","Rutgers (NJ)","4","5","0","0.44444","115","170","-55"
"1936","Rutgers (NJ)","1","6","1","0.18750","20","133","-113"
"1937","Rutgers (NJ)","5","4","0","0.55556","128","39","89"
"1923","Connecticut","3","4","1","0.43750","45","46","-1"
"1924","Connecticut","6","0","2","0.87500","90","13","77"
"1925","Connecticut","3","5","1","0.38889","39","76","-37"
"1926","Connecticut","7","1","0","0.87500","190","33","157"
"1927","Connecticut","5","4","0","0.55556","153","100","53"
"1928","Connecticut","4","1","3","0.68750","96","51","45"
"1929","Connecticut","4","4","0","0.50000","92","47","45"
"1930","Connecticut","1","6","1","0.18750","19","130","-111"
"1931","Connecticut","2","3","3","0.43750","27","84","-57"
"1932","Connecticut","0","6","2","0.12500","27","187","-160"
"1933","Connecticut","1","6","1","0.18750","39","176","-137"
"1934","Connecticut","1","7","0","0.12500","19","108","-89"
"1935","Connecticut","2","4","1","0.35714","39","70","-31"
"1936","Connecticut","7","2","0","0.77778","203","48","155"
"1937","Connecticut","6","2","1","0.72222","187","64","123"
"1938","Connecticut","4","3","0","0.57143","90","56","34"
"1939","Connecticut","5","3","0","0.62500","99","97","2"
"1940","Connecticut","4","4","0","0.50000","67","89","-22"
"1941","Connecticut","2","6","0","0.25000","58","82","-24"
"1942","Connecticut","6","2","0","0.75000","141","81","60"
"1944","Connecticut","7","1","0","0.87500","152","13","139"
"1945","Connecticut","7","1","0","0.87500","265","43","222"
"1946","Connecticut","4","3","1","0.56250","120","69","51"
"1947","Connecticut","4","4","0","0.50000","102","85","17"
"1948","Connecticut","3","5","0","0.37500","172","147","25"
"1949","Connecticut","4","4","1","0.50000","220","141","79"
"1948","Harvard (MA)","4","4","0","0.50000","130","184","-54"
"1949","Harvard (MA)","1","8","0","0.11111","103","276","-173"
"1950","Connecticut","3","5","0","0.37500","82","134","-52"
"1951","Connecticut","4","4","0","0.50000","106","102","4"
"1952","Connecticut","5","3","0","0.62500","178","135","43"
"1953","Connecticut","3","4","1","0.43750","118","147","-29"
"1954","Connecticut","1","8","0","0.11111","92","276","-184"
"1955","Connecticut","4","4","0","0.50000","68","105","-37"
"1956","Connecticut","6","2","1","0.72222","240","100","140"
"1957","Connecticut","5","4","1","0.55000","143","121","22"
"1958","Connecticut","7","3","0","0.70000","281","134","147"
"1959","Connecticut","6","3","0","0.66667","197","111","86"
"1960","Connecticut","5","4","0","0.55556","179","123","56"
"1961","Connecticut","2","7","0","0.22222","108","167","-59"
"1962","Connecticut","3","6","0","0.33333","97","139","-42"
"1963","Connecticut","2","6","0","0.25000","91","113","-22"
"1964","Connecticut","4","4","1","0.50000","99","123","-24"
"1965","Connecticut","3","6","0","0.33333","100","116","-16"
"1969","Navy (MD)","1","9","0","0.10000","98","307","-209"
"1970","Navy (MD)","2","9","0","0.18182","131","327","-196"
"1971","Navy (MD)","3","8","0","0.27273","146","331","-185"
"1972","Navy (MD)","4","7","0","0.36364","181","257","-76"
"1966","Connecticut","2","6","1","0.27778","92","156","-64"
"1967","Connecticut","5","4","0","0.55556","137","151","-14"
"1968","Connecticut","4","6","0","0.40000","216","191","25"
"1969","Connecticut","5","4","0","0.55556","193","187","6"
"1970","Connecticut","4","4","2","0.50000","240","193","47"
"1971","Connecticut","5","3","1","0.61111","107","145","-38"
"1972","Connecticut","4","5","0","0.44444","143","187","-44"
"1973","Princeton (NJ)","1","8","0","0.11111","127","233","-106"
"1974","Princeton (NJ)","4","4","1","0.50000","188","160","28"
"1975","Princeton (NJ)","4","5","0","0.44444","163","157","6"
"1976","Princeton (NJ)","2","7","0","0.22222","63","155","-92"
"1977","Princeton (NJ)","3","6","0","0.33333","137","144","-7"
"1969","Boston (MA)","9","2","0","0.81818","233","131","102"
"1970","Boston (MA)","5","4","0","0.55556","199","141","58"
"1971","Boston (MA)","3","7","0","0.30000","200","284","-84"
"1972","Boston (MA)","2","8","0","0.20000","117","281","-164"
"1973","Connecticut","8","2","1","0.77273","208","141","67"
"1974","Connecticut","4","6","0","0.40000","153","168","-15"
"1975","Connecticut","4","7","0","0.36364","178","244","-66"
"1976","Connecticut","2","9","0","0.18182","182","246","-64"
"1977","Connecticut","1","10","0","0.09091","84","290","-206"
"1978","Connecticut","4","7","0","0.36364","181","202","-21"
"1979","Connecticut","3","6","2","0.36364","144","173","-29"
"1980","Connecticut","7","3","0","0.70000","259","191","68"
"1981","Connecticut","4","7","0","0.36364","291","255","36"
"1982","Connecticut","5","6","0","0.45455","164","193","-29"
"1983","Connecticut","5","6","0","0.45455","187","209","-22"
"1984","Connecticut","3","8","0","0.27273","163","186","-23"
"1985","Connecticut","4","5","0","0.44444","175","181","-6"
"1986","Connecticut","8","3","0","0.72727","249","229","20"
"1987","Connecticut","7","4","0","0.63636","291","235","56"
"1988","Connecticut","7","4","0","0.63636","298","180","118"
"1989","Connecticut","8","3","0","0.72727","297","252","45"
"1990","Connecticut","6","5","0","0.54545","308","281","27"
"1991","Connecticut","3","8","0","0.27273","241","340","-99"
"1992","Connecticut","5","6","0","0.45455","254","239","15"
"1993","Connecticut","6","5","0","0.54545","261","217","44"
"1994","Connecticut","4","7","0","0.36364","240","264","-24"
"1995","Connecticut","8","3","0","0.72727","279","200","79"
"1996","Connecticut","4","6","0","0.40000","244","191","53"
"1997","Connecticut","7","4","0","0.63636","398","246","152"
"1998","Connecticut","10","3","0","0.76923","461","413","48"
"2005","East Carolina (NC)","5","6","0","0.45455","267","317","-50"
"2006","East Carolina (NC)","7","6","0","0.53846","280","270","10"
"2007","East Carolina (NC)","8","5","0","0.61538","403","395","8"
"2008","East Carolina (NC)","9","5","0","0.64286","328","295","33"
"2009","East Carolina (NC)","9","5","0","0.64286","378","307","71"
"2010","South Florida","8","5","0","0.61538","313","260","53"
"2011","South Florida","5","7","0","0.41667","351","272","79"
"2012","South Florida","3","9","0","0.25000","247","329","-82"
"2013","Louisiana Tech","4","8","0","0.33333","230","315","-85"
"1999","Connecticut","4","7","0","0.36364","255","383","-128"
"2000","Connecticut","3","8","0","0.27273","220","368","-148"
"2001","Connecticut","2","9","0","0.18182","192","370","-178"
"2002","Connecticut","6","6","0","0.50000","373","270","103"
"2003","Connecticut","9","3","0","0.75000","408","300","108"
"2004","Connecticut","8","4","0","0.66667","363","260","103"
"2005","Connecticut","5","6","0","0.45455","272","211","61"
"2006","Connecticut","4","8","0","0.33333","257","324","-67"
"2007","Connecticut","9","4","0","0.69231","344","247","97"
"2008","Connecticut","8","5","0","0.61538","324","257","67"
"2009","Connecticut","8","5","0","0.61538","405","307","98"
"2010","Connecticut","8","5","0","0.61538","343","286","57"
"2011","Maryland","2","10","0","0.16667","277","411","-134"
"2012","Maryland","4","8","0","0.33333","241","326","-85"
"2013","Maryland","7","6","0","0.53846","340","329","11"
"1982","Western Connecticut St.","2","7","0","0.22222","90","188","-98"
"1983","Western Connecticut St.","7","3","0","0.70000","192","129","63"
"1984","Western Connecticut St.","9","1","0","0.90000","282","96","186"
"1985","Western Connecticut St.","10","2","0","0.83333","374","170","204"
"1986","Western Connecticut St.","6","4","0","0.60000","221","166","55"
"1991","Syracuse (NY)","10","2","0","0.83333","321","200","121"
"1992","Syracuse (NY)","10","2","0","0.83333","340","205","135"
"1993","Syracuse (NY)","6","4","1","0.59091","281","288","-7"
"1994","Syracuse (NY)","7","4","0","0.63636","256","259","-3"
"1995","Syracuse (NY)","9","3","0","0.75000","375","213","162"
"1996","Syracuse (NY)","9","3","0","0.75000","437","208","229"
"1997","Syracuse (NY)","9","4","0","0.69231","441","226","215"
"1998","Syracuse (NY)","8","4","0","0.66667","478","300","178"
"1999","Syracuse (NY)","7","5","0","0.58333","300","256","44"
"2000","Syracuse (NY)","6","5","0","0.54545","294","212","82"
"2001","Syracuse (NY)","10","3","0","0.76923","334","247","87"
"2002","Syracuse (NY)","4","8","0","0.33333","347","406","-59"
"2003","Syracuse (NY)","6","6","0","0.50000","320","301","19"
"2004","Syracuse (NY)","6","6","0","0.50000","287","344","-57"
"2011","Connecticut","5","7","0","0.41667","291","292","-1"
"2012","Connecticut","5","7","0","0.41667","213","238","-25"
"2013","Connecticut","0","4","0","0.00000","72","130","-58"
"2013","Connecticut","3","5","0","0.37500","175","233","-58"
"1888","Duke (NC)","2","1","0","0.66667","41","49","-8"
"1889","Duke (NC)","1","0","1","0.75000","8","4","4"
"1869","Rutgers (NJ)","2","2","0","0.50000","18","18","0"
"1870","Rutgers (NJ)","2","2","0","0.50000","17","17","0"
"1872","Columbia (NY)","5","4","0","0.55556","22","16","6"
"1873","Rutgers (NJ)","7","4","1","0.62500","31","26","5"
"1874","Harvard (MA)","9","7","0","0.56250","54","41","13"
"1875","Harvard (MA)","12","6","2","0.65000","52","29","23"
"1876","Harvard (MA)","13","8","1","0.61364","45","29","16"
"1877","Harvard (MA)","9","7","3","0.55263","31","21","10"
"1878","Pennsylvania","14","9","5","0.58929","42","24","18"
"1879","Harvard (MA)","13","9","12","0.55882","46","27","19"
"1880","Harvard (MA)","18","11","4","0.60606","75","53","22"
"1881","Rutgers (NJ)","22","18","8","0.54167","70","47","23"
"1882","Rutgers (NJ)","41","28","2","0.59155","176","111","65"
"1883","Rutgers (NJ)","38","32","1","0.54225","1288","965","323"
"1884","Pennsylvania","47","29","5","0.61111","1728","1184","544"
"1885","Michigan","34","17","4","0.65455","1437","612","825"
"1886","Lehigh (PA)","48","21","4","0.68493","1850","637","1213"
"1887","California","67","35","3","0.65238","2660","935","1725"
"1888","Princeton (NJ)","70","56","6","0.55303","2468","1899","569"
"1889","Brown (RI)","82","51","11","0.60764","2879","1796","1083"
"1890","Brown (RI)","77","76","9","0.50309","3002","2455","547"
"1891","Southern California","94","76","13","0.54918","2813","2189","624"
"1892","Minnesota","93","80","9","0.53571","2972","2394","578"
"1893","Duke (NC)","79","94","9","0.45879","2176","2912","-736"
"1894","Colorado St.","50","62","4","0.44828","1161","1518","-357"
"1895","Boston (MA)","31","44","11","0.42442","692","1031","-339"
"1896","Rhode Island","54","62","12","0.46875","1126","1201","-75"
"1897","Boston (MA)","32","40","6","0.44872","792","785","7"
"1898","Miami (OH)","47","23","4","0.66216","921","644","277"
"1899","New Hampshire","33","32","6","0.50704","571","522","49"
"1900","New Hampshire","22","35","11","0.40441","442","686","-244"
"1901","Marshall (WV)","18","34","3","0.35455","302","917","-615"
"1902","Saint John's (MN)","9","22","4","0.31429","148","460","-312"
"1903","Wichita St. (KS)","14","25","2","0.36585","376","546","-170"
"1904","Oklahoma St.","11","14","1","0.44231","194","394","-200"
"1905","Miami (OH)","7","25","5","0.25676","245","494","-249"
"1906","Rensselaer Tech (NY)","3","7","4","0.35714","92","107","-15"
"1907","Marshall (WV)","5","10","2","0.35294","71","238","-167"
"1908","Fort Hays St. (KS)","5","6","1","0.45833","56","91","-35"
"1909","Fort Hays St. (KS)","1","3","1","0.30000","12","68","-56"
"1910","Texas St.","0","1","0","0.00000","0","19","-19"
"1912","Fort Hays St. (KS)","1","2","0","0.33333","20","132","-112"
"1913","Eureka (IL)","1","6","0","0.14286","39","203","-164"
"1914","Eureka (IL)","3","4","0","0.42857","57","201","-144"
"1915","Texas St.","1","1","1","0.50000","13","20","-7"
"1916","Texas St.","0","2","1","0.16667","0","106","-106"
"1917","Boston (MA)","4","4","0","0.50000","73","136","-63"
"1918","Monmouth (IL)","1","7","0","0.12500","26","137","-111"
"1930","Troy (AL)","1","2","0","0.33333","7","73","-66"
"2013","Grambling St. (LA)","0","1","0","0.00000","0","0","0"
"1920","Duke (NC)","4","0","1","0.90000","53","20","33"
"1919","Maine","6","1","0","0.85714","213","26","187"
"1920","Maine","3","3","3","0.50000","122","142","-20"
"1921","Duke (NC)","6","1","2","0.77778","147","32","115"
"1922","Lehigh (PA)","3","5","1","0.38889","84","79","5"
"1923","Lehigh (PA)","6","2","1","0.72222","107","57","50"
"1924","Lehigh (PA)","4","1","3","0.68750","62","36","26"
"1926","Wake Forest (NC)","5","4","1","0.55000","186","46","140"
"1927","Wake Forest (NC)","2","6","2","0.30000","64","222","-158"
"1922","Duke (NC)","7","2","1","0.75000","156","57","99"
"1923","Duke (NC)","5","4","0","0.55556","211","104","107"
"1908","Syracuse (NY)","6","3","1","0.65000","171","39","132"
"1909","Yale (CT)","10","0","0","1.00000","209","0","209"
"1910","Ohio St.","6","1","3","0.75000","182","27","155"
"1913","Yale (CT)","5","2","3","0.65000","126","34","92"
"1916","Iowa","4","3","0","0.57143","121","156","-35"
"1917","Iowa","3","6","0","0.33333","91","160","-69"
"1918","Iowa","6","2","1","0.72222","123","36","87"
"1919","Iowa","5","2","0","0.71429","90","44","46"
"1920","Iowa","5","2","0","0.71429","142","54","88"
"1921","Iowa","7","0","0","1.00000","185","36","149"
"1922","Iowa","7","0","0","1.00000","208","33","175"
"1923","Iowa","5","3","0","0.62500","124","55","69"
"1924","Duke (NC)","4","5","0","0.44444","129","99","30"
"1925","Southern California","11","2","0","0.84615","456","55","401"
"1926","Southern California","8","2","0","0.80000","317","52","265"
"1927","Southern California","8","1","1","0.85000","287","64","223"
"1928","Southern California","9","0","1","0.95000","267","59","208"
"1929","Southern California","10","2","0","0.83333","492","69","423"
"1930","Southern California","8","2","0","0.80000","382","66","316"
"1931","Southern California","10","1","0","0.90909","363","52","311"
"1932","Southern California","10","0","0","1.00000","201","13","188"
"1933","Southern California","10","1","1","0.87500","257","30","227"
"1934","Southern California","4","6","1","0.40909","120","110","10"
"1935","Southern California","5","7","0","0.41667","155","124","31"
"1936","Southern California","4","2","3","0.61111","129","65","64"
"1937","Southern California","4","4","2","0.50000","136","98","38"
"1938","Southern California","9","2","0","0.81818","172","65","107"
"1939","Southern California","8","0","2","0.90000","181","33","148"
"1940","Southern California","3","4","2","0.44444","88","98","-10"
"1922","Indiana","1","4","2","0.28571","21","113","-92"
"1925","Duke (NC)","4","5","0","0.44444","58","142","-84"
"1926","Duke (NC)","3","6","0","0.33333","124","106","18"
"1927","Duke (NC)","4","5","0","0.44444","215","117","98"
"1928","Duke (NC)","5","5","0","0.50000","155","116","39"
"1929","Duke (NC)","4","6","0","0.40000","153","260","-107"
"1930","Duke (NC)","8","1","2","0.81818","147","48","99"
"1923","Alabama","7","2","1","0.75000","222","50","172"
"1924","Alabama","8","1","0","0.88889","290","24","266"
"1925","Alabama","10","0","0","1.00000","297","26","271"
"1926","Alabama","9","0","1","0.95000","249","27","222"
"1927","Alabama","5","4","1","0.55000","154","73","81"
"1928","Alabama","6","3","0","0.66667","187","75","112"
"1929","Alabama","6","3","0","0.66667","196","58","138"
"1930","Alabama","10","0","0","1.00000","271","13","258"
"1931","Duke (NC)","5","3","2","0.60000","74","46","28"
"1932","Duke (NC)","7","3","0","0.70000","153","40","113"
"1933","Duke (NC)","9","1","0","0.90000","181","42","139"
"1934","Duke (NC)","7","2","0","0.77778","185","40","145"
"1935","Duke (NC)","8","2","0","0.80000","214","45","169"
"1936","Duke (NC)","9","1","0","0.90000","208","28","180"
"1937","Duke (NC)","7","2","1","0.75000","228","56","172"
"1938","Duke (NC)","9","1","0","0.90000","117","7","110"
"1939","Duke (NC)","8","1","0","0.88889","183","42","141"
"1940","Duke (NC)","7","2","0","0.77778","203","52","151"
"1941","Duke (NC)","9","1","0","0.90000","327","61","266"
"1946","Duke (NC)","4","5","0","0.44444","134","86","48"
"1947","Duke (NC)","4","3","2","0.55556","79","90","-11"
"1948","Duke (NC)","4","3","2","0.55556","144","92","52"
"1949","Duke (NC)","6","3","0","0.66667","260","117","143"
"1950","Duke (NC)","7","3","0","0.70000","202","108","94"
"1942","Duke (NC)","5","4","1","0.55000","211","98","113"
"1943","Duke (NC)","8","1","0","0.88889","335","34","301"
"1944","Duke (NC)","6","4","0","0.60000","230","118","112"
"1945","Duke (NC)","6","2","0","0.75000","229","114","115"
"1940","Delaware","5","3","0","0.62500","87","54","33"
"1941","Delaware","7","0","1","0.93750","176","26","150"
"1942","Delaware","8","0","0","1.00000","196","28","168"
"1946","Delaware","10","0","0","1.00000","358","45","313"
"1947","Delaware","4","4","0","0.50000","161","113","48"
"1948","Delaware","5","3","0","0.62500","107","95","12"
"1949","Delaware","8","1","0","0.88889","202","67","135"
"1950","Delaware","2","5","1","0.31250","55","147","-92"
"1951","Duke (NC)","5","4","1","0.55000","201","157","44"
"1952","Duke (NC)","8","2","0","0.80000","227","72","155"
"1953","Duke (NC)","7","2","1","0.75000","217","81","136"
"1954","Duke (NC)","8","2","1","0.77273","270","161","109"
"1955","Duke (NC)","7","2","1","0.75000","196","95","101"
"1956","Duke (NC)","5","4","1","0.55000","184","100","84"
"1957","Duke (NC)","6","3","2","0.63636","182","135","47"
"1958","Duke (NC)","5","5","0","0.50000","128","131","-3"
"1959","Duke (NC)","4","6","0","0.40000","104","159","-55"
"1960","Duke (NC)","8","3","0","0.72727","173","114","59"
"1961","Duke (NC)","7","3","0","0.70000","183","106","77"
"1962","Duke (NC)","8","2","0","0.80000","199","105","94"
"1963","Duke (NC)","5","4","1","0.55000","230","198","32"
"1964","Duke (NC)","4","5","1","0.45000","148","135","13"
"1965","Duke (NC)","6","4","0","0.60000","216","157","59"
"1961","Cornell (NY)","3","6","0","0.33333","143","137","6"
"1962","Cornell (NY)","4","5","0","0.44444","168","237","-69"
"1963","Cornell (NY)","5","4","0","0.55556","152","165","-13"
"1964","Cornell (NY)","3","5","1","0.38889","196","139","57"
"1965","Cornell (NY)","4","3","2","0.55556","192","137","55"
"1966","Duke (NC)","5","5","0","0.50000","164","237","-73"
"1967","Duke (NC)","4","6","0","0.40000","143","153","-10"
"1968","Duke (NC)","4","6","0","0.40000","214","287","-73"
"1969","Duke (NC)","3","6","1","0.35000","161","224","-63"
"1970","Duke (NC)","6","5","0","0.54545","229","252","-23"
"1973","Indiana St.","4","7","0","0.36364","212","211","1"
"1974","Indiana St.","5","5","0","0.50000","179","214","-35"
"1975","Indiana St.","5","5","0","0.50000","216","239","-23"
"1976","Indiana St.","3","7","0","0.30000","152","213","-61"
"1977","Indiana St.","3","7","0","0.30000","149","240","-91"
"1970","East Carolina (NC)","3","8","0","0.27273","136","253","-117"
"1971","Duke (NC)","6","5","0","0.54545","170","149","21"
"1972","Duke (NC)","5","6","0","0.45455","132","156","-24"
"1973","Duke (NC)","2","8","1","0.22727","132","204","-72"
"1974","Duke (NC)","6","5","0","0.54545","201","208","-7"
"1975","Duke (NC)","4","5","2","0.45455","197","212","-15"
"1976","Duke (NC)","5","5","1","0.50000","234","245","-11"
"1977","Duke (NC)","5","6","0","0.45455","231","221","10"
"1978","Duke (NC)","4","7","0","0.36364","108","247","-139"
"1967","Elon (NC)","5","3","1","0.61111","210","180","30"
"1968","Elon (NC)","4","5","0","0.44444","236","248","-12"
"1969","Elon (NC)","7","3","0","0.70000","307","154","153"
"1970","Elon (NC)","3","7","0","0.30000","81","173","-92"
"1971","Elon (NC)","8","3","0","0.72727","241","166","75"
"1972","Elon (NC)","7","3","1","0.68182","261","131","130"
"1973","Elon (NC)","12","1","0","0.92308","400","155","245"
"1974","Elon (NC)","10","2","0","0.83333","295","98","197"
"1975","Elon (NC)","5","6","0","0.45455","211","145","66"
"1976","Elon (NC)","11","1","0","0.91667","363","103","260"
"1979","Duke (NC)","2","8","1","0.22727","152","264","-112"
"1980","Duke (NC)","2","9","0","0.18182","214","296","-82"
"1981","Duke (NC)","6","5","0","0.54545","210","230","-20"
"1982","Duke (NC)","6","5","0","0.54545","307","290","17"
"1973","Vanderbilt (TN)","5","6","0","0.45455","181","262","-81"
"1974","Vanderbilt (TN)","7","3","2","0.66667","313","199","114"
"1975","Texas Tech","6","5","0","0.54545","272","251","21"
"1976","Texas Tech","10","2","0","0.83333","336","206","130"
"1977","Texas Tech","7","5","0","0.58333","299","246","53"
"1978","Mississippi","5","6","0","0.45455","181","240","-59"
"1979","Mississippi","4","7","0","0.36364","251","298","-47"
"1980","Mississippi","3","8","0","0.27273","263","266","-3"
"1981","Mississippi","4","6","1","0.40909","167","284","-117"
"1982","Mississippi","4","7","0","0.36364","208","262","-54"
"1983","Duke (NC)","3","8","0","0.27273","246","350","-104"
"1984","Duke (NC)","2","9","0","0.18182","128","301","-173"
"1985","Duke (NC)","4","7","0","0.36364","193","252","-59"
"1986","Duke (NC)","4","7","0","0.36364","200","284","-84"
"1987","Duke (NC)","5","6","0","0.45455","301","243","58"
"1988","Duke (NC)","7","3","1","0.68182","324","324","0"
"1989","Duke (NC)","8","4","0","0.66667","377","335","42"
"1990","Florida","9","2","0","0.81818","387","171","216"
"1991","Florida","10","2","0","0.83333","389","191","198"
"1992","Florida","9","4","0","0.69231","315","284","31"
"1993","Florida","11","2","0","0.84615","513","244","269"
"1994","Florida","10","2","1","0.80769","538","228","310"
"1995","Florida","12","1","0","0.92308","558","263","295"
"1996","Florida","12","1","0","0.92308","611","221","390"
"1997","Florida","10","2","0","0.83333","430","205","225"
"1998","Florida","10","2","0","0.83333","380","165","215"
"1999","Florida","9","4","0","0.69231","403","272","131"
"2000","Florida","10","3","0","0.76923","468","273","195"
"2001","Florida","10","2","0","0.83333","538","178","360"
"2005","South Carolina","7","5","0","0.58333","284","279","5"
"2006","South Carolina","8","5","0","0.61538","346","243","103"
"2007","South Carolina","6","6","0","0.50000","313","282","31"
"2008","South Carolina","7","6","0","0.53846","270","274","-4"
"2009","South Carolina","7","6","0","0.53846","268","265","3"
"2010","South Carolina","9","5","0","0.64286","433","324","109"
"2011","South Carolina","11","2","0","0.84615","391","239","152"
"2012","South Carolina","11","2","0","0.84615","410","237","173"
"2013","South Carolina","11","2","0","0.84615","443","264","179"
"1990","Duke (NC)","4","7","0","0.36364","240","295","-55"
"1991","Duke (NC)","4","6","1","0.40909","231","280","-49"
"1992","Duke (NC)","2","9","0","0.18182","265","343","-78"
"1993","Duke (NC)","3","8","0","0.27273","214","349","-135"
"1989","Rice (TX)","2","8","1","0.22727","175","313","-138"
"1990","Rice (TX)","5","6","0","0.45455","256","258","-2"
"1991","Rice (TX)","4","7","0","0.36364","239","287","-48"
"1992","Rice (TX)","6","5","0","0.54545","294","261","33"
"1993","Rice (TX)","6","5","0","0.54545","284","294","-10"
"1994","Duke (NC)","8","4","0","0.66667","380","281","99"
"1995","Duke (NC)","3","8","0","0.27273","282","386","-104"
"1996","Duke (NC)","0","11","0","0.00000","162","379","-217"
"1997","Duke (NC)","2","9","0","0.18182","223","341","-118"
"1998","Duke (NC)","4","7","0","0.36364","229","319","-90"
"2007","Lenoir-Rhyne (NC)","2","9","0","0.18182","156","348","-192"
"2008","Lenoir-Rhyne (NC)","3","8","0","0.27273","276","352","-76"
"2009","Lenoir-Rhyne (NC)","5","6","0","0.45455","293","241","52"
"2010","Lenoir-Rhyne (NC)","7","4","0","0.63636","358","223","135"
"1999","Duke (NC)","3","8","0","0.27273","217","363","-146"
"2000","Duke (NC)","0","11","0","0.00000","155","430","-275"
"2001","Duke (NC)","0","11","0","0.00000","212","491","-279"
"2002","Duke (NC)","2","10","0","0.16667","227","353","-126"
"2003","Duke (NC)","2","5","0","0.28571","106","213","-107"
"2003","Duke (NC)","2","3","0","0.40000","105","130","-25"
"2004","Duke (NC)","2","9","0","0.18182","183","322","-139"
"2005","Duke (NC)","1","10","0","0.09091","177","408","-231"
"2006","Duke (NC)","0","12","0","0.00000","179","406","-227"
"2007","Duke (NC)","1","11","0","0.08333","215","398","-183"
"1998","Mississippi","1","0","0","1.00000","35","18","17"
"1999","Mississippi","8","4","0","0.66667","323","228","95"
"2000","Mississippi","7","5","0","0.58333","352","329","23"
"2001","Mississippi","7","4","0","0.63636","391","310","81"
"2002","Mississippi","7","6","0","0.53846","351","331","20"
"2003","Mississippi","10","3","0","0.76923","442","285","157"
"2004","Mississippi","4","7","0","0.36364","215","278","-63"
"2008","Duke (NC)","4","8","0","0.33333","241","281","-40"
"2009","Duke (NC)","5","7","0","0.41667","302","340","-38"
"2010","Duke (NC)","3","9","0","0.25000","303","425","-122"
"2011","Duke (NC)","3","9","0","0.25000","270","374","-104"
"2012","Duke (NC)","6","7","0","0.46154","410","468","-58"
"2013","Duke (NC)","10","4","0","0.71429","459","373","86"
"1932","East Carolina (NC)","0","5","0","0.00000","0","187","-187"
"1933","East Carolina (NC)","1","5","0","0.16667","6","99","-93"
"1934","East Carolina (NC)","1","4","1","0.25000","18","87","-69"
"1935","East Carolina (NC)","3","3","0","0.50000","78","32","46"
"1936","East Carolina (NC)","3","2","0","0.60000","64","19","45"
"1930","Lincoln Memorial (TN)","4","6","0","0.40000","58","230","-172"
"1931","Lincoln Memorial (TN)","4","7","1","0.37500","83","278","-195"
"1937","East Carolina (NC)","2","5","0","0.28571","65","78","-13"
"1938","East Carolina (NC)","1","6","1","0.18750","40","127","-87"
"1938","Eureka (IL)","1","6","0","0.14286","40","157","-117"
"1939","East Carolina (NC)","0","8","0","0.00000","18","168","-150"
"1938","Brevard College (NC)","4","6","0","0.40000","102","112","-10"
"1939","Brevard College (NC)","3","2","2","0.57143","100","85","15"
"1940","East Carolina (NC)","5","3","0","0.62500","143","70","73"
"1941","East Carolina (NC)","7","0","0","1.00000","159","20","139"
"1946","East Carolina (NC)","5","3","1","0.61111","158","58","100"
"1947","East Carolina (NC)","3","6","0","0.33333","66","141","-75"
"1948","East Carolina (NC)","0","9","0","0.00000","38","206","-168"
"1949","East Carolina (NC)","4","5","1","0.45000","207","177","30"
"1950","East Carolina (NC)","7","3","0","0.70000","252","137","115"
"1951","East Carolina (NC)","4","6","0","0.40000","184","220","-36"
"1952","Davidson (NC)","2","7","0","0.22222","151","242","-91"
"1953","Davidson (NC)","0","9","0","0.00000","52","296","-244"
"1954","Davidson (NC)","6","3","0","0.66667","157","74","83"
"1955","Davidson (NC)","5","4","0","0.55556","157","91","66"
"1956","Davidson (NC)","5","3","1","0.61111","191","126","65"
"1957","Davidson (NC)","5","3","0","0.62500","140","107","33"
"1958","Davidson (NC)","5","4","0","0.55556","159","164","-5"
"1959","Davidson (NC)","1","8","0","0.11111","118","200","-82"
"1960","Davidson (NC)","3","5","0","0.37500","88","122","-34"
"1961","Davidson (NC)","4","4","0","0.50000","138","163","-25"
"1962","Davidson (NC)","3","5","1","0.38889","97","131","-34"
"1963","Davidson (NC)","1","5","2","0.25000","69","145","-76"
"1964","Davidson (NC)","3","6","0","0.33333","91","152","-61"
"1952","East Carolina (NC)","6","3","2","0.63636","225","132","93"
"1953","East Carolina (NC)","8","2","0","0.80000","292","81","211"
"1954","East Carolina (NC)","5","4","1","0.55000","144","105","39"
"1955","East Carolina (NC)","4","5","0","0.44444","93","103","-10"
"1956","East Carolina (NC)","2","6","1","0.27778","99","245","-146"
"1957","East Carolina (NC)","1","8","0","0.11111","73","218","-145"
"1958","East Carolina (NC)","6","4","0","0.60000","142","144","-2"
"1959","East Carolina (NC)","5","6","0","0.45455","279","171","108"
"1960","East Carolina (NC)","7","3","0","0.70000","144","92","52"
"1961","East Carolina (NC)","5","4","1","0.55000","154","144","10"
"1946","Lenoir-Rhyne (NC)","5","6","0","0.45455","99","168","-69"
"1947","Lenoir-Rhyne (NC)","5","4","1","0.55000","141","83","58"
"1948","Lenoir-Rhyne (NC)","6","3","1","0.65000","133","61","72"
"1949","Lenoir-Rhyne (NC)","7","3","0","0.70000","143","87","56"
"1950","Lenoir-Rhyne (NC)","8","2","0","0.80000","271","81","190"
"1951","Lenoir-Rhyne (NC)","10","1","0","0.90909","305","89","216"
"1952","Lenoir-Rhyne (NC)","8","1","0","0.88889","370","78","292"
"1953","Lenoir-Rhyne (NC)","4","5","0","0.44444","107","167","-60"
"1954","Lenoir-Rhyne (NC)","2","7","1","0.25000","137","132","5"
"1955","Lenoir-Rhyne (NC)","9","0","1","0.95000","242","74","168"
"1956","Lenoir-Rhyne (NC)","10","0","0","1.00000","380","70","310"
"1957","Lenoir-Rhyne (NC)","8","2","1","0.77273","387","59","328"
"1958","Lenoir-Rhyne (NC)","9","1","0","0.90000","331","77","254"
"1959","Lenoir-Rhyne (NC)","10","1","0","0.90909","390","136","254"
"1960","Lenoir-Rhyne (NC)","12","0","0","1.00000","336","92","244"
"1961","Lenoir-Rhyne (NC)","8","1","1","0.85000","251","122","129"
"1962","East Carolina (NC)","5","4","0","0.55556","217","136","81"
"1963","East Carolina (NC)","9","1","0","0.90000","230","54","176"
"1964","East Carolina (NC)","9","1","0","0.90000","279","108","171"
"1965","East Carolina (NC)","9","1","0","0.90000","299","83","216"
"1966","East Carolina (NC)","4","5","1","0.45000","144","175","-31"
"1967","East Carolina (NC)","8","2","0","0.80000","253","178","75"
"1968","East Carolina (NC)","4","6","0","0.40000","175","244","-69"
"1969","East Carolina (NC)","2","7","0","0.22222","108","204","-96"
"1970","East Carolina (NC)","3","8","0","0.27273","136","253","-117"
"1971","Duke (NC)","6","5","0","0.54545","170","149","21"
"1972","Duke (NC)","5","6","0","0.45455","132","156","-24"
"1973","Duke (NC)","2","8","1","0.22727","132","204","-72"
"1974","Duke (NC)","6","5","0","0.54545","201","208","-7"
"1975","Duke (NC)","4","5","2","0.45455","197","212","-15"
"1976","Duke (NC)","5","5","1","0.50000","234","245","-11"
"1977","Duke (NC)","5","6","0","0.45455","231","221","10"
"1978","Duke (NC)","4","7","0","0.36364","108","247","-139"
"1971","East Carolina (NC)","4","6","0","0.40000","181","300","-119"
"1972","East Carolina (NC)","9","2","0","0.81818","269","176","93"
"1973","East Carolina (NC)","9","2","0","0.81818","352","151","201"
"1974","Virginia","4","7","0","0.36364","207","239","-32"
"1975","Virginia","1","10","0","0.09091","175","428","-253"
"1979","Marshall (WV)","1","10","0","0.09091","95","309","-214"
"1980","Marshall (WV)","2","8","1","0.22727","137","245","-108"
"1981","Marshall (WV)","2","9","0","0.18182","104","284","-180"
"1982","Marshall (WV)","3","8","0","0.27273","117","279","-162"
"1983","Marshall (WV)","4","7","0","0.36364","209","214","-5"
"1974","East Carolina (NC)","7","4","0","0.63636","250","167","83"
"1975","East Carolina (NC)","8","3","0","0.72727","296","154","142"
"1976","East Carolina (NC)","9","2","0","0.81818","278","116","162"
"1977","East Carolina (NC)","8","3","0","0.72727","268","154","114"
"1978","East Carolina (NC)","9","3","0","0.75000","287","136","151"
"1979","East Carolina (NC)","7","3","1","0.68182","380","193","187"
"1980","Wyoming","6","5","0","0.54545","316","243","73"
"1981","Auburn (AL)","5","6","0","0.45455","186","166","20"
"1982","Auburn (AL)","9","3","0","0.75000","274","197","77"
"1983","Auburn (AL)","11","1","0","0.91667","311","186","125"
"1984","Auburn (AL)","9","4","0","0.69231","360","254","106"
"1985","Auburn (AL)","8","4","0","0.66667","344","208","136"
"1986","Auburn (AL)","10","2","0","0.83333","395","122","273"
"1987","Auburn (AL)","9","1","2","0.83333","314","132","182"
"1988","Auburn (AL)","10","2","0","0.83333","338","92","246"
"1989","Auburn (AL)","10","2","0","0.83333","284","131","153"
"1990","Auburn (AL)","8","3","1","0.70833","283","216","67"
"1991","Auburn (AL)","5","6","0","0.45455","233","214","19"
"1992","Auburn (AL)","5","5","1","0.50000","228","205","23"
"1980","East Carolina (NC)","4","7","0","0.36364","192","312","-120"
"1981","East Carolina (NC)","5","6","0","0.45455","242","290","-48"
"1982","East Carolina (NC)","7","4","0","0.63636","259","228","31"
"1983","East Carolina (NC)","8","3","0","0.72727","271","179","92"
"1984","East Carolina (NC)","2","9","0","0.18182","210","309","-99"
"1973","Furman (SC)","7","4","0","0.63636","255","181","74"
"1974","Furman (SC)","5","6","0","0.45455","129","166","-37"
"1975","Furman (SC)","5","5","1","0.50000","210","155","55"
"1976","Furman (SC)","6","4","1","0.59091","226","159","67"
"1977","Furman (SC)","4","5","2","0.45455","230","197","33"
"1978","Citadel (SC)","5","6","0","0.45455","201","246","-45"
"1979","Citadel (SC)","6","5","0","0.54545","253","277","-24"
"1980","Citadel (SC)","7","4","0","0.63636","269","178","91"
"1981","Citadel (SC)","7","3","1","0.68182","252","151","101"
"1982","Citadel (SC)","5","6","0","0.45455","150","230","-80"
"1985","East Carolina (NC)","2","9","0","0.18182","161","281","-120"
"1986","East Carolina (NC)","3","8","0","0.27273","187","364","-177"
"1987","East Carolina (NC)","5","6","0","0.45455","229","330","-101"
"1988","East Carolina (NC)","3","8","0","0.27273","281","325","-44"
"1977","Wyoming","4","6","1","0.40909","166","273","-107"
"1978","Wyoming","5","7","0","0.41667","253","245","8"
"1979","Wyoming","4","8","0","0.33333","186","276","-90"
"1989","East Carolina (NC)","6","5","0","0.54545","301","286","15"
"1990","East Carolina (NC)","5","6","0","0.45455","254","267","-13"
"1991","East Carolina (NC)","11","1","0","0.91667","409","277","132"
"1992","Georgia Tech","5","6","0","0.45455","237","286","-49"
"1993","Georgia Tech","5","6","0","0.45455","260","286","-26"
"1994","Georgia Tech","1","7","0","0.12500","152","231","-79"
"1992","East Carolina (NC)","5","6","0","0.45455","289","367","-78"
"1993","East Carolina (NC)","2","9","0","0.18182","175","329","-154"
"1994","East Carolina (NC)","7","5","0","0.58333","303","263","40"
"1995","East Carolina (NC)","9","3","0","0.75000","274","226","48"
"1996","East Carolina (NC)","8","3","0","0.72727","316","214","102"
"1997","East Carolina (NC)","5","6","0","0.45455","214","298","-84"
"1998","East Carolina (NC)","6","5","0","0.54545","274","297","-23"
"1999","East Carolina (NC)","9","3","0","0.75000","333","225","108"
"2000","East Carolina (NC)","8","4","0","0.66667","370","256","114"
"2001","East Carolina (NC)","6","6","0","0.50000","421","360","61"
"2002","East Carolina (NC)","4","8","0","0.33333","335","399","-64"
"2003","East Carolina (NC)","1","11","0","0.08333","217","428","-211"
"2004","East Carolina (NC)","2","9","0","0.18182","231","439","-208"
"2012","Arkansas St.","1","0","0","1.00000","17","13","4"
"2013","Arkansas St.","1","0","0","1.00000","23","20","3"
"1994","Connecticut","4","7","0","0.36364","240","264","-24"
"1995","Connecticut","8","3","0","0.72727","279","200","79"
"1996","Connecticut","4","6","0","0.40000","244","191","53"
"1997","Connecticut","7","4","0","0.63636","398","246","152"
"1998","Connecticut","10","3","0","0.76923","461","413","48"
"2005","East Carolina (NC)","5","6","0","0.45455","267","317","-50"
"2006","East Carolina (NC)","7","6","0","0.53846","280","270","10"
"2007","East Carolina (NC)","8","5","0","0.61538","403","395","8"
"2008","East Carolina (NC)","9","5","0","0.64286","328","295","33"
"2009","East Carolina (NC)","9","5","0","0.64286","378","307","71"
"2010","South Florida","8","5","0","0.61538","313","260","53"
"2011","South Florida","5","7","0","0.41667","351","272","79"
"2012","South Florida","3","9","0","0.25000","247","329","-82"
"2013","Louisiana Tech","4","8","0","0.33333","230","315","-85"
"2009","Texas Tech","1","0","0","1.00000","41","31","10"
"2010","East Carolina (NC)","6","7","0","0.46154","478","572","-94"
"2011","East Carolina (NC)","5","7","0","0.41667","315","387","-72"
"2012","East Carolina (NC)","8","5","0","0.61538","409","411","-2"
"2013","East Carolina (NC)","10","3","0","0.76923","522","322","200"
"1891","Eastern Michigan","0","2","0","0.00000","4","64","-60"
"1892","Eastern Michigan","2","1","0","0.66667","36","30","6"
"1893","Eastern Michigan","4","2","0","0.66667","116","94","22"
"1894","Eastern Michigan","5","2","0","0.71429","176","70","106"
"1895","Eastern Michigan","3","3","0","0.50000","119","64","55"
"1896","Eastern Michigan","4","1","0","0.80000","110","18","92"
"1897","Eastern Michigan","2","3","0","0.40000","36","62","-26"
"1898","Eastern Michigan","1","5","2","0.25000","19","96","-77"
"1899","Eastern Michigan","1","1","1","0.50000","29","23","6"
"1900","Eastern Michigan","2","4","0","0.33333","27","80","-53"
"1901","Eastern Michigan","3","5","0","0.37500","60","167","-107"
"1902","Eastern Michigan","1","5","1","0.21429","43","125","-82"
"1909","Utah St.","2","2","1","0.50000","34","55","-21"
"1910","Utah St.","5","2","0","0.71429","104","33","71"
"1911","Utah St.","5","0","0","1.00000","164","0","164"
"1912","Utah St.","4","2","1","0.64286","154","40","114"
"1913","Utah St.","3","3","0","0.50000","97","69","28"
"1914","Utah St.","2","5","0","0.28571","56","208","-152"
"1915","Utah St.","3","4","0","0.42857","56","99","-43"
"1903","Eastern Michigan","4","4","0","0.50000","78","88","-10"
"1904","Eastern Michigan","6","2","0","0.75000","121","159","-38"
"1905","Eastern Michigan","4","4","0","0.50000","81","157","-76"
"1906","Eastern Michigan","5","0","1","0.91667","52","11","41"
"1907","Eastern Michigan","3","2","0","0.60000","72","13","59"
"1908","Eastern Michigan","1","4","0","0.20000","15","40","-25"
"1914","Missouri","5","3","0","0.62500","128","48","80"
"1915","Missouri","2","5","1","0.31250","72","102","-30"
"1916","Missouri","6","1","1","0.81250","112","21","91"
"1917","Missouri","3","5","0","0.37500","98","124","-26"
"1919","Nebraska","3","3","2","0.50000","56","60","-4"
"1920","Nebraska","5","3","1","0.61111","151","84","67"
"1909","Eastern Michigan","2","4","0","0.33333","44","45","-1"
"1910","Eastern Michigan","0","5","1","0.08333","11","58","-47"
"1911","Eastern Michigan","3","4","0","0.42857","46","71","-25"
"1912","Eastern Michigan","4","2","1","0.64286","83","45","38"
"1913","Eastern Michigan","2","3","1","0.41667","50","72","-22"
"1914","Eastern Michigan","3","2","1","0.58333","72","46","26"
"1915","Eastern Michigan","4","2","1","0.64286","154","25","129"
"1916","Eastern Michigan","1","2","1","0.37500","18","33","-15"
"1918","Eastern Michigan","1","2","0","0.33333","26","31","-5"
"1921","Eastern Michigan","3","3","0","0.50000","82","50","32"
"1922","Eastern Michigan","3","2","2","0.57143","31","28","3"
"1923","Eastern Michigan","2","5","1","0.31250","55","104","-49"
"1924","Eastern Michigan","2","5","1","0.31250","45","69","-24"
"1917","Eastern Michigan","3","4","0","0.42857","111","82","29"
"1919","Eastern Michigan","4","2","1","0.64286","73","44","29"
"1920","Eastern Michigan","6","2","0","0.75000","155","88","67"
"1925","Eastern Michigan","8","0","0","1.00000","106","6","100"
"1926","Eastern Michigan","6","1","0","0.85714","113","12","101"
"1927","Eastern Michigan","8","0","0","1.00000","186","13","173"
"1928","Eastern Michigan","7","1","0","0.87500","233","43","190"
"1929","Eastern Michigan","5","1","2","0.75000","156","45","111"
"1930","Eastern Michigan","6","1","0","0.85714","145","14","131"
"1931","Eastern Michigan","3","2","1","0.58333","98","54","44"
"1932","Eastern Michigan","5","2","0","0.71429","145","31","114"
"1933","Eastern Michigan","6","2","0","0.75000","115","71","44"
"1934","Eastern Michigan","5","2","0","0.71429","109","79","30"
"1935","Eastern Michigan","4","2","2","0.62500","43","41","2"
"1936","Eastern Michigan","6","2","0","0.75000","76","53","23"
"1937","Eastern Michigan","5","2","1","0.68750","156","59","97"
"1938","Eastern Michigan","6","1","1","0.81250","166","36","130"
"1939","Eastern Michigan","3","3","1","0.50000","68","64","4"
"1940","Eastern Michigan","1","5","1","0.21429","34","125","-91"
"1941","Eastern Michigan","0","5","2","0.14286","12","65","-53"
"1942","Eastern Michigan","3","3","1","0.50000","64","81","-17"
"1943","Eastern Michigan","2","0","0","1.00000","28","0","28"
"1945","Eastern Michigan","5","0","1","0.91667","46","13","33"
"1946","Eastern Michigan","3","4","1","0.43750","65","80","-15"
"1947","Eastern Michigan","1","6","0","0.14286","29","106","-77"
"1948","Eastern Michigan","3","5","0","0.37500","66","114","-48"
"1935","Bowling Green (OH)","1","6","0","0.14286","25","246","-221"
"1936","Bowling Green (OH)","4","2","3","0.61111","66","60","6"
"1937","Bowling Green (OH)","3","4","1","0.43750","56","80","-24"
"1938","Bowling Green (OH)","3","2","3","0.56250","95","41","54"
"1939","Bowling Green (OH)","6","1","1","0.81250","159","46","113"
"1940","Bowling Green (OH)","3","4","1","0.43750","62","122","-60"
"1949","Eastern Michigan","0","8","0","0.00000","61","180","-119"
"1950","Eastern Michigan","3","6","0","0.33333","123","191","-68"
"1951","Eastern Michigan","4","5","0","0.44444","186","183","3"
"1952","Eastern Michigan","5","3","1","0.61111","154","146","8"
"1953","Eastern Michigan","7","1","1","0.83333","212","105","107"
"1954","Eastern Michigan","8","1","0","0.88889","210","67","143"
"1955","Eastern Michigan","7","2","0","0.77778","138","70","68"
"1956","Eastern Michigan","4","4","0","0.50000","158","84","74"
"1957","Eastern Michigan","6","3","0","0.66667","237","127","110"
"1958","Eastern Michigan","4","5","0","0.44444","108","88","20"
"1959","Eastern Michigan","1","7","0","0.12500","50","217","-167"
"1960","Eastern Michigan","0","8","1","0.05556","38","230","-192"
"1961","Eastern Michigan","0","8","1","0.05556","49","171","-122"
"1962","Eastern Michigan","2","5","0","0.28571","75","90","-15"
"1963","Eastern Michigan","2","6","0","0.25000","96","201","-105"
"1964","Eastern Michigan","4","3","0","0.57143","110","73","37"
"1965","Eastern Michigan","3","4","1","0.43750","125","129","-4"
"1966","Eastern Michigan","5","3","1","0.61111","100","87","13"
"1967","Eastern Michigan","6","3","0","0.66667","173","77","96"
"1968","Eastern Michigan","8","2","0","0.80000","248","91","157"
"1969","Eastern Michigan","5","4","0","0.55556","255","106","149"
"1970","Eastern Michigan","7","2","1","0.75000","237","109","128"
"1971","Eastern Michigan","7","1","2","0.80000","228","85","143"
"1972","Eastern Michigan","6","4","0","0.60000","202","162","40"
"1973","Eastern Michigan","6","4","0","0.60000","265","190","75"
"1974","Eastern Michigan","4","6","1","0.40909","143","178","-35"
"1975","Eastern Michigan","4","6","0","0.40000","198","171","27"
"1976","Eastern Michigan","2","9","0","0.18182","132","355","-223"
"1977","Eastern Michigan","8","3","0","0.72727","239","195","44"
"1978","Boston College (MA)","0","11","0","0.00000","153","294","-141"
"1979","Boston College (MA)","5","6","0","0.45455","215","217","-2"
"1980","Boston College (MA)","7","4","0","0.63636","199","186","13"
"1981","Kent St. (OH)","4","7","0","0.36364","144","172","-28"
"1982","Kent St. (OH)","0","11","0","0.00000","114","270","-156"
"1978","Eastern Michigan","3","7","0","0.30000","122","238","-116"
"1979","Eastern Michigan","2","8","1","0.22727","113","236","-123"
"1980","Eastern Michigan","1","9","0","0.10000","81","322","-241"
"1981","Eastern Michigan","0","11","0","0.00000","88","338","-250"
"1982","Eastern Michigan","0","3","0","0.00000","19","98","-79"
"1982","Eastern Michigan","1","6","1","0.18750","66","107","-41"
"1973","Grand Valley St. (MI)","6","3","0","0.66667","259","120","139"
"1974","Grand Valley St. (MI)","6","3","0","0.66667","225","87","138"
"1975","Grand Valley St. (MI)","7","2","1","0.75000","264","96","168"
"1976","Grand Valley St. (MI)","8","2","0","0.80000","194","131","63"
"1977","Grand Valley St. (MI)","7","3","0","0.70000","212","128","84"
"1978","Grand Valley St. (MI)","9","3","0","0.75000","333","229","104"
"1979","Grand Valley St. (MI)","4","5","0","0.44444","215","182","33"
"1980","Grand Valley St. (MI)","7","3","0","0.70000","290","166","124"
"1981","Grand Valley St. (MI)","7","2","0","0.77778","309","131","178"
"1982","Grand Valley St. (MI)","7","3","0","0.70000","310","213","97"
"1983","Eastern Michigan","1","10","0","0.09091","134","276","-142"
"1984","Eastern Michigan","2","7","2","0.27273","151","221","-70"
"1985","Eastern Michigan","4","7","0","0.36364","188","252","-64"
"1986","Eastern Michigan","6","5","0","0.54545","222","228","-6"
"1987","Eastern Michigan","10","2","0","0.83333","343","237","106"
"1988","Eastern Michigan","6","3","1","0.65000","173","200","-27"
"1989","Eastern Michigan","7","3","1","0.68182","252","196","56"
"1990","Eastern Michigan","2","9","0","0.18182","179","301","-122"
"1991","Eastern Michigan","3","7","1","0.31818","144","232","-88"
"1992","Eastern Michigan","0","4","0","0.00000","47","127","-80"
"1992","Eastern Michigan","1","6","0","0.14286","70","209","-139"
"1997","Southern Illinois","3","8","0","0.27273","238","320","-82"
"1998","Southern Illinois","3","8","0","0.27273","259","296","-37"
"1999","Southern Illinois","5","6","0","0.45455","424","432","-8"
"2000","Southern Illinois","3","8","0","0.27273","208","316","-108"
"1993","Eastern Michigan","4","7","0","0.36364","163","220","-57"
"1994","Eastern Michigan","5","6","0","0.45455","247","285","-38"
"1995","Louisville (KY)","7","4","0","0.63636","283","165","118"
"1996","Louisville (KY)","5","6","0","0.45455","182","205","-23"
"1997","Louisville (KY)","1","10","0","0.09091","245","407","-162"
"1998","Alabama A&M","5","6","0","0.45455","220","248","-28"
"1999","Alabama A&M","6","5","0","0.54545","287","230","57"
"2000","Alabama A&M","7","5","0","0.58333","312","227","85"
"2001","Alabama A&M","5","6","0","0.45455","215","246","-31"
"1995","Eastern Michigan","6","5","0","0.54545","363","335","28"
"1996","Eastern Michigan","3","8","0","0.27273","210","284","-74"
"1997","Eastern Michigan","4","7","0","0.36364","329","352","-23"
"1998","Eastern Michigan","3","8","0","0.27273","216","309","-93"
"1999","Eastern Michigan","4","6","0","0.40000","216","308","-92"
"1999","Eastern Michigan","0","1","0","0.00000","23","30","-7"
"2000","Eastern Michigan","3","8","0","0.27273","209","350","-141"
"2001","Eastern Michigan","2","9","0","0.18182","197","356","-159"
"2002","Eastern Michigan","3","9","0","0.25000","286","566","-280"
"2003","Eastern Michigan","1","8","0","0.11111","124","306","-182"
"2003","Eastern Michigan","2","1","0","0.66667","81","65","16"
"2004","Delaware St.","4","7","0","0.36364","204","352","-148"
"2005","Delaware St.","7","4","0","0.63636","225","213","12"
"2006","Delaware St.","8","3","0","0.72727","335","192","143"
"2007","Delaware St.","10","2","0","0.83333","254","221","33"
"2008","Delaware St.","5","6","0","0.45455","220","228","-8"
"2009","Delaware St.","4","7","0","0.36364","178","262","-84"
"2010","Delaware St.","3","8","0","0.27273","272","334","-62"
"2004","Eastern Michigan","4","7","0","0.36364","328","458","-130"
"2005","Eastern Michigan","4","7","0","0.36364","240","295","-55"
"2006","Eastern Michigan","1","11","0","0.08333","167","322","-155"
"2007","Eastern Michigan","4","8","0","0.33333","290","374","-84"
"2008","Eastern Michigan","3","9","0","0.25000","309","427","-118"
"2009","Eastern Michigan","0","12","0","0.00000","197","459","-262"
"2010","Eastern Michigan","2","10","0","0.16667","228","527","-299"
"2011","Eastern Michigan","6","6","0","0.50000","255","292","-37"
"2012","Eastern Michigan","2","10","0","0.16667","256","451","-195"
"2013","Eastern Michigan","1","8","0","0.11111","174","410","-236"
"1978","Wabash (IN)","8","1","0","0.88889","171","59","112"
"1979","Wabash (IN)","8","1","0","0.88889","288","76","212"
"1980","Wabash (IN)","8","0","1","0.94444","293","57","236"
"1981","Wabash (IN)","8","1","0","0.88889","272","73","199"
"1982","Wabash (IN)","10","0","0","1.00000","293","117","176"
"1984","Marshall (WV)","6","5","0","0.54545","238","226","12"
"1985","Marshall (WV)","7","3","1","0.68182","193","197","-4"
"1986","Kansas St.","2","9","0","0.18182","134","343","-209"
"1987","Kansas St.","0","10","1","0.04545","135","421","-286"
"1988","Kansas St.","0","11","0","0.00000","171","448","-277"
"2008","Ball St. (IN)","0","1","0","0.00000","13","45","-32"
"2009","Ball St. (IN)","2","10","0","0.16667","230","338","-108"
"2010","Ball St. (IN)","4","8","0","0.33333","264","365","-101"
"2013","Eastern Michigan","1","2","0","0.33333","52","132","-80"
"1906","Florida","5","3","0","0.62500","84","60","24"
"1907","Florida","4","1","1","0.75000","53","10","43"
"1908","Florida","5","2","1","0.68750","90","40","50"
"1909","Florida","6","1","1","0.81250","117","34","83"
"1910","Florida","6","1","0","0.85714","186","15","171"
"1911","Florida","5","0","1","0.91667","84","14","70"
"1912","Florida","5","2","1","0.68750","203","54","149"
"1913","Florida","4","3","0","0.57143","228","94","134"
"1914","Florida","5","2","0","0.71429","152","46","106"
"1915","Florida","4","3","0","0.57143","99","65","34"
"1916","Florida","0","5","0","0.00000","3","95","-92"
"1917","Florida","2","4","0","0.33333","47","247","-200"
"1918","Florida","0","1","0","0.00000","2","14","-12"
"1919","Florida","5","3","0","0.62500","174","46","128"
"1918","Nebraska","3","3","1","0.50000","65","55","10"
"1920","Florida","6","3","0","0.66667","113","91","22"
"1921","Florida","6","3","2","0.63636","134","61","73"
"1922","Florida","7","2","0","0.77778","239","51","188"
"1923","Florida","6","1","2","0.77778","179","60","119"
"1924","Florida","6","2","2","0.70000","211","44","167"
"1925","Florida","8","2","0","0.80000","222","80","142"
"1926","Florida","2","6","2","0.30000","94","137","-43"
"1927","Florida","7","3","0","0.70000","164","96","68"
"1919","Northwestern (IL)","2","5","0","0.28571","49","111","-62"
"1920","Kansas St.","3","3","3","0.50000","93","55","38"
"1921","Kansas St.","5","3","0","0.62500","84","64","20"
"1922","Kansas St.","5","1","2","0.75000","154","61","93"
"1923","Kansas St.","4","2","2","0.62500","107","72","35"
"1924","Kansas St.","3","4","1","0.43750","68","79","-11"
"1925","Kansas St.","5","2","1","0.68750","70","43","27"
"1926","Kansas St.","5","3","0","0.62500","85","42","43"
"1927","Kansas St.","3","5","0","0.37500","101","146","-45"
"1928","Florida","8","1","0","0.88889","336","44","292"
"1929","Florida","8","2","0","0.80000","187","73","114"
"1930","Florida","6","3","1","0.65000","199","60","139"
"1931","Florida","2","6","2","0.30000","73","168","-95"
"1932","Florida","3","6","0","0.33333","108","136","-28"
"1933","Michigan St.","4","2","2","0.62500","73","49","24"
"1934","Michigan St.","8","1","0","0.88889","153","56","97"
"1935","Michigan St.","6","2","0","0.75000","207","57","150"
"1936","Michigan St.","6","1","2","0.77778","143","40","103"
"1937","Michigan St.","8","2","0","0.80000","117","42","75"
"1938","Michigan St.","6","3","0","0.66667","133","59","74"
"1939","Michigan St.","4","4","1","0.50000","102","92","10"
"1940","Michigan St.","3","4","1","0.43750","108","76","32"
"1941","Michigan St.","5","3","1","0.61111","150","77","73"
"1942","Michigan St.","4","3","2","0.55556","120","99","21"
"1944","Michigan St.","6","1","0","0.85714","167","31","136"
"1945","Michigan St.","5","3","1","0.61111","120","128","-8"
"1946","Michigan St.","5","5","0","0.50000","181","202","-21"
"1933","Florida","5","3","1","0.61111","114","53","61"
"1934","Florida","6","3","1","0.65000","113","110","3"
"1935","Florida","3","7","0","0.30000","113","154","-41"
"1920","Mercer (GA)","2","7","0","0.22222","97","179","-82"
"1921","Mercer (GA)","3","6","0","0.33333","92","145","-53"
"1922","Mercer (GA)","5","6","0","0.45455","134","201","-67"
"1927","Clemson (SC)","5","3","1","0.61111","74","84","-10"
"1928","Clemson (SC)","8","3","0","0.72727","192","77","115"
"1929","Clemson (SC)","8","3","0","0.72727","236","110","126"
"1930","Clemson (SC)","8","2","0","0.80000","239","82","157"
"1936","Florida","4","6","0","0.40000","99","125","-26"
"1937","Florida","4","7","0","0.36364","86","89","-3"
"1938","Florida","4","6","1","0.40909","112","149","-37"
"1939","Florida","5","5","1","0.50000","78","66","12"
"1955","Temple (PA)","0","8","0","0.00000","49","223","-174"
"1930","Loyola Marymount (CA)","2","3","1","0.41667","21","62","-41"
"1931","Loyola Marymount (CA)","7","2","1","0.75000","116","45","71"
"1932","Loyola Marymount (CA)","4","4","0","0.50000","135","71","64"
"1933","Loyola Marymount (CA)","7","2","1","0.75000","178","71","107"
"1934","Loyola Marymount (CA)","7","2","1","0.75000","179","44","135"
"1935","Loyola Marymount (CA)","6","5","0","0.54545","152","90","62"
"1936","Loyola Marymount (CA)","6","3","0","0.66667","128","81","47"
"1937","Loyola Marymount (CA)","4","7","0","0.36364","108","120","-12"
"1938","Loyola Marymount (CA)","4","5","0","0.44444","151","101","50"
"1940","Florida","5","5","0","0.50000","136","139","-3"
"1941","Florida","4","6","0","0.40000","149","97","52"
"1942","Florida","3","7","0","0.30000","106","185","-79"
"1944","Florida","4","3","0","0.57143","108","136","-28"
"1945","Florida","4","5","1","0.45000","155","100","55"
"1936","North Carolina","8","2","0","0.80000","190","100","90"
"1937","North Carolina","7","1","1","0.83333","173","39","134"
"1938","North Carolina","6","2","1","0.72222","117","37","80"
"1939","North Carolina","8","1","1","0.85000","228","52","176"
"1940","North Carolina","6","4","0","0.60000","159","98","61"
"1941","North Carolina","3","7","0","0.30000","130","172","-42"
"1946","Florida","0","9","0","0.00000","104","264","-160"
"1947","Florida","4","5","1","0.45000","125","156","-31"
"1948","Florida","5","5","0","0.50000","213","206","7"
"1949","Florida","4","5","1","0.45000","180","218","-38"
"1952","Tulane (LA)","5","5","0","0.50000","188","146","42"
"1953","Tulane (LA)","1","8","1","0.15000","129","228","-99"
"1947","Baylor (TX)","5","5","0","0.50000","127","138","-11"
"1948","Baylor (TX)","6","3","2","0.63636","167","125","42"
"1949","Baylor (TX)","8","2","0","0.80000","232","126","106"
"1950","Florida","5","5","0","0.50000","157","181","-24"
"1951","Florida","5","5","0","0.50000","174","131","43"
"1952","Florida","8","3","0","0.72727","304","122","182"
"1953","Florida","3","5","2","0.40000","200","113","87"
"1954","Florida","5","5","0","0.50000","115","128","-13"
"1955","Florida","4","6","0","0.40000","111","126","-15"
"1956","Florida","6","3","1","0.65000","158","98","60"
"1957","Florida","6","2","1","0.72222","133","70","63"
"1958","Florida","6","4","1","0.59091","174","100","74"
"1959","Florida","5","4","1","0.55000","169","107","62"
"1960","Florida","9","2","0","0.81818","157","86","71"
"1961","Florida","4","5","1","0.45000","97","146","-49"
"1962","Florida","7","4","0","0.63636","221","139","82"
"1963","Florida","6","3","1","0.65000","130","120","10"
"1964","Florida","7","3","0","0.70000","181","98","83"
"1965","Florida","7","4","0","0.63636","239","149","90"
"1966","Florida","9","2","0","0.81818","265","147","118"
"1967","Florida","6","4","0","0.60000","201","161","40"
"1968","Florida","6","3","1","0.65000","151","175","-24"
"1969","Florida","9","1","1","0.86364","343","200","143"
"1964","Tennessee","4","5","1","0.45000","80","121","-41"
"1965","Tennessee","8","1","2","0.81818","220","98","122"
"1966","Tennessee","8","3","0","0.72727","240","99","141"
"1967","Tennessee","9","2","0","0.81818","283","141","142"
"1968","Tennessee","8","2","1","0.77273","261","146","115"
"1969","Tennessee","9","2","0","0.81818","328","179","149"
"1970","Florida","7","4","0","0.63636","224","256","-32"
"1971","Florida","4","7","0","0.36364","174","298","-124"
"1972","Florida","5","5","1","0.50000","218","144","74"
"1973","Florida","7","5","0","0.58333","187","187","0"
"1974","Florida","8","4","0","0.66667","261","197","64"
"1975","Florida","9","3","0","0.75000","302","117","185"
"1976","Florida","8","4","0","0.66667","328","292","36"
"1977","Florida","6","4","1","0.59091","251","235","16"
"1978","Florida","4","7","0","0.36364","249","223","26"
"1969","Jacksonville St. (AL)","3","6","0","0.33333","127","211","-84"
"1970","Jacksonville St. (AL)","10","0","0","1.00000","325","104","221"
"1971","Jacksonville St. (AL)","6","3","0","0.66667","297","142","155"
"1972","Jacksonville St. (AL)","7","2","1","0.75000","239","109","130"
"1973","Jacksonville St. (AL)","7","2","0","0.77778","319","137","182"
"1977","Clemson (SC)","8","3","1","0.70833","228","163","65"
"1978","Clemson (SC)","10","1","0","0.90909","351","116","235"
"1979","Florida","0","10","1","0.04545","106","265","-159"
"1980","Florida","8","4","0","0.66667","256","186","70"
"1981","Florida","7","5","0","0.58333","284","166","118"
"1982","Florida","8","4","0","0.66667","296","228","68"
"1983","Florida","9","2","1","0.79167","304","156","148"
"1984","Florida","1","1","1","0.50000","104","74","30"
"1984","Florida","8","0","0","1.00000","237","96","141"
"1985","Florida","9","1","1","0.86364","286","162","124"
"1986","Florida","6","5","0","0.54545","223","173","50"
"1987","Florida","6","6","0","0.50000","299","178","121"
"1988","Florida","7","5","0","0.58333","268","185","83"
"1989","Florida","4","1","0","0.80000","128","57","71"
"1983","Tennessee Tech","2","8","0","0.20000","97","226","-129"
"1984","Tennessee Tech","0","11","0","0.00000","78","329","-251"
"1985","Tennessee Tech","1","10","0","0.09091","177","314","-137"
"1989","Florida","3","4","0","0.42857","140","145","-5"
"1997","Western Michigan","8","3","0","0.72727","301","265","36"
"1998","Western Michigan","7","4","0","0.63636","360","312","48"
"1999","Western Michigan","7","5","0","0.58333","373","342","31"
"2000","Western Michigan","9","3","0","0.75000","359","139","220"
"2001","Western Michigan","5","6","0","0.45455","277","266","11"
"2002","Western Michigan","4","8","0","0.33333","303","330","-27"
"2003","Western Michigan","5","7","0","0.41667","331","370","-39"
"2004","Western Michigan","1","10","0","0.09091","248","436","-188"
"2007","Texas A&M","0","1","0","0.00000","17","24","-7"
"1987","Duke (NC)","5","6","0","0.45455","301","243","58"
"1988","Duke (NC)","7","3","1","0.68182","324","324","0"
"1989","Duke (NC)","8","4","0","0.66667","377","335","42"
"1990","Florida","9","2","0","0.81818","387","171","216"
"1991","Florida","10","2","0","0.83333","389","191","198"
"1992","Florida","9","4","0","0.69231","315","284","31"
"1993","Florida","11","2","0","0.84615","513","244","269"
"1994","Florida","10","2","1","0.80769","538","228","310"
"1995","Florida","12","1","0","0.92308","558","263","295"
"1996","Florida","12","1","0","0.92308","611","221","390"
"1997","Florida","10","2","0","0.83333","430","205","225"
"1998","Florida","10","2","0","0.83333","380","165","215"
"1999","Florida","9","4","0","0.69231","403","272","131"
"2000","Florida","10","3","0","0.76923","468","273","195"
"2001","Florida","10","2","0","0.83333","538","178","360"
"2005","South Carolina","7","5","0","0.58333","284","279","5"
"2006","South Carolina","8","5","0","0.61538","346","243","103"
"2007","South Carolina","6","6","0","0.50000","313","282","31"
"2008","South Carolina","7","6","0","0.53846","270","274","-4"
"2009","South Carolina","7","6","0","0.53846","268","265","3"
"2010","South Carolina","9","5","0","0.64286","433","324","109"
"2011","South Carolina","11","2","0","0.84615","391","239","152"
"2012","South Carolina","11","2","0","0.84615","410","237","173"
"2013","South Carolina","11","2","0","0.84615","443","264","179"
"2002","Florida","8","5","0","0.61538","336","279","57"
"2003","Florida","8","5","0","0.61538","390","271","119"
"2004","Florida","7","4","0","0.63636","372","226","146"
"2005","Illinois","2","9","0","0.18182","187","435","-248"
"2006","Illinois","2","10","0","0.16667","235","321","-86"
"2007","Illinois","9","4","0","0.69231","362","283","79"
"2008","Illinois","5","7","0","0.41667","344","319","25"
"2009","Illinois","3","9","0","0.25000","290","362","-72"
"2010","Illinois","7","6","0","0.53846","423","305","118"
"2011","Illinois","6","6","0","0.50000","274","241","33"
"2004","Florida","0","1","0","0.00000","10","27","-17"
"2010","Louisville (KY)","7","6","0","0.53846","343","252","91"
"2011","Louisville (KY)","7","6","0","0.53846","285","261","24"
"2012","Louisville (KY)","11","2","0","0.84615","405","309","96"
"2013","Louisville (KY)","12","1","0","0.92308","457","158","299"
"2001","Bowling Green (OH)","8","3","0","0.72727","333","215","118"
"2002","Bowling Green (OH)","9","3","0","0.75000","490","304","186"
"2003","Utah","10","2","0","0.83333","344","229","115"
"2004","Utah","11","0","0","1.00000","509","227","282"
"2005","Florida","9","3","0","0.75000","343","226","117"
"2006","Florida","13","1","0","0.92857","416","189","227"
"2007","Florida","9","4","0","0.69231","552","331","221"
"2008","Florida","13","1","0","0.92857","611","181","430"
"2009","Florida","13","1","0","0.92857","502","174","328"
"2010","Florida","8","5","0","0.61538","388","277","111"
"2012","Ohio St.","12","0","0","1.00000","446","274","172"
"2013","Ohio St.","12","2","0","0.85714","637","317","320"
"2011","Florida","7","6","0","0.53846","331","264","67"
"2012","Florida","11","2","0","0.84615","344","188","156"
"2013","Florida","4","8","0","0.33333","226","253","-27"
"1979","Miami (FL)","5","6","0","0.45455","191","236","-45"
"1980","Miami (FL)","9","3","0","0.75000","278","171","107"
"1981","Miami (FL)","9","2","0","0.81818","245","145","100"
"1982","Miami (FL)","7","4","0","0.63636","241","153","88"
"1983","Miami (FL)","11","1","0","0.91667","313","136","177"
"1985","Louisville (KY)","2","9","0","0.18182","199","429","-230"
"1986","Louisville (KY)","3","8","0","0.27273","179","303","-124"
"1987","Louisville (KY)","3","7","1","0.31818","215","348","-133"
"1988","Louisville (KY)","8","3","0","0.72727","261","245","16"
"1989","Louisville (KY)","6","5","0","0.54545","312","222","90"
"1990","Louisville (KY)","10","1","1","0.87500","345","149","196"
"1991","Louisville (KY)","2","9","0","0.18182","135","335","-200"
"1992","Louisville (KY)","5","6","0","0.45455","214","243","-29"
"1993","Louisville (KY)","9","3","0","0.75000","350","243","107"
"1994","Louisville (KY)","6","5","0","0.54545","255","253","2"
"1995","Oklahoma","5","5","1","0.50000","233","275","-42"
"2001","Florida Atlantic","4","6","0","0.40000","177","245","-68"
"2002","Florida Atlantic","2","9","0","0.18182","176","339","-163"
"2003","Florida Atlantic","11","3","0","0.78571","404","306","98"
"2004","Florida Atlantic","9","3","0","0.75000","299","207","92"
"2005","Florida Atlantic","2","9","0","0.18182","148","339","-191"
"2006","Florida Atlantic","5","7","0","0.41667","181","299","-118"
"2007","Florida Atlantic","8","5","0","0.61538","405","432","-27"
"2008","Florida Atlantic","7","6","0","0.53846","326","373","-47"
"2009","Florida Atlantic","5","7","0","0.41667","329","405","-76"
"2010","Florida Atlantic","4","8","0","0.33333","202","351","-149"
"2011","Florida Atlantic","1","11","0","0.08333","155","416","-261"
"2013","Florida Atlantic","4","0","0","1.00000","151","40","111"
"2012","Florida Atlantic","3","9","0","0.25000","246","370","-124"
"2013","Florida Atlantic","2","6","0","0.25000","166","227","-61"
"2002","Florida International","5","6","0","0.45455","241","228","13"
"2003","Florida International","2","10","0","0.16667","270","341","-71"
"2004","Florida International","3","7","0","0.30000","261","325","-64"
"2005","Florida International","5","6","0","0.45455","257","323","-66"
"2006","Florida International","0","12","0","0.00000","115","313","-198"
"2007","Florida International","1","11","0","0.08333","181","469","-288"
"2008","Florida International","5","7","0","0.41667","296","340","-44"
"2009","Florida International","3","9","0","0.25000","275","424","-149"
"2010","Florida International","7","6","0","0.53846","374","355","19"
"2011","Florida International","8","5","0","0.61538","325","253","72"
"2012","Florida International","3","9","0","0.25000","300","380","-80"
"1992","San Jose St. (CA)","7","4","0","0.63636","330","309","21"
"1997","Illinois","0","11","0","0.00000","119","368","-249"
"1998","Illinois","3","8","0","0.27273","149","326","-177"
"1999","Illinois","8","4","0","0.66667","388","275","113"
"2000","Illinois","5","6","0","0.45455","294","286","8"
"2001","Illinois","10","2","0","0.83333","390","285","105"
"2002","Illinois","5","7","0","0.41667","346","307","39"
"2003","Illinois","1","11","0","0.08333","203","398","-195"
"2004","Illinois","3","8","0","0.27273","240","323","-83"
"2013","Florida International","1","11","0","0.08333","117","444","-327"
"1947","Florida St.","0","5","0","0.00000","18","90","-72"
"1946","Hanover (IN)","4","3","0","0.57143","76","74","2"
"1948","Florida St.","7","1","0","0.87500","152","64","88"
"1949","Florida St.","9","1","0","0.90000","291","59","232"
"1950","Florida St.","8","0","0","1.00000","219","54","165"
"1951","Florida St.","6","2","0","0.75000","194","72","122"
"1952","Florida St.","1","8","1","0.15000","101","261","-160"
"1949","Virginia Military Institute","3","5","1","0.38889","157","207","-50"
"1950","Virginia Military Institute","6","4","0","0.60000","189","166","23"
"1951","Virginia Military Institute","7","3","0","0.70000","227","161","66"
"1952","Virginia Military Institute","3","6","1","0.35000","165","279","-114"
"1953","Florida St.","5","5","0","0.50000","183","146","37"
"1954","Florida St.","8","4","0","0.66667","277","190","87"
"1955","Florida St.","5","5","0","0.50000","147","186","-39"
"1956","Florida St.","5","4","1","0.55000","178","116","62"
"1957","Florida St.","4","6","0","0.40000","136","165","-29"
"1958","Florida St.","7","4","0","0.63636","218","124","94"
"1959","Maryland","5","5","0","0.50000","184","188","-4"
"1960","Maryland","6","4","0","0.60000","171","164","7"
"1961","Maryland","7","3","0","0.70000","156","141","15"
"1962","Maryland","6","4","0","0.60000","170","128","42"
"1963","Maryland","3","7","0","0.30000","148","201","-53"
"1964","Maryland","5","5","0","0.50000","164","126","38"
"1965","Maryland","4","6","0","0.40000","132","164","-32"
"1959","Florida St.","4","6","0","0.40000","149","132","17"
"1968","Marshall (WV)","0","9","1","0.05000","129","358","-229"
"1960","Florida St.","3","6","1","0.35000","111","136","-25"
"1961","Florida St.","4","5","1","0.45000","93","128","-35"
"1962","Florida St.","4","3","3","0.55000","170","69","101"
"1963","Florida St.","4","5","1","0.45000","167","93","74"
"1964","Florida St.","9","1","1","0.86364","263","85","178"
"1965","Florida St.","4","5","1","0.45000","121","119","2"
"1966","Florida St.","6","5","0","0.54545","274","215","59"
"1967","Florida St.","7","2","2","0.72727","250","187","63"
"1968","Florida St.","8","3","0","0.72727","308","211","97"
"1969","Florida St.","6","3","1","0.65000","220","182","38"
"1970","Florida St.","7","4","0","0.63636","254","195","59"
"1971","Rice (TX)","3","7","1","0.31818","146","220","-74"
"1971","Florida St.","8","4","0","0.66667","309","174","135"
"1972","Florida St.","7","4","0","0.63636","287","224","63"
"1973","Florida St.","0","11","0","0.00000","98","331","-233"
"1959","Adams St. (CO)","8","1","0","0.88889","217","111","106"
"1960","Adams St. (CO)","7","0","1","0.93750","233","76","157"
"1961","Adams St. (CO)","8","2","0","0.80000","203","119","84"
"1962","Adams St. (CO)","9","1","0","0.90000","207","124","83"
"1963","North Dakota St.","3","5","0","0.37500","174","164","10"
"1964","North Dakota St.","10","1","0","0.90909","252","121","131"
"1965","North Dakota St.","11","0","0","1.00000","383","87","296"
"1967","Arizona","3","6","1","0.35000","162","231","-69"
"1968","Arizona","8","3","0","0.72727","186","149","37"
"1969","Western Illinois","8","2","0","0.80000","311","162","149"
"1970","Western Illinois","7","3","0","0.70000","308","183","125"
"1971","Western Illinois","8","2","0","0.80000","213","158","55"
"1972","Western Illinois","9","2","0","0.81818","272","191","81"
"1973","Western Illinois","7","4","0","0.63636","258","187","71"
"1974","Florida St.","1","10","0","0.09091","130","289","-159"
"1975","Florida St.","3","8","0","0.27273","187","213","-26"
"1978","Eastern Illinois","12","2","0","0.85714","454","253","201"
"1979","Eastern Illinois","7","4","0","0.63636","302","170","132"
"1980","Eastern Illinois","11","3","0","0.78571","441","238","203"
"1981","Eastern Illinois","6","5","0","0.54545","250","228","22"
"1982","Eastern Illinois","11","1","1","0.88462","338","130","208"
"1983","Northern Iowa","6","5","0","0.54545","228","248","-20"
"1984","Northern Iowa","9","2","0","0.81818","366","169","197"
"1985","Northern Iowa","11","2","0","0.84615","392","212","180"
"1986","Northern Iowa","7","3","1","0.68182","347","221","126"
"1987","Northern Iowa","10","4","0","0.71429","463","305","158"
"1959","Samford (AL)","9","1","0","0.90000","226","79","147"
"1960","Samford (AL)","8","1","0","0.88889","297","58","239"
"1961","Samford (AL)","7","2","0","0.77778","320","76","244"
"1962","Samford (AL)","7","2","0","0.77778","214","98","116"
"1970","West Virginia","8","3","0","0.72727","311","200","111"
"1971","West Virginia","7","4","0","0.63636","280","220","60"
"1972","West Virginia","8","4","0","0.66667","415","289","126"
"1973","West Virginia","6","5","0","0.54545","212","266","-54"
"1974","West Virginia","4","7","0","0.36364","210","224","-14"
"1975","West Virginia","9","3","0","0.75000","283","189","94"
"1976","Florida St.","5","6","0","0.45455","205","258","-53"
"1977","Florida St.","10","2","0","0.83333","314","170","144"
"1978","Florida St.","8","3","0","0.72727","312","208","104"
"1979","Florida St.","11","1","0","0.91667","326","160","166"
"1980","Florida St.","10","2","0","0.83333","369","103","266"
"1981","Florida St.","6","5","0","0.54545","240","286","-46"
"1982","Florida St.","9","3","0","0.75000","419","254","165"
"1983","Florida St.","8","4","0","0.66667","381","312","69"
"1984","Florida St.","7","3","2","0.66667","406","254","152"
"1985","Florida St.","9","3","0","0.75000","402","258","144"
"1986","Florida St.","7","4","1","0.62500","393","218","175"
"1987","Florida St.","11","1","0","0.91667","481","163","318"
"1988","Florida St.","11","1","0","0.91667","455","172","283"
"1989","Florida St.","10","2","0","0.83333","424","199","225"
"1990","Florida St.","10","2","0","0.83333","459","206","253"
"1991","Florida St.","11","2","0","0.84615","449","188","261"
"1992","Florida St.","11","1","0","0.91667","446","186","260"
"1993","Florida St.","12","1","0","0.92308","536","129","407"
"1994","Florida St.","10","1","1","0.87500","428","200","228"
"1995","Florida St.","10","2","0","0.83333","563","246","317"
"1996","Florida St.","11","1","0","0.91667","446","174","272"
"1997","Florida St.","11","1","0","0.91667","468","181","287"
"1998","Florida St.","11","2","0","0.84615","401","161","240"
"1999","Florida St.","12","0","0","1.00000","458","203","255"
"2000","Florida St.","11","2","0","0.84615","511","136","375"
"2001","Florida St.","8","4","0","0.66667","403","304","99"
"2002","Florida St.","9","5","0","0.64286","428","301","127"
"2003","Florida St.","10","3","0","0.76923","419","217","202"
"2004","Florida St.","9","3","0","0.75000","302","169","133"
"2005","Florida St.","8","5","0","0.61538","376","286","90"
"2006","Florida St.","2","6","0","0.25000","345","258","87"
"2007","Florida St.","0","6","0","0.00000","303","298","5"
"2008","Florida St.","9","4","0","0.69231","434","262","172"
"2009","Florida St.","7","6","0","0.53846","391","390","1"
"2010","Florida St.","10","4","0","0.71429","439","275","164"
"2011","Florida St.","9","4","0","0.69231","398","196","202"
"2012","Florida St.","12","2","0","0.85714","550","206","344"
"2013","Florida St.","14","0","0","1.00000","723","170","553"
"1921","Fresno St. (CA)","3","5","0","0.37500","95","121","-26"
"1922","Fresno St. (CA)","7","1","2","0.80000","126","29","97"
"1923","Fresno St. (CA)","7","2","0","0.77778","211","108","103"
"1924","Fresno St. (CA)","7","2","0","0.77778","132","44","88"
"1925","Fresno St. (CA)","2","6","1","0.27778","122","192","-70"
"1926","Fresno St. (CA)","5","3","1","0.61111","140","107","33"
"1927","Fresno St. (CA)","3","3","2","0.50000","52","90","-38"
"1928","Fresno St. (CA)","2","5","1","0.31250","56","188","-132"
"1919","North Dakota St.","5","1","1","0.78571","52","60","-8"
"1920","North Dakota St.","2","3","1","0.41667","54","82","-28"
"1921","North Dakota St.","3","3","1","0.50000","70","106","-36"
"1923","North Dakota St.","2","4","1","0.35714","38","63","-25"
"1924","North Dakota St.","5","3","0","0.62500","106","61","45"
"1929","Fresno St. (CA)","1","7","0","0.12500","40","250","-210"
"1930","Fresno St. (CA)","8","0","0","1.00000","154","66","88"
"1931","Fresno St. (CA)","4","6","0","0.40000","98","123","-25"
"1932","Fresno St. (CA)","3","5","2","0.40000","56","91","-35"
"1933","Fresno St. (CA)","5","4","0","0.55556","98","71","27"
"1934","Fresno St. (CA)","7","2","1","0.75000","225","77","148"
"1935","Fresno St. (CA)","6","3","0","0.66667","199","84","115"
"1936","Fresno St. (CA)","5","3","1","0.61111","152","91","61"
"1937","Fresno St. (CA)","8","1","1","0.85000","223","75","148"
"1938","Fresno St. (CA)","7","3","0","0.70000","224","99","125"
"1939","Fresno St. (CA)","10","1","0","0.90909","244","98","146"
"1940","Fresno St. (CA)","9","2","1","0.79167","132","52","80"
"1941","Fresno St. (CA)","4","3","2","0.55556","118","90","28"
"1942","Fresno St. (CA)","9","1","0","0.90000","362","45","317"
"1946","Fresno St. (CA)","8","4","0","0.66667","177","129","48"
"1944","Fresno St. (CA)","0","6","0","0.00000","18","95","-77"
"1947","Fresno St. (CA)","3","6","2","0.36364","133","236","-103"
"1948","Fresno St. (CA)","3","6","1","0.35000","108","267","-159"
"1945","Fresno St. (CA)","4","6","2","0.41667","113","92","21"
"1949","Fresno St. (CA)","3","8","0","0.27273","156","344","-188"
"1950","Fresno St. (CA)","2","6","1","0.27778","131","231","-100"
"1951","Fresno St. (CA)","5","5","0","0.50000","199","189","10"
"1952","Fresno St. (CA)","8","2","0","0.80000","331","233","98"
"1953","Fresno St. (CA)","4","4","2","0.50000","255","198","57"
"1954","Fresno St. (CA)","7","3","0","0.70000","214","165","49"
"1955","Fresno St. (CA)","9","1","0","0.90000","273","110","163"
"1956","Fresno St. (CA)","8","2","0","0.80000","249","124","125"
"1957","Fresno St. (CA)","5","5","0","0.50000","164","183","-19"
"1958","Fresno St. (CA)","5","5","0","0.50000","147","206","-59"
"1959","Fresno St. (CA)","7","3","0","0.70000","226","146","80"
"1960","Fresno St. (CA)","9","1","0","0.90000","298","98","200"
"1961","Fresno St. (CA)","10","0","0","1.00000","292","125","167"
"1962","Fresno St. (CA)","7","3","0","0.70000","318","116","202"
"1963","Fresno St. (CA)","4","6","0","0.40000","208","242","-34"
"1964","Fresno St. (CA)","4","6","0","0.40000","212","204","8"
"1965","Fresno St. (CA)","6","4","0","0.60000","191","116","75"
"1973","Utah St.","7","4","0","0.63636","220","202","18"
"1974","Utah St.","8","3","0","0.72727","181","199","-18"
"1975","Utah St.","6","5","0","0.54545","193","240","-47"
"1966","Fresno St. (CA)","7","3","0","0.70000","158","214","-56"
"1967","Fresno St. (CA)","3","8","0","0.27273","240","267","-27"
"1968","Fresno St. (CA)","7","4","0","0.63636","269","226","43"
"1969","Fresno St. (CA)","6","4","0","0.60000","237","227","10"
"1970","Fresno St. (CA)","8","4","0","0.66667","289","273","16"
"1971","Fresno St. (CA)","6","5","0","0.54545","215","165","50"
"1972","Fresno St. (CA)","6","4","1","0.59091","237","158","79"
"1973","San Jose St. (CA)","5","4","2","0.54545","193","173","20"
"1974","San Jose St. (CA)","8","3","1","0.70833","323","199","124"
"1975","San Jose St. (CA)","9","2","0","0.81818","291","152","139"
"1976","Michigan St.","4","6","1","0.40909","236","278","-42"
"1977","Michigan St.","7","3","1","0.68182","260","162","98"
"1978","Michigan St.","8","3","0","0.72727","411","170","241"
"1979","Michigan St.","5","6","0","0.45455","240","253","-13"
"1980","Arizona St.","7","4","0","0.63636","311","216","95"
"1981","Arizona St.","9","2","0","0.81818","394","193","201"
"1982","Arizona St.","10","2","0","0.83333","294","145","149"
"1983","Arizona St.","6","4","1","0.59091","320","200","120"
"1984","Arizona St.","5","6","0","0.45455","297","203","94"
"1973","Fresno St. (CA)","2","9","0","0.18182","148","286","-138"
"1974","Fresno St. (CA)","5","7","0","0.41667","250","206","44"
"1975","Fresno St. (CA)","3","8","0","0.27273","219","274","-55"
"1978","Fresno St. (CA)","3","8","0","0.27273","247","329","-82"
"1979","Fresno St. (CA)","4","7","0","0.36364","245","302","-57"
"1963","Montana St.","6","3","0","0.66667","195","89","106"
"1964","Montana St.","7","4","0","0.63636","223","111","112"
"1965","Montana St.","3","7","0","0.30000","119","185","-66"
"1966","Montana St.","8","3","0","0.72727","401","162","239"
"1967","Montana St.","7","3","0","0.70000","228","151","77"
"1968","Washington St.","3","6","1","0.35000","189","188","1"
"1969","Washington St.","1","9","0","0.10000","143","339","-196"
"1970","Washington St.","1","10","0","0.09091","231","460","-229"
"1971","Washington St.","4","7","0","0.36364","246","286","-40"
"1972","Washington St.","7","4","0","0.63636","274","241","33"
"1973","Washington St.","5","6","0","0.45455","250","290","-40"
"1974","Washington St.","2","9","0","0.18182","162","272","-110"
"1975","Washington St.","3","8","0","0.27273","262","295","-33"
"1976","Fresno St. (CA)","6","5","0","0.54545","237","165","72"
"1977","Fresno St. (CA)","9","2","0","0.81818","354","163","191"
"1980","Fresno St. (CA)","5","6","0","0.45455","192","245","-53"
"1981","Fresno St. (CA)","5","6","0","0.45455","264","299","-35"
"1982","Fresno St. (CA)","11","1","0","0.91667","381","228","153"
"1983","Fresno St. (CA)","6","5","0","0.54545","242","214","28"
"1984","Fresno St. (CA)","6","6","0","0.50000","293","253","40"
"1985","Fresno St. (CA)","11","0","1","0.95833","481","209","272"
"1986","Fresno St. (CA)","9","2","0","0.81818","302","150","152"
"1987","Fresno St. (CA)","6","5","0","0.54545","260","179","81"
"1988","Fresno St. (CA)","10","2","0","0.83333","393","169","224"
"1989","Fresno St. (CA)","11","1","0","0.91667","441","220","221"
"1990","Fresno St. (CA)","8","2","1","0.77273","346","230","116"
"1991","Fresno St. (CA)","10","2","0","0.83333","507","235","272"
"1992","Fresno St. (CA)","9","4","0","0.69231","510","364","146"
"1993","Fresno St. (CA)","8","4","0","0.66667","467","350","117"
"1994","Fresno St. (CA)","5","7","1","0.42308","376","426","-50"
"1995","Fresno St. (CA)","5","7","0","0.41667","371","387","-16"
"1996","Fresno St. (CA)","4","7","0","0.36364","267","344","-77"
"1997","Fresno St. (CA)","6","6","0","0.50000","318","288","30"
"1998","Fresno St. (CA)","5","6","0","0.45455","265","225","40"
"1999","Fresno St. (CA)","8","5","0","0.61538","413","282","131"
"2000","Fresno St. (CA)","7","5","0","0.58333","317","251","66"
"2001","Fresno St. (CA)","11","3","0","0.78571","560","344","216"
"2002","Fresno St. (CA)","9","5","0","0.64286","378","379","-1"
"2003","Fresno St. (CA)","9","5","0","0.64286","322","317","5"
"2004","Fresno St. (CA)","9","3","0","0.75000","482","253","229"
"2005","Fresno St. (CA)","8","5","0","0.61538","491","292","199"
"2006","Fresno St. (CA)","4","8","0","0.33333","276","339","-63"
"2007","Fresno St. (CA)","9","4","0","0.69231","427","351","76"
"2008","Fresno St. (CA)","7","6","0","0.53846","385","404","-19"
"2009","Fresno St. (CA)","8","5","0","0.61538","440","369","71"
"2010","Fresno St. (CA)","8","5","0","0.61538","377","390","-13"
"2011","Fresno St. (CA)","4","9","0","0.30769","371","457","-86"
"2011","Texas A&M","1","0","0","1.00000","33","22","11"
"2012","Fresno St. (CA)","9","4","0","0.69231","493","310","183"
"2013","Fresno St. (CA)","11","2","0","0.84615","564","394","170"
"1891","Georgia","1","1","0","0.50000","50","10","40"
"1893","Georgia","2","2","1","0.50000","52","71","-19"
"1890","Syracuse (NY)","8","3","0","0.72727","140","84","56"
"1894","Georgia","5","1","0","0.83333","156","20","136"
"1895","Iowa St.","3","5","0","0.37500","108","56","52"
"1896","Georgia","4","0","0","1.00000","86","22","64"
"1897","Cornell (NY)","5","3","1","0.61111","133","42","91"
"1898","Cornell (NY)","10","2","0","0.83333","296","29","267"
"1899","Carlisle Indian School (PA)","9","2","0","0.81818","365","50","315"
"1900","Carlisle Indian School (PA)","6","4","1","0.59091","212","92","120"
"1901","Carlisle Indian School (PA)","5","7","1","0.42308","133","168","-35"
"1902","Carlisle Indian School (PA)","8","3","0","0.72727","251","51","200"
"1903","Carlisle Indian School (PA)","11","2","1","0.82143","274","52","222"
"1904","Cornell (NY)","7","3","0","0.70000","226","92","134"
"1905","Cornell (NY)","6","4","0","0.60000","173","59","114"
"1906","Cornell (NY)","8","1","2","0.81818","237","37","200"
"1907","Carlisle Indian School (PA)","10","1","0","0.90909","267","62","205"
"1908","Carlisle Indian School (PA)","10","2","1","0.80769","222","55","167"
"1909","Carlisle Indian School (PA)","8","3","1","0.70833","243","94","149"
"1910","Carlisle Indian School (PA)","8","6","0","0.57143","235","69","166"
"1911","Carlisle Indian School (PA)","11","1","0","0.91667","298","49","249"
"1912","Carlisle Indian School (PA)","12","1","1","0.89286","503","120","383"
"1913","Carlisle Indian School (PA)","10","1","1","0.87500","296","63","233"
"1914","Carlisle Indian School (PA)","5","9","1","0.36667","125","174","-49"
"1915","Pittsburgh (PA)","8","0","0","1.00000","247","19","228"
"1916","Pittsburgh (PA)","8","0","0","1.00000","255","25","230"
"1917","Pittsburgh (PA)","10","0","0","1.00000","260","21","239"
"1918","Pittsburgh (PA)","4","1","0","0.80000","140","16","124"
"1919","Pittsburgh (PA)","6","2","1","0.72222","119","66","53"
"1920","Pittsburgh (PA)","6","0","2","0.87500","146","44","102"
"1921","Pittsburgh (PA)","5","3","1","0.61111","133","51","82"
"1922","Pittsburgh (PA)","8","2","0","0.80000","190","43","147"
"1923","Pittsburgh (PA)","5","4","0","0.55556","83","39","44"
"1924","Stanford (CA)","7","1","1","0.83333","179","69","110"
"1925","Stanford (CA)","7","2","0","0.77778","231","71","160"
"1926","Stanford (CA)","10","0","1","0.95455","268","73","195"
"1927","Stanford (CA)","8","2","1","0.77273","162","82","80"
"1928","Stanford (CA)","8","3","1","0.70833","274","69","205"
"1929","Stanford (CA)","9","2","0","0.81818","288","53","235"
"1930","Stanford (CA)","9","1","1","0.86364","252","69","183"
"1931","Stanford (CA)","7","2","2","0.72727","160","44","116"
"1932","Stanford (CA)","6","4","1","0.59091","171","58","113"
"1933","Temple (PA)","5","3","0","0.62500","110","96","14"
"1934","Temple (PA)","7","1","2","0.80000","220","57","163"
"1935","Temple (PA)","7","3","0","0.70000","181","68","113"
"1936","Temple (PA)","6","3","2","0.63636","117","66","51"
"1937","Temple (PA)","3","2","4","0.55556","38","59","-21"
"1938","Temple (PA)","3","6","1","0.35000","97","170","-73"
"1897","Georgia","2","1","0","0.66667","56","17","39"
"1898","Georgia","4","2","0","0.66667","70","70","0"
"1909","Boston College (MA)","3","4","1","0.43750","71","42","29"
"1897","Mercer (GA)","0","1","1","0.25000","0","26","-26"
"1899","Georgia","2","3","1","0.41667","44","22","22"
"1900","Georgia","2","4","0","0.33333","28","159","-131"
"1901","Georgia","1","5","2","0.25000","21","171","-150"
"1902","Georgia","4","2","1","0.64286","55","52","3"
"1903","Georgia","3","4","0","0.42857","65","98","-33"
"1905","Georgia","1","5","0","0.16667","26","188","-162"
"1904","Georgia","1","5","0","0.16667","69","68","1"
"1905","George Washington (DC)","3","4","2","0.44444","45","128","-83"
"1906","Georgia","2","4","1","0.35714","59","50","9"
"1907","Georgia","4","3","1","0.56250","103","47","56"
"1908","Georgia","5","2","1","0.68750","71","45","26"
"1909","Virginia Tech","6","1","0","0.85714","148","27","121"
"1910","Virginia Tech","6","2","0","0.75000","109","18","91"
"1911","North Carolina","6","1","1","0.81250","66","31","35"
"1912","Virginia Tech","5","4","0","0.55556","202","92","110"
"1913","Virginia Tech","7","1","1","0.83333","175","60","115"
"1914","Virginia Tech","6","2","1","0.72222","143","33","110"
"1915","Virginia Tech","4","4","0","0.50000","91","109","-18"
"1920","Louisiana St.","5","3","1","0.61111","206","63","143"
"1921","Louisiana St.","6","1","1","0.81250","180","56","124"
"1925","South Carolina","7","3","0","0.70000","150","27","123"
"1926","South Carolina","6","4","0","0.60000","159","62","97"
"1928","William & Mary (VA)","6","3","2","0.63636","218","54","164"
"1929","William & Mary (VA)","8","2","0","0.80000","250","77","173"
"1930","William & Mary (VA)","7","2","1","0.75000","247","39","208"
"1936","William & Mary (VA)","1","8","0","0.11111","51","112","-61"
"1937","William & Mary (VA)","4","5","0","0.44444","129","103","26"
"1938","William & Mary (VA)","3","7","0","0.30000","105","154","-49"
"1909","Georgia","2","4","2","0.37500","19","48","-29"
"1910","Georgia","6","2","1","0.72222","281","52","229"
"1911","Georgia","7","1","1","0.83333","147","25","122"
"1912","Georgia","6","1","1","0.81250","151","80","71"
"1913","Georgia","6","2","0","0.75000","243","55","188"
"1914","Georgia","3","5","1","0.38889","120","126","-6"
"1915","Georgia","5","2","2","0.66667","245","27","218"
"1916","Georgia","6","3","0","0.66667","121","58","63"
"1919","Georgia","4","2","3","0.61111","85","27","58"
"1915","Beloit (WI)","0","6","1","0.07143","0","112","-112"
"1916","Monmouth (IL)","5","2","1","0.68750","136","90","46"
"1917","Monmouth (IL)","4","3","1","0.56250","129","85","44"
"1920","Georgia","8","0","1","0.94444","250","17","233"
"1921","Georgia","7","2","1","0.75000","161","31","130"
"1922","Georgia","5","4","1","0.55000","178","77","101"
"1923","Georgia","5","3","1","0.61111","74","120","-46"
"1924","Georgia","7","3","0","0.70000","129","61","68"
"1925","Georgia","4","5","0","0.44444","133","91","42"
"1926","Georgia","5","4","0","0.55556","135","115","20"
"1927","Georgia","9","1","0","0.90000","248","38","210"
"1928","Georgia","4","5","0","0.44444","122","113","9"
"1929","Georgia","6","4","0","0.60000","155","97","58"
"1930","Georgia","7","2","1","0.75000","185","71","114"
"1931","Georgia","8","2","0","0.80000","201","118","83"
"1932","Georgia","2","5","2","0.33333","122","116","6"
"1933","Georgia","8","2","0","0.80000","148","86","62"
"1934","Georgia","7","3","0","0.70000","141","56","85"
"1935","Georgia","6","4","0","0.60000","169","88","81"
"1936","Georgia","5","4","1","0.55000","115","159","-44"
"1937","Georgia","6","3","2","0.63636","151","64","87"
"1938","Mississippi","9","2","0","0.81818","232","120","112"
"1939","Mississippi","7","2","0","0.77778","230","64","166"
"1940","Mississippi","9","2","0","0.81818","251","100","151"
"1941","Mississippi","6","2","1","0.72222","131","67","64"
"1942","Mississippi","2","7","0","0.22222","132","163","-31"
"1944","Mississippi","2","6","0","0.25000","77","178","-101"
"1945","Mississippi","4","5","0","0.44444","100","183","-83"
"1938","Georgia","5","4","1","0.55000","145","143","2"
"1939","Wyoming","0","7","1","0.06250","47","241","-194"
"1939","Georgia","5","6","0","0.45455","113","98","15"
"1940","Georgia","5","4","1","0.55000","209","134","75"
"1941","Georgia","9","1","1","0.86364","319","85","234"
"1942","Georgia","11","1","0","0.91667","376","76","300"
"1943","Georgia","6","4","0","0.60000","264","153","111"
"1944","Georgia","7","3","0","0.70000","273","130","143"
"1945","Georgia","9","2","0","0.81818","314","100","214"
"1946","Georgia","11","0","0","1.00000","392","110","282"
"1947","Georgia","7","4","1","0.62500","212","135","77"
"1948","Georgia","9","2","0","0.81818","306","141","165"
"1949","Georgia","4","6","1","0.40909","177","134","43"
"1950","Georgia","6","3","3","0.62500","178","105","73"
"1951","Georgia","5","5","0","0.50000","176","184","-8"
"1952","Georgia","7","4","0","0.63636","226","208","18"
"1953","Georgia","3","8","0","0.27273","155","250","-95"
"1954","Georgia","6","3","1","0.65000","89","89","0"
"1955","Georgia","4","6","0","0.40000","173","170","3"
"1956","Georgia","3","6","1","0.35000","66","162","-96"
"1957","Georgia","3","7","0","0.30000","93","150","-57"
"1958","Georgia","4","6","0","0.40000","196","114","82"
"1959","Georgia","10","1","0","0.90909","228","89","139"
"1960","Georgia","6","4","0","0.60000","174","118","56"
"1961","Georgia","3","7","0","0.30000","84","177","-93"
"1962","Georgia","3","4","3","0.45000","109","174","-65"
"1963","Georgia","4","5","1","0.45000","133","151","-18"
"1964","Georgia","7","3","1","0.68182","130","98","32"
"1965","Georgia","6","4","0","0.60000","186","158","28"
"1966","Georgia","10","1","0","0.90909","235","98","137"
"1967","Georgia","7","4","0","0.63636","257","119","138"
"1968","Georgia","8","1","2","0.81818","284","114","170"
"1969","Georgia","5","5","1","0.50000","218","146","72"
"1970","Georgia","5","5","0","0.50000","242","153","89"
"1971","Georgia","11","1","0","0.91667","360","115","245"
"1972","Georgia","7","4","0","0.63636","174","163","11"
"1973","Georgia","7","4","1","0.62500","224","166","58"
"1974","Georgia","6","6","0","0.50000","327","285","42"
"1975","Georgia","9","3","0","0.75000","299","197","102"
"1976","Georgia","10","2","0","0.83333","327","145","182"
"1977","Georgia","5","6","0","0.45455","157","191","-34"
"1978","Georgia","9","2","1","0.79167","290","187","103"
"1979","Georgia","6","5","0","0.54545","206","189","17"
"1980","Georgia","12","0","0","1.00000","333","137","196"
"1981","Georgia","10","2","0","0.83333","372","122","250"
"1982","Georgia","11","1","0","0.91667","338","160","178"
"1983","Georgia","10","1","1","0.87500","274","158","116"
"1984","Georgia","7","4","1","0.62500","263","230","33"
"1985","Georgia","7","3","2","0.66667","297","171","126"
"1986","Georgia","8","4","0","0.66667","309","233","76"
"1987","Georgia","9","3","0","0.75000","311","204","107"
"1988","Georgia","9","3","0","0.75000","358","212","146"
"1989","Georgia","6","6","0","0.50000","251","198","53"
"1990","Georgia","4","7","0","0.36364","185","293","-108"
"1991","Georgia","9","3","0","0.75000","336","219","117"
"1992","Georgia","10","2","0","0.83333","373","155","218"
"1993","Georgia","5","6","0","0.45455","328","289","39"
"1994","Georgia","6","4","1","0.59091","351","283","68"
"1995","Georgia","6","6","0","0.50000","260","281","-21"
"1990","Marshall (WV)","6","5","0","0.54545","310","162","148"
"1991","Marshall (WV)","11","4","0","0.73333","506","257","249"
"1992","Marshall (WV)","12","3","0","0.80000","604","292","312"
"1993","Marshall (WV)","11","4","0","0.73333","414","206","208"
"1994","Marshall (WV)","12","2","0","0.85714","560","212","348"
"1995","Marshall (WV)","12","3","0","0.80000","492","240","252"
"1996","Georgia","5","6","0","0.45455","230","257","-27"
"1997","Georgia","10","2","0","0.83333","380","195","185"
"1998","Georgia","9","3","0","0.75000","292","222","70"
"1999","Georgia","8","4","0","0.66667","336","310","26"
"2000","Georgia","8","4","0","0.66667","331","212","119"
"2001","Georgia","8","4","0","0.66667","331","228","103"
"2002","Georgia","13","1","0","0.92857","450","212","238"
"2003","Georgia","11","3","0","0.78571","371","203","168"
"2004","Georgia","10","2","0","0.83333","335","198","137"
"2005","Georgia","10","3","0","0.76923","384","213","171"
"2006","Georgia","9","4","0","0.69231","327","229","98"
"2007","Georgia","11","2","0","0.84615","424","262","162"
"2008","Georgia","10","3","0","0.76923","409","319","90"
"2009","Georgia","8","5","0","0.61538","376","337","39"
"2010","Georgia","6","7","0","0.46154","417","287","130"
"2011","Georgia","10","4","0","0.71429","448","288","160"
"2012","Georgia","12","2","0","0.85714","529","275","254"
"2013","Georgia","8","5","0","0.61538","477","377","100"
"1980","Georgia Tech","1","9","1","0.13636","113","260","-147"
"1981","Georgia Tech","1","10","0","0.09091","124","309","-185"
"1982","Georgia Tech","6","5","0","0.54545","239","286","-47"
"1983","Georgia Tech","3","8","0","0.27273","222","313","-91"
"1984","Georgia Tech","6","4","1","0.59091","296","201","95"
"1985","Georgia Tech","9","2","1","0.79167","252","132","120"
"1986","Georgia Tech","5","5","1","0.50000","282","211","71"
"1987","Alabama","7","5","0","0.58333","268","213","55"
"1988","Alabama","9","3","0","0.75000","317","188","129"
"1989","Alabama","10","2","0","0.83333","357","217","140"
"1990","Kentucky","4","7","0","0.36364","228","316","-88"
"1991","Kentucky","3","8","0","0.27273","190","268","-78"
"1992","Kentucky","4","7","0","0.36364","207","280","-73"
"1993","Kentucky","6","6","0","0.50000","220","209","11"
"1994","Kentucky","1","10","0","0.09091","149","405","-256"
"1995","Kentucky","4","7","0","0.36364","223","269","-46"
"1996","Kentucky","4","7","0","0.36364","138","322","-184"
"2010","Georgia St.","6","5","0","0.54545","302","286","16"
"2011","Georgia St.","3","8","0","0.27273","249","343","-94"
"2012","Georgia St.","1","10","0","0.09091","191","424","-233"
"2008","Indiana St.","0","12","0","0.00000","101","508","-407"
"2009","Indiana St.","1","10","0","0.09091","99","390","-291"
"2010","Indiana St.","6","5","0","0.54545","351","328","23"
"2011","Indiana St.","6","5","0","0.54545","315","300","15"
"2012","Indiana St.","7","4","0","0.63636","254","157","97"
"2013","Georgia St.","0","12","0","0.00000","225","440","-215"
"1892","Georgia Tech","0","3","0","0.00000","16","58","-42"
"1893","Georgia Tech","2","1","1","0.62500","38","18","20"
"1894","Georgia Tech","0","3","0","0.00000","0","136","-136"
"1898","Georgia Tech","0","3","0","0.00000","6","67","-61"
"1899","Georgia Tech","0","5","0","0.00000","5","184","-179"
"1869","Rutgers (NJ)","2","2","0","0.50000","18","18","0"
"1870","Rutgers (NJ)","2","2","0","0.50000","17","17","0"
"1872","Columbia (NY)","5","4","0","0.55556","22","16","6"
"1873","Rutgers (NJ)","7","4","1","0.62500","31","26","5"
"1874","Harvard (MA)","9","7","0","0.56250","54","41","13"
"1875","Harvard (MA)","12","6","2","0.65000","52","29","23"
"1876","Harvard (MA)","13","8","1","0.61364","45","29","16"
"1877","Harvard (MA)","9","7","3","0.55263","31","21","10"
"1878","Pennsylvania","14","9","5","0.58929","42","24","18"
"1879","Harvard (MA)","13","9","12","0.55882","46","27","19"
"1880","Harvard (MA)","18","11","4","0.60606","75","53","22"
"1881","Rutgers (NJ)","22","18","8","0.54167","70","47","23"
"1882","Rutgers (NJ)","41","28","2","0.59155","176","111","65"
"1883","Rutgers (NJ)","38","32","1","0.54225","1288","965","323"
"1884","Pennsylvania","47","29","5","0.61111","1728","1184","544"
"1885","Michigan","34","17","4","0.65455","1437","612","825"
"1886","Lehigh (PA)","48","21","4","0.68493","1850","637","1213"
"1887","California","67","35","3","0.65238","2660","935","1725"
"1888","Princeton (NJ)","70","56","6","0.55303","2468","1899","569"
"1889","Brown (RI)","82","51","11","0.60764","2879","1796","1083"
"1890","Brown (RI)","77","76","9","0.50309","3002","2455","547"
"1891","Southern California","94","76","13","0.54918","2813","2189","624"
"1892","Minnesota","93","80","9","0.53571","2972","2394","578"
"1893","Duke (NC)","79","94","9","0.45879","2176","2912","-736"
"1894","Colorado St.","50","62","4","0.44828","1161","1518","-357"
"1895","Boston (MA)","31","44","11","0.42442","692","1031","-339"
"1896","Rhode Island","54","62","12","0.46875","1126","1201","-75"
"1897","Boston (MA)","32","40","6","0.44872","792","785","7"
"1898","Miami (OH)","47","23","4","0.66216","921","644","277"
"1899","New Hampshire","33","32","6","0.50704","571","522","49"
"1900","New Hampshire","22","35","11","0.40441","442","686","-244"
"1901","Marshall (WV)","18","34","3","0.35455","302","917","-615"
"1902","Saint John's (MN)","9","22","4","0.31429","148","460","-312"
"1903","Wichita St. (KS)","14","25","2","0.36585","376","546","-170"
"1904","Oklahoma St.","11","14","1","0.44231","194","394","-200"
"1905","Miami (OH)","7","25","5","0.25676","245","494","-249"
"1906","Rensselaer Tech (NY)","3","7","4","0.35714","92","107","-15"
"1907","Marshall (WV)","5","10","2","0.35294","71","238","-167"
"1908","Fort Hays St. (KS)","5","6","1","0.45833","56","91","-35"
"1909","Fort Hays St. (KS)","1","3","1","0.30000","12","68","-56"
"1910","Texas St.","0","1","0","0.00000","0","19","-19"
"1912","Fort Hays St. (KS)","1","2","0","0.33333","20","132","-112"
"1913","Eureka (IL)","1","6","0","0.14286","39","203","-164"
"1914","Eureka (IL)","3","4","0","0.42857","57","201","-144"
"1915","Texas St.","1","1","1","0.50000","13","20","-7"
"1916","Texas St.","0","2","1","0.16667","0","106","-106"
"1917","Boston (MA)","4","4","0","0.50000","73","136","-63"
"1918","Monmouth (IL)","1","7","0","0.12500","26","137","-111"
"1930","Troy (AL)","1","2","0","0.33333","7","73","-66"
"2013","Grambling St. (LA)","0","1","0","0.00000","0","0","0"
"1901","Georgia Tech","4","0","1","0.90000","97","5","92"
"1900","North Carolina St.","0","5","0","0.00000","7","69","-62"
"1901","North Carolina St.","1","2","0","0.33333","27","75","-48"
"1902","Georgia Tech","0","6","2","0.12500","23","122","-99"
"1893","Akron (OH)","5","2","0","0.71429","276","82","194"
"1894","Akron (OH)","1","0","0","1.00000","12","6","6"
"1895","Auburn (AL)","2","1","0","0.66667","70","15","55"
"1896","Auburn (AL)","3","1","0","0.75000","135","18","117"
"1897","Auburn (AL)","2","0","1","0.83333","40","4","36"
"1898","Auburn (AL)","2","1","0","0.66667","47","47","0"
"1899","Auburn (AL)","3","1","1","0.70000","148","11","137"
"1900","Clemson (SC)","6","0","0","1.00000","222","10","212"
"1901","Clemson (SC)","3","1","1","0.70000","190","38","152"
"1902","Clemson (SC)","6","1","0","0.85714","152","22","130"
"1903","Clemson (SC)","4","1","1","0.75000","167","22","145"
"1904","Georgia Tech","8","1","1","0.85000","287","34","253"
"1905","Georgia Tech","7","0","1","0.93750","233","33","200"
"1906","Georgia Tech","6","3","1","0.65000","140","69","71"
"1907","Georgia Tech","4","4","0","0.50000","148","100","48"
"1908","Georgia Tech","6","3","0","0.66667","147","74","73"
"1909","Georgia Tech","7","2","0","0.77778","217","44","173"
"1910","Georgia Tech","5","3","0","0.62500","197","50","147"
"1911","Georgia Tech","6","2","1","0.72222","150","21","129"
"1912","Georgia Tech","5","3","1","0.61111","100","86","14"
"1913","Georgia Tech","7","2","0","0.77778","250","43","207"
"1914","Georgia Tech","6","2","0","0.75000","206","40","166"
"1915","Georgia Tech","7","0","1","0.93750","233","24","209"
"1916","Georgia Tech","8","0","1","0.94444","421","20","401"
"1917","Georgia Tech","9","0","0","1.00000","491","17","474"
"1918","Georgia Tech","6","1","0","0.85714","466","32","434"
"1919","Georgia Tech","7","3","0","0.70000","256","33","223"
"1920","Pennsylvania","6","4","0","0.60000","167","133","34"
"1921","Pennsylvania","4","3","2","0.55556","164","135","29"
"1922","Pennsylvania","6","3","0","0.66667","100","44","56"
"1924","Rice (TX)","4","4","0","0.50000","85","70","15"
"1925","Rice (TX)","4","4","1","0.50000","85","79","6"
"1926","Rice (TX)","4","4","1","0.50000","84","81","3"
"1927","Rice (TX)","2","6","1","0.27778","64","160","-96"
"1920","Georgia Tech","8","1","0","0.88889","312","16","296"
"1921","Georgia Tech","8","1","0","0.88889","360","56","304"
"1922","Georgia Tech","7","2","0","0.77778","157","59","98"
"1923","Georgia Tech","3","2","4","0.55556","75","82","-7"
"1924","Georgia Tech","5","3","1","0.61111","82","78","4"
"1925","Georgia Tech","6","2","1","0.72222","102","48","54"
"1926","Georgia Tech","4","5","0","0.44444","87","87","0"
"1927","Georgia Tech","8","1","1","0.85000","125","39","86"
"1928","Georgia Tech","10","0","0","1.00000","221","47","174"
"1929","Georgia Tech","3","6","0","0.33333","105","138","-33"
"1930","Georgia Tech","2","6","1","0.27778","79","185","-106"
"1931","Georgia Tech","2","7","1","0.25000","98","207","-109"
"1932","Georgia Tech","4","5","1","0.45000","114","105","9"
"1933","Georgia Tech","5","5","0","0.50000","117","63","54"
"1934","Georgia Tech","1","9","0","0.10000","56","187","-131"
"1935","Georgia Tech","5","5","0","0.50000","163","142","21"
"1936","Georgia Tech","5","5","1","0.50000","251","103","148"
"1937","Georgia Tech","6","3","1","0.65000","177","54","123"
"1938","Georgia Tech","3","4","3","0.45000","72","84","-12"
"1939","Georgia Tech","8","2","0","0.80000","150","56","94"
"1940","Georgia Tech","3","7","0","0.30000","139","160","-21"
"1941","Georgia Tech","3","6","0","0.33333","82","130","-48"
"1942","Georgia Tech","9","2","0","0.81818","219","87","132"
"1943","Georgia Tech","8","3","0","0.72727","300","142","158"
"1944","Georgia Tech","8","3","0","0.72727","253","101","152"
"1945","Georgia Tech","4","6","0","0.40000","157","165","-8"
"1946","Georgia Tech","9","2","0","0.81818","284","127","157"
"1947","Georgia Tech","10","1","0","0.90909","240","49","191"
"1948","Georgia Tech","7","3","0","0.70000","226","69","157"
"1949","Georgia Tech","7","3","0","0.70000","197","129","68"
"1950","Georgia Tech","5","6","0","0.45455","182","193","-11"
"1951","Georgia Tech","11","0","1","0.95833","295","90","205"
"1952","Georgia Tech","12","0","0","1.00000","325","59","266"
"1953","Georgia Tech","9","2","1","0.79167","288","111","177"
"1954","Georgia Tech","8","3","0","0.72727","189","97","92"
"1955","Georgia Tech","9","1","1","0.86364","189","46","143"
"1956","Georgia Tech","10","1","0","0.90909","248","47","201"
"1957","Georgia Tech","4","4","2","0.50000","75","71","4"
"1958","Georgia Tech","5","4","1","0.55000","93","91","2"
"1959","Georgia Tech","6","5","0","0.54545","136","121","15"
"1960","Georgia Tech","5","5","0","0.50000","118","97","21"
"1961","Georgia Tech","7","4","0","0.63636","177","80","97"
"1962","Georgia Tech","7","3","1","0.68182","211","97","114"
"1963","Georgia Tech","7","3","0","0.70000","173","89","84"
"1964","Georgia Tech","7","3","0","0.70000","121","79","42"
"1965","Georgia Tech","7","3","1","0.68182","253","171","82"
"1966","Georgia Tech","9","2","0","0.81818","260","108","152"
"1967","Georgia Tech","4","6","0","0.40000","129","205","-76"
"1968","Georgia Tech","4","6","0","0.40000","158","263","-105"
"1969","Georgia Tech","4","6","0","0.40000","144","183","-39"
"1970","Georgia Tech","9","3","0","0.75000","233","165","68"
"1971","Georgia Tech","6","6","0","0.50000","207","207","0"
"1972","Georgia Tech","7","4","1","0.62500","284","226","58"
"1973","Georgia Tech","5","6","0","0.45455","192","211","-19"
"1967","Kansas","5","5","0","0.50000","166","146","20"
"1968","Kansas","9","2","0","0.81818","394","190","204"
"1969","Kansas","1","9","0","0.10000","176","290","-114"
"1970","Kansas","5","6","0","0.45455","270","277","-7"
"1971","UCLA","2","7","1","0.25000","166","243","-77"
"1972","UCLA","8","3","0","0.72727","351","239","112"
"1973","UCLA","9","2","0","0.81818","470","199","271"
"1974","Georgia Tech","6","5","0","0.54545","238","212","26"
"1975","Georgia Tech","7","4","0","0.63636","270","200","70"
"1976","Georgia Tech","4","6","1","0.40909","221","267","-46"
"1977","Georgia Tech","6","5","0","0.54545","224","221","3"
"1978","Georgia Tech","7","5","0","0.58333","270","253","17"
"1979","Georgia Tech","4","6","1","0.40909","152","190","-38"
"1980","Georgia Tech","1","9","1","0.13636","113","260","-147"
"1981","Georgia Tech","1","10","0","0.09091","124","309","-185"
"1982","Georgia Tech","6","5","0","0.54545","239","286","-47"
"1983","Georgia Tech","3","8","0","0.27273","222","313","-91"
"1984","Georgia Tech","6","4","1","0.59091","296","201","95"
"1985","Georgia Tech","9","2","1","0.79167","252","132","120"
"1986","Georgia Tech","5","5","1","0.50000","282","211","71"
"1987","Alabama","7","5","0","0.58333","268","213","55"
"1988","Alabama","9","3","0","0.75000","317","188","129"
"1989","Alabama","10","2","0","0.83333","357","217","140"
"1990","Kentucky","4","7","0","0.36364","228","316","-88"
"1991","Kentucky","3","8","0","0.27273","190","268","-78"
"1992","Kentucky","4","7","0","0.36364","207","280","-73"
"1993","Kentucky","6","6","0","0.50000","220","209","11"
"1994","Kentucky","1","10","0","0.09091","149","405","-256"
"1995","Kentucky","4","7","0","0.36364","223","269","-46"
"1996","Kentucky","4","7","0","0.36364","138","322","-184"
"2010","Georgia St.","6","5","0","0.54545","302","286","16"
"2011","Georgia St.","3","8","0","0.27273","249","343","-94"
"2012","Georgia St.","1","10","0","0.09091","191","424","-233"
"1973","Citadel (SC)","3","8","0","0.27273","137","250","-113"
"1974","Citadel (SC)","4","7","0","0.36364","216","248","-32"
"1975","Citadel (SC)","6","5","0","0.54545","144","97","47"
"1976","Citadel (SC)","6","5","0","0.54545","171","176","-5"
"1977","Citadel (SC)","5","6","0","0.45455","133","162","-29"
"1982","Maryland","8","4","0","0.66667","373","220","153"
"1983","Maryland","8","4","0","0.66667","316","253","63"
"1984","Maryland","9","3","0","0.75000","380","280","100"
"1985","Maryland","9","3","0","0.75000","326","192","134"
"1986","Maryland","5","5","1","0.50000","262","211","51"
"1987","Georgia Tech","2","9","0","0.18182","199","275","-76"
"1988","Georgia Tech","3","8","0","0.27273","200","194","6"
"1989","Georgia Tech","7","4","0","0.63636","265","213","52"
"1990","Georgia Tech","11","0","1","0.95833","379","186","193"
"1991","Georgia Tech","8","5","0","0.61538","283","214","69"
"2004","Army (NY)","2","9","0","0.18182","260","388","-128"
"2005","Army (NY)","4","7","0","0.36364","220","294","-74"
"2006","Army (NY)","3","9","0","0.25000","232","335","-103"
"1977","Wyoming","4","6","1","0.40909","166","273","-107"
"1978","Wyoming","5","7","0","0.41667","253","245","8"
"1979","Wyoming","4","8","0","0.33333","186","276","-90"
"1989","East Carolina (NC)","6","5","0","0.54545","301","286","15"
"1990","East Carolina (NC)","5","6","0","0.45455","254","267","-13"
"1991","East Carolina (NC)","11","1","0","0.91667","409","277","132"
"1992","Georgia Tech","5","6","0","0.45455","237","286","-49"
"1993","Georgia Tech","5","6","0","0.45455","260","286","-26"
"1994","Georgia Tech","1","7","0","0.12500","152","231","-79"
"1994","Georgia Tech","0","3","0","0.00000","33","88","-55"
"1995","Georgia Tech","6","5","0","0.54545","260","243","17"
"1996","Georgia Tech","5","6","0","0.45455","220","236","-16"
"1997","Georgia Tech","7","5","0","0.58333","314","296","18"
"1998","Georgia Tech","10","2","0","0.83333","426","295","131"
"1999","Georgia Tech","8","4","0","0.66667","461","361","100"
"2000","Georgia Tech","9","3","0","0.75000","386","237","149"
"2001","Georgia Tech","7","5","0","0.58333","381","267","114"
"2004","Central Florida","0","11","0","0.00000","175","362","-187"
"2005","Central Florida","8","5","0","0.61538","373","373","0"
"2006","Central Florida","4","8","0","0.33333","232","345","-113"
"2007","Central Florida","10","4","0","0.71429","502","372","130"
"2008","Central Florida","4","8","0","0.33333","199","289","-90"
"2009","Central Florida","8","5","0","0.61538","340","293","47"
"2010","Central Florida","11","3","0","0.78571","449","240","209"
"2011","Central Florida","5","7","0","0.41667","325","220","105"
"2012","Central Florida","10","4","0","0.71429","496","309","187"
"2013","Central Florida","12","1","0","0.92308","450","277","173"
"2001","Georgia Tech","1","0","0","1.00000","24","14","10"
"1983","Troy (AL)","7","4","0","0.63636","263","226","37"
"1984","Troy (AL)","12","1","0","0.92308","372","185","187"
"1993","Samford (AL)","5","6","0","0.45455","191","255","-64"
"2002","Georgia Tech","7","6","0","0.53846","280","267","13"
"2003","Georgia Tech","7","6","0","0.53846","274","266","8"
"2004","Georgia Tech","7","5","0","0.58333","264","227","37"
"2005","Georgia Tech","7","5","0","0.58333","222","241","-19"
"2006","Georgia Tech","9","5","0","0.64286","349","257","92"
"2007","Georgia Tech","7","5","0","0.58333","313","231","82"
"2007","Georgia Tech","0","1","0","0.00000","28","40","-12"
"1997","Georgia Southern","10","3","0","0.76923","423","229","194"
"1998","Georgia Southern","14","1","0","0.93333","654","363","291"
"1999","Georgia Southern","13","2","0","0.86667","747","262","485"
"2000","Georgia Southern","13","2","0","0.86667","506","274","232"
"2001","Georgia Southern","12","2","0","0.85714","525","215","310"
"2002","Navy (MD)","2","10","0","0.16667","290","436","-146"
"2003","Navy (MD)","8","5","0","0.61538","396","283","113"
"2004","Navy (MD)","10","2","0","0.83333","334","238","96"
"2005","Navy (MD)","8","4","0","0.66667","410","313","97"
"2006","Navy (MD)","9","4","0","0.69231","367","261","106"
"2007","Navy (MD)","8","4","0","0.66667","479","438","41"
"2008","Georgia Tech","9","4","0","0.69231","317","264","53"
"2009","Georgia Tech","10","3","0","0.76923","473","347","126"
"2010","Georgia Tech","6","7","0","0.46154","338","328","10"
"2011","Georgia Tech","8","5","0","0.61538","446","339","107"
"2012","Georgia Tech","7","7","0","0.50000","470","396","74"
"2013","Georgia Tech","7","6","0","0.53846","456","297","159"
"1909","Hawaii","2","2","0","0.50000","16","39","-23"
"1910","Hawaii","4","2","0","0.66667","79","16","63"
"1911","Hawaii","2","2","0","0.50000","32","49","-17"
"1915","Hawaii","5","1","1","0.78571","121","36","85"
"1916","Hawaii","3","2","1","0.58333","79","41","38"
"1917","Hawaii","4","0","1","0.90000","88","6","82"
"1918","Hawaii","3","1","0","0.75000","62","47","15"
"1919","Hawaii","4","0","1","0.90000","138","21","117"
"1920","Hawaii","6","2","0","0.75000","158","31","127"
"1921","Hawaii","3","3","2","0.50000","67","114","-47"
"1922","Hawaii","5","1","1","0.78571","216","25","191"
"1923","Hawaii","5","1","2","0.75000","172","52","120"
"1924","Hawaii","8","0","0","1.00000","185","12","173"
"1925","Hawaii","10","0","0","1.00000","421","17","404"
"1926","Hawaii","5","4","0","0.55556","311","62","249"
"1927","Hawaii","5","2","0","0.71429","109","61","48"
"1928","Hawaii","2","5","0","0.28571","121","109","12"
"1929","Hawaii","4","3","0","0.57143","88","66","22"
"1930","Hawaii","5","2","0","0.71429","145","85","60"
"1931","Hawaii","3","2","1","0.58333","76","66","10"
"1932","Hawaii","2","1","1","0.62500","32","28","4"
"1933","Hawaii","4","3","0","0.57143","73","86","-13"
"1934","Hawaii","6","0","0","1.00000","142","21","121"
"1935","Hawaii","5","3","0","0.62500","127","105","22"
"1936","Hawaii","3","5","0","0.37500","82","109","-27"
"1937","Hawaii","2","6","0","0.25000","85","199","-114"
"1938","Hawaii","4","4","0","0.50000","128","113","15"
"1939","Hawaii","3","6","0","0.33333","107","167","-60"
"1940","Hawaii","2","5","0","0.28571","115","137","-22"
"1941","Hawaii","8","1","0","0.88889","193","83","110"
"1946","Hawaii","8","2","0","0.80000","275","93","182"
"1947","Hawaii","8","5","0","0.61538","294","240","54"
"1948","Hawaii","7","4","1","0.62500","366","289","77"
"1949","Hawaii","6","3","0","0.66667","362","210","152"
"1950","Hawaii","5","4","2","0.54545","290","256","34"
"1951","Hawaii","4","7","0","0.36364","226","292","-66"
"1952","Hawaii","5","5","2","0.50000","285","280","5"
"1953","Hawaii","5","6","0","0.45455","189","216","-27"
"1954","Hawaii","4","4","0","0.50000","133","178","-45"
"1955","Hawaii","8","3","0","0.72727","187","166","21"
"1956","Hawaii","7","3","0","0.70000","291","113","178"
"1957","Hawaii","4","4","1","0.50000","152","96","56"
"1958","Hawaii","5","7","0","0.41667","139","260","-121"
"1959","Hawaii","3","6","0","0.33333","100","174","-74"
"1960","Hawaii","3","7","0","0.30000","113","200","-87"
"1961","Hawaii","5","3","1","0.61111","184","111","73"
"1962","Hawaii","6","2","0","0.75000","112","63","49"
"1963","Hawaii","5","5","0","0.50000","160","167","-7"
"1964","Hawaii","4","5","0","0.44444","104","131","-27"
"1915","Tulane (LA)","4","4","0","0.50000","118","78","40"
"1916","Tulane (LA)","4","3","1","0.56250","126","149","-23"
"1917","Tulane (LA)","5","3","0","0.62500","159","105","54"
"1918","Tulane (LA)","4","1","1","0.75000","133","16","117"
"1919","Tulane (LA)","6","2","1","0.72222","224","55","169"
"1920","Tulane (LA)","6","2","1","0.72222","181","28","153"
"1922","Tulane (LA)","4","4","0","0.50000","136","100","36"
"1923","Tulane (LA)","6","3","1","0.65000","117","89","28"
"1924","Tulane (LA)","8","1","0","0.88889","201","59","142"
"1925","Tulane (LA)","9","0","1","0.95000","246","23","223"
"1926","Tulane (LA)","3","5","1","0.38889","71","60","11"
"1927","Loyola (LA)","6","2","2","0.70000","130","41","89"
"1928","Loyola (LA)","7","3","0","0.70000","220","85","135"
"1929","Loyola (LA)","4","5","2","0.45455","150","129","21"
"1930","Loyola (LA)","9","1","0","0.90000","217","52","165"
"1931","Loyola (LA)","5","4","0","0.55556","154","91","63"
"1932","Loyola (LA)","6","4","1","0.59091","134","77","57"
"1933","Chicago (IL)","3","3","2","0.50000","118","56","62"
"1934","Chicago (IL)","4","4","0","0.50000","113","106","7"
"1935","Chicago (IL)","4","4","0","0.50000","102","110","-8"
"1936","Chicago (IL)","2","5","1","0.31250","68","166","-98"
"1937","Chicago (IL)","1","6","0","0.14286","45","143","-98"
"1938","Chicago (IL)","1","6","1","0.18750","75","241","-166"
"1939","Chicago (IL)","2","6","0","0.25000","37","308","-271"
"1940","Stanford (CA)","10","0","0","1.00000","196","85","111"
"1941","Stanford (CA)","6","3","0","0.66667","160","95","65"
"1942","Maryland","7","2","0","0.77778","198","124","74"
"1943","Pittsburgh (PA)","3","5","0","0.37500","114","180","-66"
"1944","Pittsburgh (PA)","4","5","0","0.44444","147","293","-146"
"1945","Pittsburgh (PA)","3","7","0","0.30000","87","141","-54"
"1946","Maryland","3","6","0","0.33333","136","193","-57"
"1965","Hawaii","1","8","1","0.15000","85","227","-142"
"1945","Washington St.","6","2","1","0.72222","157","70","87"
"1946","Washington St.","1","6","1","0.18750","118","147","-29"
"1947","Washington St.","3","7","0","0.30000","93","148","-55"
"1948","Washington St.","4","5","1","0.45000","164","219","-55"
"1949","Washington St.","3","6","0","0.33333","149","205","-56"
"1966","Hawaii","4","6","0","0.40000","110","245","-135"
"1967","Hawaii","6","4","0","0.60000","205","118","87"
"1969","Northwood (TX)","2","8","0","0.20000","127","251","-124"
"1970","Northwood (TX)","6","5","0","0.54545","226","188","38"
"1963","Eastern Washington","3","6","0","0.33333","108","129","-21"
"1964","Eastern Washington","5","4","0","0.55556","141","99","42"
"1965","Eastern Washington","8","1","0","0.88889","268","84","184"
"1966","Eastern Washington","7","1","1","0.83333","326","135","191"
"1967","Eastern Washington","11","1","0","0.91667","409","168","241"
"1968","Hawaii","7","3","0","0.70000","312","199","113"
"1969","Hawaii","6","3","1","0.65000","313","235","78"
"1970","Hawaii","9","2","0","0.81818","276","149","127"
"1971","Hawaii","7","4","0","0.63636","255","225","30"
"1972","Hawaii","8","3","0","0.72727","282","214","68"
"1973","Hawaii","9","2","0","0.81818","205","152","53"
"1974","Hawaii","6","5","0","0.54545","175","211","-36"
"1975","Hawaii","6","5","0","0.54545","180","201","-21"
"1976","Hawaii","3","8","0","0.27273","154","377","-223"
"1977","Hawaii","5","6","0","0.45455","250","233","17"
"1978","Hawaii","6","5","0","0.54545","251","280","-29"
"1979","Hawaii","6","5","0","0.54545","330","213","117"
"1980","Hawaii","8","3","0","0.72727","260","212","48"
"1981","Hawaii","9","2","0","0.81818","328","130","198"
"1982","Hawaii","6","5","0","0.54545","240","230","10"
"1983","Hawaii","5","5","1","0.50000","251","236","15"
"1984","Hawaii","7","4","0","0.63636","217","181","36"
"1985","Hawaii","4","6","2","0.41667","269","262","7"
"1986","Hawaii","7","5","0","0.58333","238","235","3"
"1987","Arizona","4","4","3","0.50000","263","220","43"
"1988","Arizona","7","4","0","0.63636","279","218","61"
"1989","Arizona","8","4","0","0.66667","248","178","70"
"1990","Arizona","7","5","0","0.58333","267","311","-44"
"1991","Arizona","4","7","0","0.36364","248","361","-113"
"1992","Arizona","6","5","1","0.54167","232","118","114"
"1993","Arizona","10","2","0","0.83333","294","161","133"
"1994","Arizona","8","4","0","0.66667","278","190","88"
"1995","Arizona","6","5","0","0.54545","207","199","8"
"1996","Arizona","5","6","0","0.45455","310","280","30"
"1997","Arizona","7","5","0","0.58333","317","312","5"
"1998","Arizona","12","1","0","0.92308","439","236","203"
"1999","Arizona","6","6","0","0.50000","339","364","-25"
"2000","Arizona","5","6","0","0.45455","254","237","17"
"2005","San Jose St. (CA)","3","8","0","0.27273","248","357","-109"
"2006","San Jose St. (CA)","9","4","0","0.69231","324","270","54"
"2007","San Jose St. (CA)","5","7","0","0.41667","245","352","-107"
"2008","San Jose St. (CA)","6","6","0","0.50000","224","259","-35"
"2009","San Jose St. (CA)","2","10","0","0.16667","165","414","-249"
"1987","Hawaii","5","7","0","0.41667","337","299","38"
"1988","Hawaii","9","3","0","0.75000","383","283","100"
"1989","Hawaii","9","3","1","0.73077","470","281","189"
"1990","Hawaii","7","5","0","0.58333","374","257","117"
"1991","Hawaii","4","7","1","0.37500","335","388","-53"
"1992","Hawaii","11","2","0","0.84615","421","317","104"
"1993","Hawaii","6","6","0","0.50000","393","357","36"
"1994","Hawaii","3","8","1","0.29167","260","273","-13"
"1995","Hawaii","4","8","0","0.33333","285","401","-116"
"1996","Hawaii","2","10","0","0.16667","161","433","-272"
"1997","Hawaii","3","9","0","0.25000","189","308","-119"
"1998","Hawaii","0","12","0","0.00000","149","422","-273"
"1999","Hawaii","9","4","0","0.69231","371","349","22"
"2000","Hawaii","3","9","0","0.25000","294","399","-105"
"2001","Hawaii","9","3","0","0.75000","483","318","165"
"2002","Hawaii","10","4","0","0.71429","502","389","113"
"2003","Hawaii","9","5","0","0.64286","486","427","59"
"2004","Hawaii","8","5","0","0.61538","467","499","-32"
"2005","Hawaii","5","7","0","0.41667","368","428","-60"
"2006","Hawaii","11","3","0","0.78571","656","337","319"
"2007","Hawaii","12","1","0","0.92308","564","331","233"
"2008","Southern Methodist (TX)","1","11","0","0.08333","256","458","-202"
"2009","Southern Methodist (TX)","8","5","0","0.61538","380","359","21"
"2010","Southern Methodist (TX)","7","7","0","0.50000","360","359","1"
"2011","Southern Methodist (TX)","8","5","0","0.61538","336","300","36"
"2012","Southern Methodist (TX)","7","6","0","0.53846","397","334","63"
"2013","Southern Methodist (TX)","5","7","0","0.41667","321","400","-79"
"2008","Hawaii","7","7","0","0.50000","345","404","-59"
"2009","Hawaii","6","7","0","0.46154","296","383","-87"
"2010","Hawaii","10","4","0","0.71429","554","357","197"
"2011","Hawaii","6","7","0","0.46154","409","378","31"
"2012","Hawaii","3","9","0","0.25000","254","428","-174"
"2013","Hawaii","1","11","0","0.08333","329","465","-136"
"1946","Houston (TX)","4","6","0","0.40000","140","136","4"
"1947","Houston (TX)","3","8","0","0.27273","95","214","-119"
"1948","Houston (TX)","5","6","0","0.45455","149","182","-33"
"1949","Houston (TX)","5","4","1","0.55000","229","169","60"
"1950","Houston (TX)","4","6","0","0.40000","233","190","43"
"1951","Houston (TX)","6","5","0","0.54545","247","228","19"
"1952","Houston (TX)","8","2","0","0.80000","180","80","100"
"1953","Houston (TX)","4","4","1","0.50000","189","185","4"
"1954","Houston (TX)","5","5","0","0.50000","125","203","-78"
"1951","Kansas St.","0","9","0","0.00000","73","228","-155"
"1952","Kansas St.","1","9","0","0.10000","81","255","-174"
"1953","Kansas St.","6","3","1","0.65000","198","116","82"
"1954","Kansas St.","7","3","0","0.70000","191","154","37"
"1955","Houston (TX)","6","4","0","0.60000","176","139","37"
"1956","Houston (TX)","7","2","1","0.75000","185","90","95"
"1957","Southern Methodist (TX)","4","5","1","0.45000","127","175","-48"
"1958","Southern Methodist (TX)","6","4","0","0.60000","203","134","69"
"1959","Southern Methodist (TX)","5","4","1","0.55000","147","133","14"
"1960","Southern Methodist (TX)","0","9","1","0.05000","31","221","-190"
"1961","Southern Methodist (TX)","2","7","1","0.25000","92","191","-99"
"1968","Utah","3","7","0","0.30000","162","234","-72"
"1969","Utah","8","2","0","0.80000","231","107","124"
"1970","Utah","6","4","0","0.60000","208","176","32"
"1971","Utah","3","8","0","0.27273","244","315","-71"
"1972","Utah","6","5","0","0.54545","354","336","18"
"1973","Utah","7","5","0","0.58333","385","344","41"
"1952","Colgate (NY)","6","3","0","0.66667","195","107","88"
"1953","Colgate (NY)","3","4","2","0.44444","147","161","-14"
"1954","Colgate (NY)","5","2","2","0.66667","141","117","24"
"1955","Colgate (NY)","6","3","0","0.66667","164","107","57"
"1956","Colgate (NY)","4","5","0","0.44444","201","214","-13"
"1957","Houston (TX)","5","4","1","0.55000","113","141","-28"
"1958","Houston (TX)","5","4","0","0.55556","209","161","48"
"1959","Houston (TX)","3","7","0","0.30000","105","170","-65"
"1960","Houston (TX)","6","4","0","0.60000","141","150","-9"
"1961","Houston (TX)","5","4","1","0.55000","144","138","6"
"1962","Colgate (NY)","3","5","1","0.38889","97","134","-37"
"1963","Colgate (NY)","3","4","1","0.43750","75","147","-72"
"1964","Colgate (NY)","7","2","0","0.77778","135","52","83"
"1965","Colgate (NY)","6","3","1","0.65000","128","109","19"
"1966","Colgate (NY)","8","1","1","0.85000","242","67","175"
"1967","Colgate (NY)","2","8","0","0.20000","121","181","-60"
"1962","Houston (TX)","7","4","0","0.63636","198","171","27"
"1963","Houston (TX)","2","8","0","0.20000","149","208","-59"
"1964","Houston (TX)","2","6","1","0.27778","115","174","-59"
"1965","Houston (TX)","4","5","1","0.45000","159","174","-15"
"1966","Houston (TX)","8","2","0","0.80000","335","125","210"
"1967","Houston (TX)","7","3","0","0.70000","322","122","200"
"1968","Houston (TX)","6","2","2","0.70000","425","154","271"
"1969","Houston (TX)","9","2","0","0.81818","422","208","214"
"1970","Houston (TX)","8","3","0","0.72727","307","160","147"
"1971","Houston (TX)","9","3","0","0.75000","339","199","140"
"1972","Houston (TX)","6","4","1","0.59091","325","202","123"
"1973","Houston (TX)","11","1","0","0.91667","363","142","221"
"1974","Houston (TX)","8","3","1","0.70833","280","185","95"
"1975","Houston (TX)","2","8","0","0.20000","185","245","-60"
"1976","Houston (TX)","10","2","0","0.83333","343","188","155"
"1977","Houston (TX)","6","5","0","0.54545","282","259","23"
"1978","Houston (TX)","9","3","0","0.75000","364","213","151"
"1979","Houston (TX)","11","1","0","0.91667","295","135","160"
"1980","Houston (TX)","7","5","0","0.58333","236","190","46"
"1981","Houston (TX)","7","4","1","0.62500","238","174","64"
"1982","Houston (TX)","5","5","1","0.50000","215","262","-47"
"1983","Houston (TX)","4","7","0","0.36364","225","294","-69"
"1984","Houston (TX)","7","5","0","0.58333","266","267","-1"
"1985","Houston (TX)","4","7","0","0.36364","253","339","-86"
"1986","Houston (TX)","1","10","0","0.09091","125","267","-142"
"1987","Houston (TX)","4","6","1","0.40909","284","292","-8"
"1988","Houston (TX)","9","3","0","0.75000","474","219","255"
"1989","Houston (TX)","9","2","0","0.81818","589","150","439"
"1990","Houston (TX)","10","1","0","0.90909","511","303","208"
"1991","Houston (TX)","4","7","0","0.36364","353","344","9"
"1992","Houston (TX)","4","7","0","0.36364","378","386","-8"
"1993","Houston (TX)","1","9","1","0.13636","171","392","-221"
"1994","Houston (TX)","1","10","0","0.09091","115","402","-287"
"1995","Houston (TX)","2","9","0","0.18182","188","360","-172"
"1996","Houston (TX)","7","5","0","0.58333","361","341","20"
"1997","Houston (TX)","3","8","0","0.27273","216","410","-194"
"1998","Houston (TX)","3","8","0","0.27273","254","317","-63"
"1999","Houston (TX)","7","4","0","0.63636","254","211","43"
"1997","Wyoming","7","6","0","0.53846","322","227","95"
"1998","Wyoming","8","3","0","0.72727","222","215","7"
"1999","Wyoming","7","4","0","0.63636","302","270","32"
"2000","Houston (TX)","3","8","0","0.27273","211","370","-159"
"2001","Houston (TX)","0","11","0","0.00000","190","432","-242"
"2002","Houston (TX)","5","7","0","0.41667","320","393","-73"
"2003","Houston (TX)","7","6","0","0.53846","448","468","-20"
"2004","Houston (TX)","3","8","0","0.27273","230","354","-124"
"2005","Houston (TX)","6","6","0","0.50000","337","324","13"
"2006","Houston (TX)","10","4","0","0.71429","462","329","133"
"2007","Houston (TX)","8","4","0","0.66667","436","359","77"
"2008","Baylor (TX)","4","8","0","0.33333","336","352","-16"
"2009","Baylor (TX)","4","8","0","0.33333","249","327","-78"
"2010","Baylor (TX)","7","6","0","0.53846","405","396","9"
"2011","Baylor (TX)","10","3","0","0.76923","589","484","105"
"2012","Baylor (TX)","8","5","0","0.61538","578","484","94"
"2013","Baylor (TX)","11","2","0","0.84615","681","306","375"
"2007","Houston (TX)","0","1","0","0.00000","13","20","-7"
"2008","Houston (TX)","8","5","0","0.61538","528","402","126"
"2009","Houston (TX)","10","4","0","0.71429","591","421","170"
"2010","Houston (TX)","5","7","0","0.41667","452","386","66"
"2011","Houston (TX)","12","1","0","0.92308","660","300","360"
"2012","Texas A&M","11","2","0","0.84615","578","283","295"
"2013","Texas A&M","9","4","0","0.69231","575","419","156"
"2011","Houston (TX)","1","0","0","1.00000","30","14","16"
"2012","Houston (TX)","5","7","0","0.41667","389","432","-43"
"2013","Houston (TX)","8","5","0","0.61538","431","283","148"
"1872","Stevens Tech (NJ)","0","1","0","0.00000","0","6","-6"
"1873","New York (NY)","3","3","0","0.50000","15","13","2"
"1874","Stevens Tech (NJ)","2","3","0","0.40000","10","20","-10"
"1875","Stevens Tech (NJ)","4","4","0","0.50000","21","20","1"
"1876","New York (NY)","2","3","1","0.41667","16","19","-3"
"1877","Stevens Tech (NJ)","3","1","2","0.66667","9","14","-5"
"1878","Stevens Tech (NJ)","3","3","3","0.50000","3","9","-6"
"1879","Stevens Tech (NJ)","2","3","5","0.45000","8","14","-6"
"1880","Stevens Tech (NJ)","1","5","0","0.16667","3","16","-13"
"1881","Stevens Tech (NJ)","3","8","3","0.32143","16","29","-13"
"1882","Lawrence (WI)","7","8","1","0.46875","17","25","-8"
"1883","Stevens Tech (NJ)","7","6","1","0.53571","187","128","59"
"1884","Fordham (NY)","9","10","0","0.47368","221","261","-40"
"1885","Georgetown (DC)","5","17","1","0.23913","359","612","-253"
"1886","New York (NY)","9","15","2","0.38462","180","565","-385"
"1887","Fordham (NY)","8","12","1","0.40476","157","445","-288"
"1888","Amherst (MA)","6","17","3","0.28846","192","791","-599"
"1889","New York (NY)","8","21","4","0.30303","278","647","-369"
"1890","New York (NY)","25","14","2","0.63415","727","538","189"
"1891","Delaware","32","30","7","0.51449","966","971","-5"
"1892","Beloit (WI)","29","31","3","0.48413","726","797","-71"
"1893","Marquette (WI)","39","34","3","0.53289","1091","885","206"
"1894","Manhattan (NY)","32","29","7","0.52206","853","692","161"
"1895","Delaware","44","35","6","0.55294","889","813","76"
"1896","Manhattan (NY)","51","49","6","0.50943","949","1164","-215"
"1897","Stevens Tech (NJ)","37","50","4","0.42857","661","1048","-387"
"1898","Manhattan (NY)","37","43","9","0.46629","781","1050","-269"
"1899","Manhattan (NY)","34","40","6","0.46250","594","1063","-469"
"1900","Manhattan (NY)","43","47","11","0.48020","991","1049","-58"
"1901","Ferris St. (MI)","51","44","7","0.53431","906","852","54"
"1902","Indiana St.","56","48","5","0.53670","1053","927","126"
"1903","Manhattan (NY)","30","49","7","0.38953","762","1319","-557"
"1904","Saint Francis (NY)","44","53","9","0.45755","787","1363","-576"
"1905","Bluffton (OH)","38","59","5","0.39706","850","1433","-583"
"1906","Ferris St. (MI)","32","43","12","0.43678","677","854","-177"
"1907","Ferris St. (MI)","32","48","10","0.41111","722","1208","-486"
"1908","Western Illinois","36","45","10","0.45055","760","1069","-309"
"1909","Delaware Valley (PA)","27","52","2","0.34568","682","1287","-605"
"1910","East Stroudsburg (PA)","23","31","3","0.42982","583","738","-155"
"1911","Western Illinois","32","44","7","0.42771","661","902","-241"
"1912","Indiana (PA)","36","56","7","0.39899","1134","1463","-329"
"1913","Saint Francis (NY)","52","67","8","0.44094","1672","2360","-688"
"1914","Delaware Valley (PA)","41","50","6","0.45361","1217","1585","-368"
"1915","Western Illinois","34","35","11","0.49375","932","1217","-285"
"1916","Morgan St. (MD)","44","43","7","0.50532","1493","1270","223"
"1917","Morgan St. (MD)","21","21","2","0.50000","408","883","-475"
"1918","Oklahoma Baptist University","7","16","2","0.32000","258","358","-100"
"1919","Western Illinois","53","41","8","0.55882","1478","1056","422"
"1920","Virginia Union","28","39","2","0.42029","506","893","-387"
"1921","Cooper Union (NY)","19","34","3","0.36607","441","1112","-671"
"1922","Cooper Union (NY)","27","34","6","0.44776","703","832","-129"
"1923","Cooper Union (NY)","31","45","2","0.41026","718","1112","-394"
"1924","East Stroudsburg (PA)","34","40","6","0.46250","946","1175","-229"
"1925","Saint Anselm (NH)","32","28","10","0.52857","847","802","45"
"1926","Saint Anselm (NH)","22","30","4","0.42857","515","702","-187"
"1927","Bethune-Cookman (FL)","20","29","8","0.42105","674","783","-109"
"1928","Saint Anselm (NH)","28","24","7","0.53390","564","1095","-531"
"1929","Saint Anselm (NH)","25","32","5","0.44355","616","843","-227"
"1930","Saint Anselm (NH)","31","27","10","0.52941","643","549","94"
"1931","Campbell (NC)","21","17","4","0.54762","465","428","37"
"1932","Campbell (NC)","7","30","3","0.21250","254","760","-506"
"1933","Campbell (NC)","11","13","3","0.46296","262","324","-62"
"1934","Bowie St. (MD)","4","7","2","0.38462","116","94","22"
"1935","Florida Southern","7","12","1","0.37500","170","162","8"
"1936","Bowie St. (MD)","5","2","1","0.68750","154","97","57"
"1937","Bowie St. (MD)","6","3","0","0.66667","98","87","11"
"1938","West Alabama","7","5","0","0.58333","151","88","63"
"1939","Elizabeth City St. (NC)","7","13","0","0.35000","150","307","-157"
"1940","Elizabeth City St. (NC)","6","5","4","0.53333","128","67","61"
"1941","Arkansas-Pine Bluff","3","9","5","0.32353","178","223","-45"
"1942","Brevard College (NC)","10","6","2","0.61111","225","189","36"
"1943","Clark Atlanta (GA)","6","8","0","0.42857","127","206","-79"
"1944","Abilene Christian (TX)","9","11","1","0.45238","158","255","-97"
"1945","Benedict (SC)","10","15","2","0.40741","299","296","3"
"1946","Elizabeth City St. (NC)","7","20","3","0.28333","144","540","-396"
"1947","Clark Atlanta (GA)","3","6","2","0.36364","49","230","-181"
"1948","Virginia-Lynchburg","4","6","1","0.40909","77","302","-225"
"1949","Virginia-Lynchburg","0","3","1","0.12500","7","70","-63"
"1950","Virginia-Lynchburg","2","3","0","0.40000","53","98","-45"
"1951","Lane (TN)","8","6","0","0.57143","295","234","61"
"1952","Lane (TN)","9","5","1","0.63333","220","206","14"
"1953","Lane (TN)","1","7","0","0.12500","58","215","-157"
"1954","Lane (TN)","2","6","0","0.25000","105","135","-30"
"1955","Lane (TN)","2","4","0","0.33333","83","129","-46"
"1957","Louisiana College","2","7","0","0.22222","106","179","-73"
"1959","Azusa Pacific (CA)","2","3","0","0.40000","117","90","27"
"1960","Azusa Pacific (CA)","4","3","1","0.56250","103","76","27"
"1961","Azusa Pacific (CA)","3","3","0","0.50000","123","147","-24"
"1963","San Francisco (CA)","2","5","0","0.28571","58","98","-40"
"1964","New York (NY)","0","2","0","0.00000","20","48","-28"
"1965","Adelphi (NY)","4","8","0","0.33333","198","216","-18"
"1966","Fairfield (CT)","18","22","2","0.45238","545","652","-107"
"1967","La Salle (PA)","25","31","0","0.44643","846","1080","-234"
"1968","Centenary (LA)","17","42","2","0.29508","726","1393","-667"
"1969","Bluffton (OH)","33","43","0","0.43421","1058","1548","-490"
"1970","Saint John's (NY)","35","54","1","0.39444","1379","1783","-404"
"1971","Bluffton (OH)","43","45","1","0.48876","1360","1384","-24"
"1972","Marquette (WI)","39","44","2","0.47059","1217","1351","-134"
"1973","Brooklyn (NY)","30","52","1","0.36747","1007","1611","-604"
"1974","Marquette (WI)","33","36","3","0.47917","959","1169","-210"
"1975","Marquette (WI)","31","22","4","0.57895","1042","932","110"
"1976","Bluffton (OH)","23","33","1","0.41228","862","1186","-324"
"1977","Manhattan (NY)","14","28","1","0.33721","568","923","-355"
"1978","Fairfield (CT)","5","7","1","0.42308","194","203","-9"
"1979","Fairfield (CT)","7","8","0","0.46667","247","260","-13"
"1980","Westfield St. (MA)","6","5","4","0.53333","184","196","-12"
"1981","San Francisco (CA)","17","14","0","0.54839","567","498","69"
"1982","Manhattan (NY)","18","16","0","0.52941","580","644","-64"
"1983","SUNY-Stony Brook (NY)","15","11","0","0.57692","474","453","21"
"1984","Stonehill (MA)","7","12","0","0.36842","231","439","-208"
"1985","Manhattan (NY)","10","10","0","0.50000","313","316","-3"
"1986","Marquette (WI)","13","17","0","0.43333","497","564","-67"
"1987","Marquette (WI)","10","17","0","0.37037","389","487","-98"
"1988","Marquette (WI)","1","5","0","0.16667","80","125","-45"
"1989","Marquette (WI)","4","4","0","0.50000","209","151","58"
"1990","Marquette (WI)","1","7","0","0.12500","80","180","-100"
"1991","Marquette (WI)","1","5","0","0.16667","106","182","-76"
"1992","Marquette (WI)","2","5","0","0.28571","81","129","-48"
"1993","Marquette (WI)","7","1","0","0.87500","212","126","86"
"1994","Marquette (WI)","1","6","0","0.14286","125","184","-59"
"1995","Marquette (WI)","3","4","0","0.42857","141","191","-50"
"1996","Marquette (WI)","3","5","0","0.37500","139","182","-43"
"1998","Madison College (WI)","2","15","0","0.11765","221","613","-392"
"1999","Marquette (WI)","0","7","0","0.00000","110","298","-188"
"2000","Marquette (WI)","1","5","0","0.16667","60","96","-36"
"2001","Marquette (WI)","2","6","0","0.25000","144","179","-35"
"2002","Marquette (WI)","3","4","0","0.42857","127","208","-81"
"2003","Marquette (WI)","1","6","0","0.14286","71","151","-80"
"2004","Marquette (WI)","0","6","0","0.00000","53","238","-185"
"2005","Marquette (WI)","2","5","0","0.28571","92","226","-134"
"2006","Marquette (WI)","1","6","0","0.14286","62","206","-144"
"2007","Marquette (WI)","2","5","0","0.28571","140","215","-75"
"2008","Marquette (WI)","0","7","0","0.00000","61","304","-243"
"2009","Marquette (WI)","0","1","0","0.00000","0","22","-22"
"1894","Idaho","0","2","0","0.00000","6","18","-12"
"1895","Idaho","0","1","0","0.00000","4","10","-6"
"1897","Idaho","0","1","0","0.00000","4","12","-8"
"1899","Idaho","0","4","0","0.00000","6","29","-23"
"1900","Idaho","1","0","0","1.00000","12","6","6"
"1901","Idaho","3","2","1","0.58333","38","25","13"
"1902","Oregon St.","4","1","1","0.75000","157","16","141"
"1902","Idaho","1","3","1","0.30000","23","43","-20"
"1903","Idaho","4","1","0","0.80000","131","5","126"
"1904","Idaho","2","1","0","0.66667","36","12","24"
"1905","Idaho","5","0","0","1.00000","113","2","111"
"1906","Idaho","2","4","0","0.33333","47","49","-2"
"1909","Iowa","2","4","1","0.35714","58","97","-39"
"1910","Idaho","4","2","0","0.66667","112","69","43"
"1911","Idaho","4","3","0","0.57143","98","58","40"
"1912","Idaho","2","2","0","0.50000","26","34","-8"
"1913","Idaho","3","3","0","0.50000","93","56","37"
"1914","Idaho","2","3","1","0.41667","12","45","-33"
"1915","Oklahoma St.","4","5","1","0.45000","161","93","68"
"1916","Oklahoma St.","4","4","0","0.50000","290","95","195"
"1917","New Mexico St.","4","2","0","0.66667","231","75","156"
"1907","Idaho","4","1","2","0.71429","68","25","43"
"1908","Idaho","2","2","2","0.50000","85","42","43"
"1909","Idaho","3","4","0","0.42857","86","126","-40"
"1915","Idaho","1","4","1","0.25000","16","118","-102"
"1912","Alma (MI)","6","1","0","0.85714","274","40","234"
"1913","Alma (MI)","3","4","0","0.42857","133","179","-46"
"1914","Alma (MI)","1","5","1","0.21429","36","186","-150"
"1915","Alma (MI)","1","3","2","0.33333","46","208","-162"
"1916","Idaho","3","5","0","0.37500","131","139","-8"
"1917","Idaho","2","3","0","0.40000","36","62","-26"
"1903","Texas","5","1","2","0.75000","131","28","103"
"1904","Texas","6","2","0","0.75000","219","88","131"
"1905","Texas","5","4","0","0.55556","98","68","30"
"1911","New Mexico","1","3","1","0.30000","62","22","40"
"1912","New Mexico","0","4","0","0.00000","15","76","-61"
"1913","New Mexico","3","2","0","0.60000","84","27","57"
"1914","New Mexico","3","1","1","0.70000","83","33","50"
"1915","New Mexico","3","1","0","0.75000","97","6","91"
"1916","New Mexico","3","2","0","0.60000","216","70","146"
"1919","Idaho","2","3","0","0.40000","26","91","-65"
"1920","Idaho St.","3","3","0","0.50000","53","92","-39"
"1921","Idaho St.","6","2","0","0.75000","178","58","120"
"1922","Idaho St.","4","3","0","0.57143","247","54","193"
"1923","Idaho St.","3","2","1","0.58333","58","80","-22"
"1924","Idaho St.","5","2","0","0.71429","169","72","97"
"1925","Idaho St.","2","4","0","0.33333","18","46","-28"
"1926","Idaho St.","1","4","0","0.20000","14","80","-66"
"1927","Idaho St.","1","4","1","0.25000","46","88","-42"
"1915","Alabama","6","2","0","0.75000","250","51","199"
"1916","Alabama","6","3","0","0.66667","156","62","94"
"1917","Alabama","5","2","1","0.68750","168","29","139"
"1920","Idaho","4","2","0","0.66667","75","48","27"
"1921","Idaho","4","3","1","0.56250","98","68","30"
"1922","Missouri","5","3","0","0.62500","98","90","8"
"1922","Idaho","3","5","0","0.37500","74","51","23"
"1923","Idaho","5","2","1","0.68750","164","26","138"
"1924","Idaho","5","2","1","0.68750","118","32","86"
"1925","Idaho","3","5","0","0.37500","79","153","-74"
"1929","Gonzaga (WA)","4","3","0","0.57143","104","100","4"
"1924","Nevada","3","4","1","0.43750","101","125","-24"
"1926","Idaho","3","4","1","0.43750","75","75","0"
"1927","Idaho","4","1","3","0.68750","123","48","75"
"1928","Idaho","3","4","1","0.43750","93","148","-55"
"1929","Idaho","4","5","0","0.44444","168","214","-46"
"1930","Idaho","4","7","0","0.36364","154","176","-22"
"1931","Idaho","3","4","0","0.42857","75","106","-31"
"1932","Idaho","3","5","0","0.37500","114","97","17"
"1933","Idaho","4","4","0","0.50000","117","89","28"
"1934","Idaho","3","5","0","0.37500","77","120","-43"
"1935","San Diego St. (CA)","3","4","1","0.43750","56","83","-27"
"1936","San Diego St. (CA)","6","1","1","0.81250","118","62","56"
"1937","San Diego St. (CA)","7","1","0","0.87500","90","16","74"
"1938","San Diego St. (CA)","5","2","1","0.68750","82","69","13"
"1939","San Diego St. (CA)","2","7","0","0.22222","60","148","-88"
"1940","San Diego St. (CA)","5","3","1","0.61111","128","87","41"
"1941","San Diego St. (CA)","6","4","0","0.60000","105","87","18"
"1935","Idaho","2","7","0","0.22222","52","87","-35"
"1936","Idaho","3","7","0","0.30000","69","132","-63"
"1937","Idaho","4","3","1","0.56250","35","53","-18"
"1938","Idaho","6","3","1","0.65000","133","94","39"
"1939","Idaho","2","6","0","0.25000","45","131","-86"
"1940","Idaho","1","7","1","0.16667","30","214","-184"
"1919","Tulsa (OK)","8","0","1","0.94444","591","27","564"
"1920","Tulsa (OK)","10","0","1","0.95455","621","21","600"
"1921","Tulsa (OK)","6","3","0","0.66667","257","95","162"
"1922","Arkansas","4","5","0","0.44444","143","136","7"
"1923","Arkansas","7","2","1","0.75000","178","40","138"
"1924","Arkansas","7","2","1","0.75000","227","69","158"
"1925","Arkansas","4","4","1","0.50000","95","62","33"
"1926","Arkansas","5","5","0","0.50000","179","88","91"
"1927","Arkansas","8","1","0","0.88889","218","76","142"
"1928","Arkansas","7","2","0","0.77778","251","63","188"
"1929","Texas Christian","9","0","1","0.95000","249","33","216"
"1930","Texas Christian","9","2","1","0.79167","298","49","249"
"1931","Texas Christian","8","2","1","0.77273","119","41","78"
"1932","Texas Christian","10","0","1","0.95455","283","23","260"
"1933","Texas Christian","9","2","1","0.79167","208","49","159"
"1934","Ohio St.","7","1","0","0.87500","267","34","233"
"1935","Ohio St.","7","1","0","0.87500","237","57","180"
"1936","Ohio St.","5","3","0","0.62500","160","27","133"
"1937","Ohio St.","6","2","0","0.75000","125","23","102"
"1938","Ohio St.","4","3","1","0.56250","119","65","54"
"1939","Ohio St.","6","2","0","0.75000","189","64","125"
"1940","Ohio St.","4","4","0","0.50000","99","113","-14"
"1941","Idaho","4","5","0","0.44444","123","135","-12"
"1942","Idaho","3","7","0","0.30000","96","209","-113"
"1945","Idaho","1","7","0","0.12500","78","175","-97"
"1946","Idaho","1","8","0","0.11111","65","247","-182"
"1938","Arizona St.","3","6","0","0.33333","89","98","-9"
"1939","Arizona St.","8","2","1","0.77273","212","56","156"
"1940","Arizona St.","7","2","2","0.72727","198","99","99"
"1941","Arizona St.","5","5","1","0.50000","111","137","-26"
"1947","Idaho","4","4","0","0.50000","92","138","-46"
"1948","Idaho","3","6","0","0.33333","154","156","-2"
"1949","Idaho","3","5","0","0.37500","220","270","-50"
"1950","Idaho","3","5","1","0.38889","180","212","-32"
"1946","New Mexico St.","5","5","0","0.50000","155","154","1"
"1947","New Mexico St.","3","6","0","0.33333","140","169","-29"
"1951","Idaho","2","7","0","0.22222","109","182","-73"
"1952","Idaho","4","4","1","0.50000","176","143","33"
"1953","Idaho","1","8","0","0.11111","66","214","-148"
"1934","Delaware","4","3","1","0.56250","51","71","-20"
"1941","Brown (RI)","5","4","0","0.55556","102","81","21"
"1942","Brown (RI)","4","4","0","0.50000","96","114","-18"
"1943","Brown (RI)","5","3","0","0.62500","194","180","14"
"1946","George Washington (DC)","4","3","0","0.57143","107","87","20"
"1947","George Washington (DC)","1","7","1","0.16667","92","177","-85"
"1948","Toledo (OH)","5","6","0","0.45455","206","225","-19"
"1949","Toledo (OH)","6","4","0","0.60000","318","210","108"
"1954","Idaho","4","5","0","0.44444","96","153","-57"
"1955","Idaho","2","7","0","0.22222","128","174","-46"
"1956","Idaho","4","5","0","0.44444","198","215","-17"
"1957","Idaho","4","4","1","0.50000","140","108","32"
"1958","Idaho","4","5","0","0.44444","114","139","-25"
"1959","Idaho","1","9","0","0.10000","79","293","-214"
"1960","Idaho","1","9","0","0.10000","104","256","-152"
"1961","Idaho","2","7","0","0.22222","65","351","-286"
"1962","Idaho","2","6","1","0.27778","108","209","-101"
"1963","Idaho","5","4","0","0.55556","186","148","38"
"1964","Idaho","4","6","0","0.40000","144","143","1"
"1965","Oregon St.","5","5","0","0.50000","125","162","-37"
"1966","Oregon St.","7","3","0","0.70000","171","156","15"
"1967","Oregon St.","7","2","1","0.75000","187","137","50"
"1968","Oregon St.","7","3","0","0.70000","285","179","106"
"1969","Oregon St.","6","4","0","0.60000","175","148","27"
"1970","Oregon St.","6","5","0","0.54545","211","239","-28"
"1971","Oregon St.","5","6","0","0.45455","268","317","-49"
"1972","Oregon St.","2","9","0","0.18182","131","295","-164"
"1973","Oregon St.","2","9","0","0.18182","166","293","-127"
"1974","Oregon St.","3","8","0","0.27273","216","285","-69"
"1975","Oregon St.","1","10","0","0.09091","103","264","-161"
"1965","Idaho","5","5","0","0.50000","201","125","76"
"1966","Idaho","4","6","0","0.40000","182","165","17"
"1967","Idaho","4","6","0","0.40000","156","332","-176"
"1968","Idaho","5","5","0","0.50000","246","301","-55"
"1969","Idaho","2","8","0","0.20000","206","346","-140"
"1970","Idaho","4","7","0","0.36364","226","335","-109"
"1971","Idaho","8","3","0","0.72727","227","171","56"
"1972","Idaho","4","7","0","0.36364","165","278","-113"
"1973","Idaho","4","7","0","0.36364","262","319","-57"
"1974","Idaho","2","8","1","0.22727","198","280","-82"
"1975","Idaho","4","5","2","0.45455","251","316","-65"
"1976","Idaho","7","4","0","0.63636","224","236","-12"
"1977","Idaho","3","8","0","0.27273","245","365","-120"
"1978","Idaho","2","9","0","0.18182","163","401","-238"
"1979","Idaho","4","7","0","0.36364","210","268","-58"
"1980","Idaho","6","5","0","0.54545","266","228","38"
"1981","Idaho","3","8","0","0.27273","310","254","56"
"1982","Idaho","9","4","0","0.69231","397","299","98"
"1983","Idaho","8","3","0","0.72727","347","257","90"
"1984","Idaho","6","5","0","0.54545","363","283","80"
"1985","Idaho","9","3","0","0.75000","441","247","194"
"1986","Wyoming","6","6","0","0.50000","299","272","27"
"1987","Washington St.","3","7","1","0.31818","238","356","-118"
"1988","Washington St.","9","3","0","0.75000","415","303","112"
"1989","Miami (FL)","11","1","0","0.91667","426","127","299"
"1990","Miami (FL)","10","2","0","0.83333","447","184","263"
"1991","Miami (FL)","12","0","0","1.00000","386","100","286"
"1992","Miami (FL)","11","1","0","0.91667","369","161","208"
"1993","Miami (FL)","9","3","0","0.75000","331","167","164"
"1994","Miami (FL)","10","2","0","0.83333","365","143","222"
"1999","Oregon St.","7","5","0","0.58333","347","277","70"
"2000","Oregon St.","11","1","0","0.91667","400","212","188"
"2001","Oregon St.","5","6","0","0.45455","287","259","28"
"2002","Oregon St.","8","5","0","0.61538","414","267","147"
"2006","Idaho","4","8","0","0.33333","203","417","-214"
"2007","Arizona St.","10","3","0","0.76923","420","292","128"
"2008","Arizona St.","5","7","0","0.41667","274","272","2"
"2009","Arizona St.","4","8","0","0.33333","268","253","15"
"2010","Arizona St.","6","6","0","0.50000","387","300","87"
"2011","Arizona St.","6","7","0","0.46154","431","372","59"
"1986","Idaho","8","4","0","0.66667","307","244","63"
"1987","Idaho","9","3","0","0.75000","358","339","19"
"1988","Idaho","11","2","0","0.84615","392","305","87"
"1992","California","4","7","0","0.36364","284","284","0"
"1993","California","9","4","0","0.69231","411","303","108"
"1994","California","4","7","0","0.36364","212","248","-36"
"1995","California","3","8","0","0.27273","243","286","-43"
"2003","Washington","6","6","0","0.50000","312","316","-4"
"2004","Washington","1","10","0","0.09091","154","334","-180"
"1989","Idaho","9","3","0","0.75000","407","314","93"
"1990","Idaho","9","4","0","0.69231","477","342","135"
"1991","Idaho","6","5","0","0.54545","375","313","62"
"1992","Idaho","9","3","0","0.75000","466","247","219"
"1993","Idaho","11","3","0","0.78571","593","353","240"
"1994","Idaho","9","3","0","0.75000","493","289","204"
"1995","Utah St.","4","7","0","0.36364","293","287","6"
"1996","Utah St.","6","5","0","0.54545","330","339","-9"
"1997","Utah St.","6","6","0","0.50000","389","296","93"
"1998","Louisville (KY)","7","5","0","0.58333","473","435","38"
"1999","Louisville (KY)","7","5","0","0.58333","443","365","78"
"2000","Louisville (KY)","9","3","0","0.75000","405","268","137"
"2001","Louisville (KY)","11","2","0","0.84615","394","223","171"
"2002","Louisville (KY)","7","6","0","0.53846","374","319","55"
"2003","Michigan St.","8","5","0","0.61538","363","293","70"
"2004","Michigan St.","5","7","0","0.41667","353","326","27"
"2005","Michigan St.","5","6","0","0.45455","372","316","56"
"2006","Michigan St.","4","8","0","0.33333","302","341","-39"
"2012","Arkansas","4","8","0","0.33333","282","365","-83"
"2013","Fort Lewis (CO)","4","7","0","0.36364","161","334","-173"
"1995","Idaho","6","5","0","0.54545","287","209","78"
"1996","Idaho","6","5","0","0.54545","374","296","78"
"1997","Idaho","5","6","0","0.45455","302","263","39"
"1998","Idaho","9","3","0","0.75000","392","317","75"
"1999","Idaho","7","4","0","0.63636","304","283","21"
"2000","Nevada","2","10","0","0.16667","207","464","-257"
"2001","Nevada","3","8","0","0.27273","286","431","-145"
"2002","Nevada","5","7","0","0.41667","331","371","-40"
"2003","Nevada","6","6","0","0.50000","282","338","-56"
"2000","Idaho","5","6","0","0.45455","321","377","-56"
"2001","Idaho","1","10","0","0.09091","313","495","-182"
"2002","Idaho","2","10","0","0.16667","285","428","-143"
"2003","Idaho","3","9","0","0.25000","248","314","-66"
"2004","Idaho","3","9","0","0.25000","245","473","-228"
"2005","Idaho","2","9","0","0.18182","243","419","-176"
"2007","Idaho","1","11","0","0.08333","258","443","-185"
"2008","Idaho","2","10","0","0.16667","235","513","-278"
"2009","Idaho","8","5","0","0.61538","425","468","-43"
"2010","Idaho","6","7","0","0.46154","346","368","-22"
"2011","Idaho","2","10","0","0.16667","243","399","-156"
"2012","Idaho","1","7","0","0.12500","128","336","-208"
"2012","Idaho","0","4","0","0.00000","62","173","-111"
"2013","Idaho","1","11","0","0.08333","218","561","-343"
"1890","Illinois","1","2","0","0.33333","12","84","-72"
"1891","Illinois","6","0","0","1.00000","142","24","118"
"1892","Illinois","9","4","1","0.67857","240","96","144"
"1893","Illinois","3","2","3","0.56250","156","106","50"
"1894","Illinois","5","3","0","0.62500","188","76","112"
"1895","Illinois","4","2","1","0.64286","215","28","187"
"1896","Illinois","4","2","1","0.64286","148","36","112"
"1897","Illinois","6","2","0","0.75000","200","45","155"
"1898","Illinois","4","5","0","0.44444","83","78","5"
"1899","Illinois","3","5","1","0.38889","40","96","-56"
"1900","Illinois","7","3","2","0.66667","184","67","117"
"1904","Fordham (NY)","4","1","1","0.75000","70","12","58"
"1906","Fordham (NY)","5","3","0","0.62500","139","38","101"
"1907","Fordham (NY)","6","1","1","0.81250","245","25","220"
"1901","Illinois","8","2","0","0.80000","243","39","204"
"1902","Illinois","10","2","1","0.80769","380","44","336"
"1892","Pennsylvania","15","1","0","0.93750","405","52","353"
"1893","Pennsylvania","12","3","0","0.80000","484","62","422"
"1894","Pennsylvania","12","0","0","1.00000","366","20","346"
"1895","Pennsylvania","14","0","0","1.00000","480","24","456"
"1896","Pennsylvania","14","1","0","0.93333","326","24","302"
"1897","Pennsylvania","15","0","0","1.00000","463","20","443"
"1898","Pennsylvania","12","1","0","0.92308","398","32","366"
"1899","Pennsylvania","8","3","2","0.69231","268","81","187"
"1900","Pennsylvania","12","1","0","0.92308","335","45","290"
"1901","Pennsylvania","10","5","0","0.66667","203","121","82"
"1903","Illinois","8","6","0","0.57143","352","117","235"
"1905","Carlisle Indian School (PA)","7","2","0","0.77778","229","34","195"
"1904","Illinois","9","2","1","0.79167","232","42","190"
"1905","Illinois","5","4","0","0.55556","84","136","-52"
"1906","Illinois","1","3","1","0.30000","20","107","-87"
"1907","Illinois","3","2","0","0.60000","64","81","-17"
"1908","Illinois","5","1","1","0.78571","140","37","103"
"1909","Illinois","5","2","0","0.71429","115","39","76"
"1910","Illinois","7","0","0","1.00000","89","0","89"
"1911","Illinois","4","2","1","0.64286","81","51","30"
"1912","Illinois","3","3","1","0.50000","122","48","74"
"1913","Illinois","4","2","1","0.64286","108","54","54"
"1914","Illinois","7","0","0","1.00000","224","22","202"
"1915","Illinois","5","0","2","0.85714","183","25","158"
"1916","Illinois","3","3","1","0.50000","74","58","16"
"1917","Illinois","5","2","1","0.68750","134","40","94"
"1918","Illinois","5","2","0","0.71429","86","14","72"
"1919","Illinois","6","1","0","0.85714","91","48","43"
"1920","Illinois","5","2","0","0.71429","97","37","60"
"1921","Illinois","3","4","0","0.42857","88","51","37"
"1922","Illinois","2","5","0","0.28571","26","60","-34"
"1923","Illinois","8","0","0","1.00000","136","20","116"
"1924","Illinois","6","1","1","0.81250","204","71","133"
"1925","Illinois","5","3","0","0.62500","98","59","39"
"1926","Illinois","6","2","0","0.75000","121","46","75"
"1927","Illinois","7","0","1","0.93750","152","24","128"
"1928","Illinois","7","1","0","0.87500","145","16","129"
"1929","Illinois","6","1","1","0.81250","155","27","128"
"1930","Illinois","3","5","0","0.37500","78","97","-19"
"1931","Illinois","2","6","1","0.27778","58","140","-82"
"1932","Illinois","5","4","0","0.55556","96","101","-5"
"1933","Illinois","5","3","0","0.62500","77","32","45"
"1934","Illinois","7","1","0","0.87500","103","43","60"
"1935","Illinois","3","5","0","0.37500","59","54","5"
"1936","Illinois","4","3","1","0.56250","57","76","-19"
"1937","Illinois","3","3","2","0.50000","59","45","14"
"1938","Illinois","3","5","0","0.37500","110","88","22"
"1939","Illinois","3","4","1","0.43750","75","74","1"
"1940","Illinois","1","7","0","0.12500","71","144","-73"
"1941","Illinois","2","6","0","0.25000","112","163","-51"
"1933","Illinois College","4","2","1","0.64286","63","32","31"
"1934","Illinois College","6","1","0","0.85714","141","7","134"
"1935","Illinois College","5","3","0","0.62500","104","53","51"
"1936","Illinois College","4","3","1","0.56250","78","55","23"
"1942","Illinois","6","4","0","0.60000","227","126","101"
"1943","Illinois","3","7","0","0.30000","154","308","-154"
"1944","Illinois","5","4","1","0.55000","273","149","124"
"1945","Illinois","2","6","1","0.27778","93","104","-11"
"1946","Illinois","8","2","0","0.80000","217","105","112"
"1947","Illinois","5","3","1","0.61111","204","102","102"
"1948","Illinois","3","6","0","0.33333","135","140","-5"
"1949","Illinois","3","4","2","0.44444","149","140","9"
"1950","Illinois","7","2","0","0.77778","137","56","81"
"1951","Illinois","9","0","1","0.95000","220","83","137"
"1952","Illinois","4","5","0","0.44444","194","175","19"
"1953","Illinois","7","1","1","0.83333","228","133","95"
"1954","Illinois","1","8","0","0.11111","103","180","-77"
"1955","Illinois","5","3","1","0.61111","149","114","35"
"1956","Illinois","2","5","2","0.33333","124","154","-30"
"1957","Illinois","4","5","0","0.44444","167","133","34"
"1958","Illinois","4","5","0","0.44444","144","150","-6"
"1959","Illinois","5","3","1","0.61111","111","93","18"
"1956","Nebraska","4","6","0","0.40000","125","206","-81"
"1957","California","1","9","0","0.10000","109","176","-67"
"1958","California","7","4","0","0.63636","207","200","7"
"1959","California","2","8","0","0.20000","115","223","-108"
"1960","Illinois","5","4","0","0.55556","140","117","23"
"1961","Illinois","0","9","0","0.00000","53","289","-236"
"1962","Illinois","2","7","0","0.22222","75","234","-159"
"1963","Illinois","8","1","1","0.85000","170","96","74"
"1964","Illinois","6","3","0","0.66667","142","100","42"
"1965","Illinois","6","4","0","0.60000","235","118","117"
"1966","Illinois","4","6","0","0.40000","173","193","-20"
"1973","Miami (FL)","5","6","0","0.45455","163","240","-77"
"1974","Miami (FL)","6","5","0","0.54545","167","190","-23"
"1967","Illinois","4","6","0","0.40000","143","213","-70"
"1968","Illinois","1","9","0","0.10000","107","333","-226"
"1969","Illinois","0","10","0","0.00000","106","397","-291"
"1970","Illinois","3","7","0","0.30000","165","279","-114"
"1953","Denver (CO)","3","5","2","0.40000","159","195","-36"
"1954","Denver (CO)","9","1","0","0.90000","298","96","202"
"1955","Dartmouth (NH)","3","6","0","0.33333","92","120","-28"
"1956","Dartmouth (NH)","5","3","1","0.61111","122","89","33"
"1957","Dartmouth (NH)","7","1","1","0.83333","163","77","86"
"1958","Dartmouth (NH)","7","2","0","0.77778","182","83","99"
"1959","Dartmouth (NH)","5","3","1","0.61111","96","106","-10"
"1960","Dartmouth (NH)","5","4","0","0.55556","98","66","32"
"1961","Dartmouth (NH)","6","3","0","0.66667","197","104","93"
"1962","Dartmouth (NH)","9","0","0","1.00000","231","57","174"
"1963","Dartmouth (NH)","7","2","0","0.77778","175","94","81"
"1964","Dartmouth (NH)","6","3","0","0.66667","235","135","100"
"1965","Dartmouth (NH)","9","0","0","1.00000","271","71","200"
"1966","Dartmouth (NH)","7","2","0","0.77778","273","131","142"
"1967","Dartmouth (NH)","7","2","0","0.77778","205","146","59"
"1968","Dartmouth (NH)","4","5","0","0.44444","206","183","23"
"1969","Dartmouth (NH)","8","1","0","0.88889","282","99","183"
"1970","Dartmouth (NH)","9","0","0","1.00000","311","42","269"
"1971","Illinois","5","6","0","0.45455","163","238","-75"
"1972","Illinois","3","8","0","0.27273","197","277","-80"
"1973","Illinois","5","6","0","0.45455","164","157","7"
"1974","Illinois","6","4","1","0.59091","210","206","4"
"1975","Illinois","5","6","0","0.45455","229","260","-31"
"1976","Illinois","5","6","0","0.45455","235","248","-13"
"1977","Cornell (NY)","1","8","0","0.11111","86","199","-113"
"1978","Cornell (NY)","5","3","1","0.61111","188","154","34"
"1979","Cornell (NY)","5","4","0","0.55556","215","152","63"
"1980","Cornell (NY)","5","5","0","0.50000","179","192","-13"
"1981","Cornell (NY)","3","7","0","0.30000","148","256","-108"
"1982","Cornell (NY)","4","6","0","0.40000","211","202","9"
"1977","Illinois","3","8","0","0.27273","141","292","-151"
"1978","Illinois","1","8","2","0.18182","103","317","-214"
"1979","Illinois","2","8","1","0.22727","156","266","-110"
"1990","Michigan","9","3","0","0.75000","389","198","191"
"1991","Michigan","10","2","0","0.83333","420","203","217"
"1992","Michigan","9","0","3","0.87500","431","171","260"
"1993","Michigan","8","4","0","0.66667","342","160","182"
"1994","Michigan","8","4","0","0.66667","330","268","62"
"1972","California","3","8","0","0.27273","228","314","-86"
"1973","California","4","7","0","0.36364","245","380","-135"
"1974","California","7","3","1","0.68182","276","213","63"
"1975","California","8","3","0","0.72727","330","233","97"
"1976","California","5","6","0","0.45455","230","226","4"
"1977","California","8","3","0","0.72727","300","211","89"
"1980","Illinois","3","7","1","0.31818","241","326","-85"
"1981","Illinois","7","4","0","0.63636","287","288","-1"
"1982","Illinois","7","5","0","0.58333","338","229","109"
"1983","Illinois","10","2","0","0.83333","347","213","134"
"1984","Illinois","7","4","0","0.63636","323","209","114"
"1985","Illinois","6","5","1","0.54167","304","334","-30"
"1986","Illinois","4","7","0","0.36364","189","299","-110"
"1987","Illinois","3","7","1","0.31818","153","208","-55"
"2013","Albany St. (GA)","6","4","0","0.60000","255","174","81"
"1978","Wake Forest (NC)","1","10","0","0.09091","104","274","-170"
"1979","Wake Forest (NC)","8","4","0","0.66667","240","283","-43"
"1980","Wake Forest (NC)","5","6","0","0.45455","251","213","38"
"1988","Illinois","6","5","1","0.54167","245","243","2"
"1989","Illinois","10","2","0","0.83333","332","182","150"
"1990","Illinois","8","4","0","0.66667","293","246","47"
"1991","Illinois","6","5","0","0.54545","261","182","79"
"1992","Texas","6","5","0","0.54545","292","282","10"
"1993","Texas","5","5","1","0.50000","281","269","12"
"1994","Texas","8","4","0","0.66667","366","291","75"
"1995","Texas","10","2","1","0.80769","390","255","135"
"1996","Texas","8","5","0","0.61538","447","305","142"
"1997","Texas","4","7","0","0.36364","283","366","-83"
"2001","Arizona","5","6","0","0.45455","320","377","-57"
"2002","Arizona","4","8","0","0.33333","227","310","-83"
"2003","Arizona","1","4","0","0.20000","82","186","-104"
"1991","Illinois","0","1","0","0.00000","3","6","-3"
"1992","Illinois","6","5","1","0.54167","228","235","-7"
"1993","Illinois","5","6","0","0.45455","204","210","-6"
"1994","Illinois","7","5","0","0.58333","309","156","153"
"1995","Illinois","5","5","1","0.50000","193","198","-5"
"1996","Illinois","2","9","0","0.18182","190","372","-182"
"2000","Edinboro (PA)","5","6","0","0.45455","163","209","-46"
"2001","Edinboro (PA)","4","6","0","0.40000","202","209","-7"
"2002","Edinboro (PA)","5","6","0","0.45455","253","260","-7"
"2003","Edinboro (PA)","9","3","0","0.75000","357","196","161"
"2004","Edinboro (PA)","9","3","0","0.75000","398","259","139"
"2005","Edinboro (PA)","8","2","0","0.80000","314","93","221"
"2006","Indiana (PA)","8","2","0","0.80000","261","144","117"
"2007","Indiana (PA)","9","3","0","0.75000","462","274","188"
"2008","Indiana (PA)","8","2","0","0.80000","385","114","271"
"2009","Indiana (PA)","5","6","0","0.45455","253","235","18"
"2010","Indiana (PA)","6","5","0","0.54545","257","223","34"
"1992","San Jose St. (CA)","7","4","0","0.63636","330","309","21"
"1997","Illinois","0","11","0","0.00000","119","368","-249"
"1998","Illinois","3","8","0","0.27273","149","326","-177"
"1999","Illinois","8","4","0","0.66667","388","275","113"
"2000","Illinois","5","6","0","0.45455","294","286","8"
"2001","Illinois","10","2","0","0.83333","390","285","105"
"2002","Illinois","5","7","0","0.41667","346","307","39"
"2003","Illinois","1","11","0","0.08333","203","398","-195"
"2004","Illinois","3","8","0","0.27273","240","323","-83"
"2013","Florida International","1","11","0","0.08333","117","444","-327"
"2002","Florida","8","5","0","0.61538","336","279","57"
"2003","Florida","8","5","0","0.61538","390","271","119"
"2004","Florida","7","4","0","0.63636","372","226","146"
"2005","Illinois","2","9","0","0.18182","187","435","-248"
"2006","Illinois","2","10","0","0.16667","235","321","-86"
"2007","Illinois","9","4","0","0.69231","362","283","79"
"2008","Illinois","5","7","0","0.41667","344","319","25"
"2009","Illinois","3","9","0","0.25000","290","362","-72"
"2010","Illinois","7","6","0","0.53846","423","305","118"
"2011","Illinois","6","6","0","0.50000","274","241","33"
"2000","Wyoming","1","10","0","0.09091","170","393","-223"
"2001","Wyoming","2","9","0","0.18182","229","368","-139"
"2002","Wyoming","2","10","0","0.16667","288","432","-144"
"2011","Illinois","1","0","0","1.00000","20","14","6"
"2009","Toledo (OH)","5","7","0","0.41667","356","452","-96"
"2010","Toledo (OH)","8","5","0","0.61538","363","371","-8"
"2011","Toledo (OH)","8","4","0","0.66667","507","371","136"
"2012","Illinois","2","10","0","0.16667","200","385","-185"
"2013","Illinois","4","8","0","0.33333","356","425","-69"
"1887","Indiana","0","1","0","0.00000","8","10","-2"
"1888","Indiana","0","0","1","0.50000","6","6","0"
"1886","Wabash (IN)","2","0","1","0.83333","34","12","22"
"1889","Indiana","0","2","0","0.00000","7","50","-43"
"1891","Indiana","1","5","0","0.16667","46","225","-179"
"1869","Rutgers (NJ)","2","2","0","0.50000","18","18","0"
"1870","Rutgers (NJ)","2","2","0","0.50000","17","17","0"
"1872","Columbia (NY)","5","4","0","0.55556","22","16","6"
"1873","Rutgers (NJ)","7","4","1","0.62500","31","26","5"
"1874","Harvard (MA)","9","7","0","0.56250","54","41","13"
"1875","Harvard (MA)","12","6","2","0.65000","52","29","23"
"1876","Harvard (MA)","13","8","1","0.61364","45","29","16"
"1877","Harvard (MA)","9","7","3","0.55263","31","21","10"
"1878","Pennsylvania","14","9","5","0.58929","42","24","18"
"1879","Harvard (MA)","13","9","12","0.55882","46","27","19"
"1880","Harvard (MA)","18","11","4","0.60606","75","53","22"
"1881","Rutgers (NJ)","22","18","8","0.54167","70","47","23"
"1882","Rutgers (NJ)","41","28","2","0.59155","176","111","65"
"1883","Rutgers (NJ)","38","32","1","0.54225","1288","965","323"
"1884","Pennsylvania","47","29","5","0.61111","1728","1184","544"
"1885","Michigan","34","17","4","0.65455","1437","612","825"
"1886","Lehigh (PA)","48","21","4","0.68493","1850","637","1213"
"1887","California","67","35","3","0.65238","2660","935","1725"
"1888","Princeton (NJ)","70","56","6","0.55303","2468","1899","569"
"1889","Brown (RI)","82","51","11","0.60764","2879","1796","1083"
"1890","Brown (RI)","77","76","9","0.50309","3002","2455","547"
"1891","Southern California","94","76","13","0.54918","2813","2189","624"
"1892","Minnesota","93","80","9","0.53571","2972","2394","578"
"1893","Duke (NC)","79","94","9","0.45879","2176","2912","-736"
"1894","Colorado St.","50","62","4","0.44828","1161","1518","-357"
"1895","Boston (MA)","31","44","11","0.42442","692","1031","-339"
"1896","Rhode Island","54","62","12","0.46875","1126","1201","-75"
"1897","Boston (MA)","32","40","6","0.44872","792","785","7"
"1898","Miami (OH)","47","23","4","0.66216","921","644","277"
"1899","New Hampshire","33","32","6","0.50704","571","522","49"
"1900","New Hampshire","22","35","11","0.40441","442","686","-244"
"1901","Marshall (WV)","18","34","3","0.35455","302","917","-615"
"1902","Saint John's (MN)","9","22","4","0.31429","148","460","-312"
"1903","Wichita St. (KS)","14","25","2","0.36585","376","546","-170"
"1904","Oklahoma St.","11","14","1","0.44231","194","394","-200"
"1905","Miami (OH)","7","25","5","0.25676","245","494","-249"
"1906","Rensselaer Tech (NY)","3","7","4","0.35714","92","107","-15"
"1907","Marshall (WV)","5","10","2","0.35294","71","238","-167"
"1908","Fort Hays St. (KS)","5","6","1","0.45833","56","91","-35"
"1909","Fort Hays St. (KS)","1","3","1","0.30000","12","68","-56"
"1910","Texas St.","0","1","0","0.00000","0","19","-19"
"1912","Fort Hays St. (KS)","1","2","0","0.33333","20","132","-112"
"1913","Eureka (IL)","1","6","0","0.14286","39","203","-164"
"1914","Eureka (IL)","3","4","0","0.42857","57","201","-144"
"1915","Texas St.","1","1","1","0.50000","13","20","-7"
"1916","Texas St.","0","2","1","0.16667","0","106","-106"
"1917","Boston (MA)","4","4","0","0.50000","73","136","-63"
"1918","Monmouth (IL)","1","7","0","0.12500","26","137","-111"
"1930","Troy (AL)","1","2","0","0.33333","7","73","-66"
"2013","Grambling St. (LA)","0","1","0","0.00000","0","0","0"
"1894","Indiana","0","4","1","0.10000","10","125","-115"
"1895","Indiana","4","3","1","0.56250","108","90","18"
"1896","Indiana","6","3","0","0.66667","186","74","112"
"1897","Indiana","6","1","1","0.81250","150","32","118"
"1898","Indiana","4","1","2","0.71429","90","30","60"
"1899","Indiana","6","2","0","0.75000","133","33","100"
"1900","Indiana","4","2","2","0.62500","110","29","81"
"1901","Indiana","6","3","0","0.66667","214","87","127"
"1902","Indiana","3","5","1","0.38889","94","207","-113"
"1903","Indiana","4","4","0","0.50000","148","124","24"
"1904","Indiana","6","4","0","0.60000","84","116","-32"
"1905","Indiana","8","1","1","0.85000","240","38","202"
"1906","Indiana","4","2","0","0.66667","109","46","63"
"1907","Indiana","2","3","1","0.41667","85","57","28"
"1908","Indiana","3","4","0","0.42857","43","70","-27"
"1909","Indiana","4","3","0","0.57143","129","53","76"
"1910","Indiana","6","1","0","0.85714","111","6","105"
"1911","Indiana","3","3","1","0.50000","74","46","28"
"1912","Indiana","2","5","0","0.28571","80","100","-20"
"1913","Indiana","3","4","0","0.42857","90","162","-72"
"1914","Indiana","3","4","0","0.42857","104","130","-26"
"1915","Indiana","3","3","1","0.50000","85","43","42"
"1911","Nebraska","5","1","2","0.75000","281","33","248"
"1912","Nebraska","7","1","0","0.87500","220","37","183"
"1913","Nebraska","8","0","0","1.00000","138","28","110"
"1914","Nebraska","7","0","1","0.93750","174","28","146"
"1915","Nebraska","8","0","0","1.00000","282","39","243"
"1916","Indiana","2","4","1","0.35714","51","90","-39"
"1917","Indiana","5","2","0","0.71429","225","59","166"
"1918","Indiana","2","2","0","0.50000","64","31","33"
"1919","Indiana","3","4","0","0.42857","70","64","6"
"1920","Indiana","5","2","0","0.71429","129","48","81"
"1921","Indiana","3","4","0","0.42857","86","94","-8"
"1922","Indiana","1","4","2","0.28571","21","113","-92"
"1925","Duke (NC)","4","5","0","0.44444","58","142","-84"
"1922","William & Mary (VA)","6","3","0","0.66667","171","80","91"
"1923","Indiana","3","4","0","0.42857","48","117","-69"
"1924","Indiana","4","4","0","0.50000","147","100","47"
"1925","Indiana","3","4","1","0.43750","102","115","-13"
"1926","Navy (MD)","9","0","1","0.95000","236","88","148"
"1927","Navy (MD)","6","3","0","0.66667","192","84","108"
"1928","Navy (MD)","5","3","1","0.61111","121","21","100"
"1929","Navy (MD)","6","2","2","0.70000","233","59","174"
"1930","Navy (MD)","6","5","0","0.54545","148","117","31"
"1931","California","8","2","0","0.80000","106","41","65"
"1932","California","7","3","2","0.66667","169","89","80"
"1933","California","6","3","2","0.63636","161","39","122"
"1934","California","6","6","0","0.50000","176","110","66"
"1920","Butler (IN)","7","1","0","0.87500","251","51","200"
"1921","Butler (IN)","6","2","0","0.75000","282","49","233"
"1922","Butler (IN)","8","2","0","0.80000","160","74","86"
"1923","Butler (IN)","7","2","0","0.77778","142","81","61"
"1924","Butler (IN)","4","5","0","0.44444","93","113","-20"
"1925","Butler (IN)","5","2","2","0.66667","134","62","72"
"1926","Indiana","3","5","0","0.37500","80","137","-57"
"1927","Indiana","3","4","1","0.43750","104","107","-3"
"1928","Indiana","4","4","0","0.50000","55","68","-13"
"1929","Indiana","2","6","1","0.27778","58","133","-75"
"1930","Indiana","2","5","1","0.31250","28","121","-93"
"1914","Mississippi St.","6","2","0","0.75000","289","38","251"
"1915","Mississippi St.","5","2","1","0.68750","110","36","74"
"1916","Mississippi St.","4","4","1","0.50000","125","60","65"
"1931","Indiana","3","5","2","0.40000","57","98","-41"
"1932","Indiana","3","4","1","0.43750","65","76","-11"
"1933","Indiana","1","5","2","0.25000","25","96","-71"
"1922","Centenary (LA)","8","1","0","0.88889","295","41","254"
"1923","Centenary (LA)","10","2","0","0.83333","371","40","331"
"1924","Centenary (LA)","8","1","0","0.88889","177","59","118"
"1928","Kansas St.","3","5","0","0.37500","94","94","0"
"1929","Kansas St.","3","5","0","0.37500","55","102","-47"
"1930","Kansas St.","5","3","0","0.62500","91","66","25"
"1931","Kansas St.","8","2","0","0.80000","162","39","123"
"1932","Kansas St.","4","4","0","0.50000","160","80","80"
"1933","Kansas St.","6","2","1","0.72222","105","29","76"
"1934","Indiana","3","3","2","0.50000","67","110","-43"
"1935","Indiana","4","3","1","0.56250","70","55","15"
"1936","Indiana","5","2","1","0.68750","123","63","60"
"1937","Indiana","5","3","0","0.62500","72","32","40"
"1938","Indiana","1","6","1","0.18750","21","67","-46"
"1939","Indiana","2","4","2","0.37500","70","96","-26"
"1940","Indiana","3","5","0","0.37500","69","100","-31"
"1941","Indiana","2","6","0","0.25000","101","126","-25"
"1942","Indiana","7","3","0","0.70000","256","79","177"
"1943","Indiana","4","4","2","0.50000","193","106","87"
"1944","Indiana","7","3","0","0.70000","292","79","213"
"1945","Indiana","9","0","1","0.95000","279","56","223"
"1946","Indiana","6","3","0","0.66667","129","95","34"
"1947","Indiana","5","3","1","0.61111","156","102","54"
"1948","Indiana","2","7","0","0.22222","75","217","-142"
"1949","Indiana","1","8","0","0.11111","117","254","-137"
"1950","Indiana","3","5","1","0.38889","99","155","-56"
"1951","Indiana","2","7","0","0.22222","118","191","-73"
"1952","Arizona St.","6","3","0","0.66667","247","121","126"
"1953","Arizona St.","4","5","1","0.45000","207","203","4"
"1954","Arizona St.","5","5","0","0.50000","178","228","-50"
"1952","Indiana","2","7","0","0.22222","143","224","-81"
"1953","Indiana","2","7","0","0.22222","119","227","-108"
"1954","Indiana","3","6","0","0.33333","110","143","-33"
"1955","Indiana","3","6","0","0.33333","91","150","-59"
"1956","Indiana","3","6","0","0.33333","129","263","-134"
"1957","Indiana","1","8","0","0.11111","47","307","-260"
"1947","Wofford (SC)","6","5","0","0.54545","142","98","44"
"1948","Wofford (SC)","4","0","5","0.72222","102","45","57"
"1949","Wofford (SC)","11","1","0","0.91667","353","86","267"
"1950","Wofford (SC)","7","2","1","0.75000","212","95","117"
"1951","Wofford (SC)","6","3","1","0.65000","177","140","37"
"1952","Wofford (SC)","6","5","0","0.54545","189","259","-70"
"1953","Wyoming","5","4","1","0.55000","195","110","85"
"1954","Wyoming","6","4","0","0.60000","215","171","44"
"1955","Wyoming","8","3","0","0.72727","225","137","88"
"1956","Wyoming","10","0","0","1.00000","252","112","140"
"1958","Indiana","5","3","1","0.61111","81","141","-60"
"1959","Indiana","4","4","1","0.50000","142","105","37"
"1960","Indiana","1","8","0","0.11111","69","243","-174"
"1961","Indiana","2","7","0","0.22222","96","162","-66"
"1962","Indiana","3","6","0","0.33333","126","140","-14"
"1963","Indiana","3","6","0","0.33333","151","188","-37"
"1964","Indiana","2","7","0","0.22222","154","188","-34"
"1956","Miami (OH)","7","1","1","0.83333","159","83","76"
"1957","Miami (OH)","6","3","0","0.66667","163","137","26"
"1958","Miami (OH)","6","3","0","0.66667","193","96","97"
"1959","Miami (OH)","5","4","0","0.55556","158","94","64"
"1960","Miami (OH)","5","5","0","0.50000","139","159","-20"
"1961","Miami (OH)","6","4","0","0.60000","153","115","38"
"1962","Miami (OH)","8","2","1","0.77273","241","175","66"
"1963","Yale (CT)","6","3","0","0.66667","135","78","57"
"1964","Yale (CT)","6","2","1","0.72222","195","120","75"
"1965","Indiana","2","8","0","0.20000","134","225","-91"
"1966","Indiana","1","8","1","0.15000","104","229","-125"
"1967","Indiana","9","2","0","0.81818","197","159","38"
"1968","Indiana","6","4","0","0.60000","250","262","-12"
"1969","Indiana","4","6","0","0.40000","252","242","10"
"1970","Indiana","1","9","0","0.10000","102","300","-198"
"1971","Indiana","3","8","0","0.27273","152","260","-108"
"1972","Indiana","5","6","0","0.45455","204","272","-68"
"1973","Northwestern (IL)","4","7","0","0.36364","188","299","-111"
"1974","Northwestern (IL)","3","8","0","0.27273","140","385","-245"
"1975","Northwestern (IL)","3","8","0","0.27273","149","318","-169"
"1976","Northwestern (IL)","1","10","0","0.09091","134","311","-177"
"1977","Northwestern (IL)","1","10","0","0.09091","102","337","-235"
"1990","Mount Saint Joseph (OH)","1","9","0","0.10000","160","330","-170"
"1991","Mount Saint Joseph (OH)","4","6","0","0.40000","204","249","-45"
"1992","Mount Saint Joseph (OH)","4","5","0","0.44444","135","269","-134"
"1969","Louisville (KY)","5","4","1","0.55000","206","273","-67"
"1970","Louisville (KY)","8","3","1","0.70833","252","208","44"
"1971","Louisville (KY)","6","3","1","0.65000","190","111","79"
"1972","Louisville (KY)","9","1","0","0.90000","309","91","218"
"1973","Indiana","2","9","0","0.18182","151","271","-120"
"1974","Indiana","1","10","0","0.09091","166","292","-126"
"1975","Indiana","2","8","1","0.22727","104","254","-150"
"1976","Indiana","5","6","0","0.45455","130","254","-124"
"1977","Indiana","5","5","1","0.50000","205","228","-23"
"1978","Indiana","4","7","0","0.36364","228","290","-62"
"1979","Indiana","8","4","0","0.66667","314","252","62"
"1980","Indiana","6","5","0","0.54545","255","235","20"
"1981","Indiana","3","8","0","0.27273","144","293","-149"
"1982","Indiana","5","6","0","0.45455","203","250","-47"
"1984","Northern Illinois","4","6","1","0.40909","153","188","-35"
"1983","Indiana","3","8","0","0.27273","201","360","-159"
"1969","Miami (OH)","7","3","0","0.70000","231","139","92"
"1970","Miami (OH)","7","3","0","0.70000","187","112","75"
"1971","Miami (OH)","7","3","0","0.70000","207","117","90"
"1972","Miami (OH)","7","3","0","0.70000","232","116","116"
"1973","Miami (OH)","11","0","0","1.00000","223","76","147"
"1974","Colorado","5","6","0","0.45455","226","307","-81"
"1975","Colorado","9","3","0","0.75000","331","251","80"
"1976","Colorado","8","4","0","0.66667","305","225","80"
"1977","Colorado","7","3","1","0.68182","266","174","92"
"1978","Colorado","6","5","0","0.54545","230","206","24"
"1980","Northern Illinois","7","4","0","0.63636","216","175","41"
"1981","Northern Illinois","3","8","0","0.27273","160","217","-57"
"1982","Northern Illinois","5","5","0","0.50000","137","136","1"
"1983","Northern Illinois","10","2","0","0.83333","314","203","111"
"1984","Indiana","0","11","0","0.00000","185","338","-153"
"1985","Indiana","4","7","0","0.36364","251","340","-89"
"1986","Indiana","6","6","0","0.50000","273","227","46"
"1987","Indiana","8","4","0","0.66667","283","238","45"
"1988","Indiana","8","3","1","0.70833","396","235","161"
"1989","Indiana","5","6","0","0.45455","289","262","27"
"1990","Indiana","6","5","1","0.54167","329","238","91"
"1991","Indiana","7","4","1","0.62500","305","224","81"
"1992","Indiana","5","6","0","0.45455","177","197","-20"
"1993","Indiana","8","4","0","0.66667","259","197","62"
"1994","Indiana","7","4","0","0.63636","294","285","9"
"1995","Indiana","2","9","0","0.18182","159","326","-167"
"1996","Indiana","3","8","0","0.27273","242","291","-49"
"1997","Indiana","2","9","0","0.18182","120","359","-239"
"1998","Indiana","4","7","0","0.36364","245","305","-60"
"1999","Indiana","4","7","0","0.36364","291","386","-95"
"2000","Indiana","3","8","0","0.27273","337","427","-90"
"2001","Indiana","5","6","0","0.45455","305","298","7"
"1991","Vanderbilt (TN)","5","6","0","0.45455","205","267","-62"
"1992","Vanderbilt (TN)","4","7","0","0.36364","224","277","-53"
"1993","Vanderbilt (TN)","5","6","0","0.45455","137","290","-153"
"1994","Vanderbilt (TN)","5","6","0","0.45455","203","277","-74"
"1995","Louisiana St.","7","4","1","0.62500","324","186","138"
"1996","Louisiana St.","10","2","0","0.83333","335","210","125"
"1997","Louisiana St.","9","3","0","0.75000","373","188","185"
"1998","Louisiana St.","4","7","0","0.36364","337","279","58"
"1999","Louisiana St.","2","8","0","0.20000","188","249","-61"
"2002","Indiana","3","9","0","0.25000","258","445","-187"
"2003","Indiana","2","10","0","0.16667","177","388","-211"
"2004","Indiana","3","8","0","0.27273","262","343","-81"
"1999","Miami (OH)","7","4","0","0.63636","335","264","71"
"2000","Miami (OH)","6","5","0","0.54545","272","286","-14"
"2001","Miami (OH)","7","5","0","0.58333","319","309","10"
"2002","Miami (OH)","7","5","0","0.58333","384","325","59"
"2003","Miami (OH)","13","1","0","0.92857","602","272","330"
"2004","Miami (OH)","8","5","0","0.61538","407","298","109"
"2005","Indiana","4","7","0","0.36364","248","361","-113"
"2006","Indiana","5","7","0","0.41667","277","394","-117"
"1985","Butler (IN)","8","2","0","0.80000","247","138","109"
"1986","Butler (IN)","5","5","0","0.50000","258","169","89"
"1987","Butler (IN)","8","1","1","0.85000","311","149","162"
"1988","Butler (IN)","8","2","1","0.77273","304","176","128"
"1989","Butler (IN)","7","2","1","0.75000","280","205","75"
"1995","Ball St. (IN)","7","4","0","0.63636","204","187","17"
"1996","Ball St. (IN)","8","4","0","0.66667","296","210","86"
"1997","Ball St. (IN)","5","6","0","0.45455","239","260","-21"
"1998","Ball St. (IN)","1","10","0","0.09091","150","343","-193"
"1999","Ball St. (IN)","0","11","0","0.00000","157","361","-204"
"2000","Ball St. (IN)","5","6","0","0.45455","212","349","-137"
"2001","Ball St. (IN)","5","6","0","0.45455","268","296","-28"
"2002","Ball St. (IN)","6","6","0","0.50000","278","333","-55"
"2004","DePauw (IN)","8","2","0","0.80000","261","160","101"
"2007","Indiana","7","6","0","0.53846","412","370","42"
"2008","Indiana","3","9","0","0.25000","246","423","-177"
"2009","Indiana","4","8","0","0.33333","282","354","-72"
"2010","Indiana","5","7","0","0.41667","326","408","-82"
"2013","DePauw (IN)","4","6","0","0.40000","214","242","-28"
"2011","Indiana","1","11","0","0.08333","257","448","-191"
"2012","Indiana","4","8","0","0.33333","369","423","-54"
"2013","Indiana","5","7","0","0.41667","461","466","-5"
"1869","Rutgers (NJ)","2","2","0","0.50000","18","18","0"
"1870","Rutgers (NJ)","2","2","0","0.50000","17","17","0"
"1872","Columbia (NY)","5","4","0","0.55556","22","16","6"
"1873","Rutgers (NJ)","7","4","1","0.62500","31","26","5"
"1874","Harvard (MA)","9","7","0","0.56250","54","41","13"
"1875","Harvard (MA)","12","6","2","0.65000","52","29","23"
"1876","Harvard (MA)","13","8","1","0.61364","45","29","16"
"1877","Harvard (MA)","9","7","3","0.55263","31","21","10"
"1878","Pennsylvania","14","9","5","0.58929","42","24","18"
"1879","Harvard (MA)","13","9","12","0.55882","46","27","19"
"1880","Harvard (MA)","18","11","4","0.60606","75","53","22"
"1881","Rutgers (NJ)","22","18","8","0.54167","70","47","23"
"1882","Rutgers (NJ)","41","28","2","0.59155","176","111","65"
"1883","Rutgers (NJ)","38","32","1","0.54225","1288","965","323"
"1884","Pennsylvania","47","29","5","0.61111","1728","1184","544"
"1885","Michigan","34","17","4","0.65455","1437","612","825"
"1886","Lehigh (PA)","48","21","4","0.68493","1850","637","1213"
"1887","California","67","35","3","0.65238","2660","935","1725"
"1888","Princeton (NJ)","70","56","6","0.55303","2468","1899","569"
"1889","Brown (RI)","82","51","11","0.60764","2879","1796","1083"
"1890","Brown (RI)","77","76","9","0.50309","3002","2455","547"
"1891","Southern California","94","76","13","0.54918","2813","2189","624"
"1892","Minnesota","93","80","9","0.53571","2972","2394","578"
"1893","Duke (NC)","79","94","9","0.45879","2176","2912","-736"
"1894","Colorado St.","50","62","4","0.44828","1161","1518","-357"
"1895","Boston (MA)","31","44","11","0.42442","692","1031","-339"
"1896","Rhode Island","54","62","12","0.46875","1126","1201","-75"
"1897","Boston (MA)","32","40","6","0.44872","792","785","7"
"1898","Miami (OH)","47","23","4","0.66216","921","644","277"
"1899","New Hampshire","33","32","6","0.50704","571","522","49"
"1900","New Hampshire","22","35","11","0.40441","442","686","-244"
"1901","Marshall (WV)","18","34","3","0.35455","302","917","-615"
"1902","Saint John's (MN)","9","22","4","0.31429","148","460","-312"
"1903","Wichita St. (KS)","14","25","2","0.36585","376","546","-170"
"1904","Oklahoma St.","11","14","1","0.44231","194","394","-200"
"1905","Miami (OH)","7","25","5","0.25676","245","494","-249"
"1906","Rensselaer Tech (NY)","3","7","4","0.35714","92","107","-15"
"1907","Marshall (WV)","5","10","2","0.35294","71","238","-167"
"1908","Fort Hays St. (KS)","5","6","1","0.45833","56","91","-35"
"1909","Fort Hays St. (KS)","1","3","1","0.30000","12","68","-56"
"1910","Texas St.","0","1","0","0.00000","0","19","-19"
"1912","Fort Hays St. (KS)","1","2","0","0.33333","20","132","-112"
"1913","Eureka (IL)","1","6","0","0.14286","39","203","-164"
"1914","Eureka (IL)","3","4","0","0.42857","57","201","-144"
"1915","Texas St.","1","1","1","0.50000","13","20","-7"
"1916","Texas St.","0","2","1","0.16667","0","106","-106"
"1917","Boston (MA)","4","4","0","0.50000","73","136","-63"
"1918","Monmouth (IL)","1","7","0","0.12500","26","137","-111"
"1930","Troy (AL)","1","2","0","0.33333","7","73","-66"
"2013","Grambling St. (LA)","0","1","0","0.00000","0","0","0"
"1892","Iowa","3","2","1","0.58333","124","70","54"
"1893","Iowa","3","4","0","0.42857","178","161","17"
"1894","Iowa","4","4","1","0.50000","162","170","-8"
"1896","Iowa","10","5","3","0.63889","202","137","65"
"1897","Franklin & Marshall (PA)","2","6","2","0.30000","58","199","-141"
"1900","Georgetown (DC)","5","1","3","0.72222","159","42","117"
"1903","Lafayette (PA)","7","3","0","0.70000","182","69","113"
"1904","Lafayette (PA)","8","2","0","0.80000","251","33","218"
"1905","Lafayette (PA)","7","2","1","0.75000","313","55","258"
"1906","Lafayette (PA)","8","1","1","0.85000","223","36","187"
"1907","Lafayette (PA)","7","2","1","0.75000","198","50","148"
"1896","Alabama","2","1","0","0.66667","56","10","46"
"1897","Iowa","4","4","0","0.50000","76","110","-34"
"1898","Iowa","3","4","2","0.44444","67","97","-30"
"1899","Iowa","9","0","1","0.95000","257","5","252"
"1900","Iowa","7","0","1","0.93750","311","12","299"
"1901","Iowa","6","3","0","0.66667","79","115","-36"
"1902","Iowa","5","4","0","0.55556","121","238","-117"
"1902","Franklin & Marshall (PA)","7","2","0","0.77778","282","54","228"
"1903","Iowa","9","2","0","0.81818","171","102","69"
"1904","Iowa","7","4","0","0.63636","257","109","148"
"1905","Iowa","8","3","0","0.72727","309","90","219"
"1914","Dubuque (IA)","1","1","0","0.50000","17","13","4"
"1915","Dubuque (IA)","7","0","0","1.00000","191","20","171"
"1916","Dubuque (IA)","5","1","0","0.83333","199","27","172"
"1917","Dubuque (IA)","5","0","1","0.91667","303","25","278"
"1918","Dubuque (IA)","2","1","0","0.66667","71","13","58"
"1919","Dubuque (IA)","6","1","0","0.85714","196","54","142"
"1920","Dubuque (IA)","4","1","1","0.75000","134","48","86"
"1921","Dubuque (IA)","4","2","1","0.64286","132","35","97"
"1922","Dubuque (IA)","2","5","0","0.28571","71","62","9"
"1923","Dubuque (IA)","3","4","1","0.43750","99","72","27"
"1924","Dubuque (IA)","1","6","0","0.14286","72","98","-26"
"1906","Iowa","3","3","0","0.50000","56","75","-19"
"1907","Iowa","3","2","0","0.60000","90","48","42"
"1908","Iowa","2","5","0","0.28571","132","65","67"
"1909","Lawrence (WI)","4","3","0","0.57143","99","60","39"
"1910","Lawrence (WI)","3","3","1","0.50000","89","65","24"
"1911","Lawrence (WI)","8","1","0","0.88889","129","15","114"
"1912","Lawrence (WI)","5","1","1","0.78571","138","13","125"
"1913","Lawrence (WI)","5","1","1","0.78571","147","82","65"
"1914","Lawrence (WI)","5","1","0","0.83333","100","33","67"
"1915","Lawrence (WI)","2","5","0","0.28571","97","179","-82"
"1916","Lawrence (WI)","4","2","1","0.64286","63","52","11"
"1918","Lawrence (WI)","6","1","0","0.85714","184","14","170"
"1924","Lawrence (WI)","4","2","1","0.64286","139","31","108"
"1925","Lawrence (WI)","4","3","0","0.57143","70","35","35"
"1926","Lawrence (WI)","4","2","2","0.62500","107","58","49"
"1927","Lawrence (WI)","2","5","0","0.28571","32","100","-68"
"1902","Idaho","1","3","1","0.30000","23","43","-20"
"1903","Idaho","4","1","0","0.80000","131","5","126"
"1904","Idaho","2","1","0","0.66667","36","12","24"
"1905","Idaho","5","0","0","1.00000","113","2","111"
"1906","Idaho","2","4","0","0.33333","47","49","-2"
"1909","Iowa","2","4","1","0.35714","58","97","-39"
"1910","Idaho","4","2","0","0.66667","112","69","43"
"1911","Idaho","4","3","0","0.57143","98","58","40"
"1912","Idaho","2","2","0","0.50000","26","34","-8"
"1913","Idaho","3","3","0","0.50000","93","56","37"
"1914","Idaho","2","3","1","0.41667","12","45","-33"
"1915","Oklahoma St.","4","5","1","0.45000","161","93","68"
"1916","Oklahoma St.","4","4","0","0.50000","290","95","195"
"1917","New Mexico St.","4","2","0","0.66667","231","75","156"
"1910","Iowa","5","2","0","0.71429","94","15","79"
"1911","Iowa","3","4","0","0.42857","34","53","-19"
"1912","Iowa","4","3","0","0.57143","130","138","-8"
"1913","Iowa","5","2","0","0.71429","310","51","259"
"1914","Iowa","4","3","0","0.57143","204","36","168"
"1915","Iowa","3","4","0","0.42857","92","150","-58"
"1923","Dartmouth (NH)","8","1","0","0.88889","202","54","148"
"1924","Dartmouth (NH)","7","0","1","0.93750","225","31","194"
"1925","Dartmouth (NH)","8","0","0","1.00000","340","29","311"
"1926","Dartmouth (NH)","4","4","0","0.50000","203","64","139"
"1927","Dartmouth (NH)","7","1","0","0.87500","280","53","227"
"1928","Dartmouth (NH)","5","4","0","0.55556","182","103","79"
"1908","Syracuse (NY)","6","3","1","0.65000","171","39","132"
"1909","Yale (CT)","10","0","0","1.00000","209","0","209"
"1910","Ohio St.","6","1","3","0.75000","182","27","155"
"1913","Yale (CT)","5","2","3","0.65000","126","34","92"
"1916","Iowa","4","3","0","0.57143","121","156","-35"
"1917","Iowa","3","6","0","0.33333","91","160","-69"
"1918","Iowa","6","2","1","0.72222","123","36","87"
"1919","Iowa","5","2","0","0.71429","90","44","46"
"1920","Iowa","5","2","0","0.71429","142","54","88"
"1921","Iowa","7","0","0","1.00000","185","36","149"
"1922","Iowa","7","0","0","1.00000","208","33","175"
"1923","Iowa","5","3","0","0.62500","124","55","69"
"1924","Duke (NC)","4","5","0","0.44444","129","99","30"
"1925","Southern California","11","2","0","0.84615","456","55","401"
"1926","Southern California","8","2","0","0.80000","317","52","265"
"1927","Southern California","8","1","1","0.85000","287","64","223"
"1928","Southern California","9","0","1","0.95000","267","59","208"
"1929","Southern California","10","2","0","0.83333","492","69","423"
"1930","Southern California","8","2","0","0.80000","382","66","316"
"1931","Southern California","10","1","0","0.90909","363","52","311"
"1932","Southern California","10","0","0","1.00000","201","13","188"
"1933","Southern California","10","1","1","0.87500","257","30","227"
"1934","Southern California","4","6","1","0.40909","120","110","10"
"1935","Southern California","5","7","0","0.41667","155","124","31"
"1936","Southern California","4","2","3","0.61111","129","65","64"
"1937","Southern California","4","4","2","0.50000","136","98","38"
"1938","Southern California","9","2","0","0.81818","172","65","107"
"1939","Southern California","8","0","2","0.90000","181","33","148"
"1940","Southern California","3","4","2","0.44444","88","98","-10"
"1924","Iowa","6","1","1","0.81250","106","50","56"
"1925","Iowa","5","3","0","0.62500","122","74","48"
"1926","Iowa","3","5","0","0.37500","113","117","-4"
"1927","Iowa","4","4","0","0.50000","107","83","24"
"1928","Iowa","6","2","0","0.75000","147","42","105"
"1929","Iowa","4","2","2","0.62500","128","28","100"
"1930","Iowa","4","4","0","0.50000","88","74","14"
"1931","Iowa","1","7","1","0.16667","7","138","-131"
"1921","Drake (IA)","5","2","0","0.71429","149","40","109"
"1922","Drake (IA)","7","0","0","1.00000","155","26","129"
"1923","Drake (IA)","5","2","0","0.71429","168","49","119"
"1924","Drake (IA)","5","2","1","0.68750","106","56","50"
"1925","Drake (IA)","5","3","0","0.62500","65","41","24"
"1926","Drake (IA)","2","6","0","0.25000","60","118","-58"
"1927","Drake (IA)","3","6","0","0.33333","89","158","-69"
"1928","Drake (IA)","7","1","0","0.87500","141","52","89"
"1929","Drake (IA)","5","3","1","0.61111","145","79","66"
"1930","Drake (IA)","5","4","0","0.55556","166","120","46"
"1931","Drake (IA)","5","6","0","0.45455","130","226","-96"
"1932","Iowa","1","7","0","0.12500","62","171","-109"
"1933","Iowa","5","3","0","0.62500","131","56","75"
"1934","Iowa","2","5","1","0.31250","98","153","-55"
"1935","Iowa","4","2","2","0.62500","122","39","83"
"1936","Iowa","3","4","1","0.43750","85","103","-18"
"1937","Syracuse (NY)","5","2","1","0.68750","132","57","75"
"1938","Syracuse (NY)","5","3","0","0.62500","137","102","35"
"1939","Syracuse (NY)","3","3","2","0.50000","63","92","-29"
"1940","Syracuse (NY)","3","4","1","0.43750","114","134","-20"
"1941","Syracuse (NY)","5","2","1","0.68750","190","86","104"
"1942","Syracuse (NY)","6","3","0","0.66667","152","61","91"
"1944","Syracuse (NY)","2","4","1","0.35714","102","152","-50"
"1945","Syracuse (NY)","1","6","0","0.14286","38","106","-68"
"1935","Miami (FL)","5","3","0","0.62500","91","52","39"
"1936","Miami (FL)","6","2","2","0.70000","129","39","90"
"1937","Iowa","1","7","0","0.12500","36","120","-84"
"1938","Iowa","1","6","1","0.18750","46","135","-89"
"1933","Holy Cross (MA)","7","2","0","0.77778","165","70","95"
"1934","Holy Cross (MA)","8","2","0","0.80000","187","61","126"
"1935","Holy Cross (MA)","9","0","1","0.95000","260","19","241"
"1936","Holy Cross (MA)","7","2","1","0.75000","157","42","115"
"1937","Holy Cross (MA)","8","0","2","0.90000","107","19","88"
"1938","Holy Cross (MA)","8","1","0","0.88889","225","51","174"
"1939","Iowa","6","1","1","0.81250","130","91","39"
"1940","Iowa","4","4","0","0.50000","125","98","27"
"1941","Iowa","3","5","0","0.37500","91","99","-8"
"1942","Iowa","6","4","0","0.60000","147","135","12"
"1946","Iowa","5","4","0","0.55556","129","92","37"
"1947","Iowa","3","5","1","0.38889","145","179","-34"
"1948","Iowa","4","5","0","0.44444","127","142","-15"
"1949","Iowa","4","5","0","0.44444","184","247","-63"
"1950","Holy Cross (MA)","4","5","1","0.45000","247","209","38"
"1951","Holy Cross (MA)","8","2","0","0.80000","362","117","245"
"1952","Holy Cross (MA)","8","2","0","0.80000","226","77","149"
"1953","Holy Cross (MA)","5","5","0","0.50000","134","89","45"
"1954","Holy Cross (MA)","3","7","0","0.30000","180","243","-63"
"1955","Holy Cross (MA)","6","4","0","0.60000","148","160","-12"
"1956","Holy Cross (MA)","5","3","1","0.61111","142","123","19"
"1957","Holy Cross (MA)","5","3","1","0.61111","191","130","61"
"1958","Holy Cross (MA)","6","3","0","0.66667","112","104","8"
"1959","Holy Cross (MA)","6","4","0","0.60000","142","160","-18"
"1960","Holy Cross (MA)","6","4","0","0.60000","172","119","53"
"1961","Holy Cross (MA)","7","3","0","0.70000","207","152","55"
"1962","Holy Cross (MA)","6","4","0","0.60000","216","204","12"
"1963","Holy Cross (MA)","2","6","1","0.27778","77","154","-77"
"1964","Holy Cross (MA)","5","5","0","0.50000","146","153","-7"
"1921","Saint Mary's (CA)","4","3","0","0.57143","155","70","85"
"1922","Saint Mary's (CA)","3","6","0","0.33333","67","151","-84"
"1923","Saint Mary's (CA)","5","3","1","0.61111","212","111","101"
"1924","Saint Mary's (CA)","8","1","0","0.88889","205","50","155"
"1925","Saint Mary's (CA)","8","2","0","0.80000","313","72","241"
"1926","Saint Mary's (CA)","9","0","1","0.95000","242","27","215"
"1927","Saint Mary's (CA)","7","2","1","0.75000","155","28","127"
"1928","Saint Mary's (CA)","5","4","0","0.55556","105","59","46"
"1929","Saint Mary's (CA)","8","0","1","0.94444","198","6","192"
"1930","Saint Mary's (CA)","8","1","0","0.88889","168","31","137"
"1931","Saint Mary's (CA)","8","2","0","0.80000","119","65","54"
"1932","Saint Mary's (CA)","6","2","1","0.72222","118","59","59"
"1933","Saint Mary's (CA)","6","3","1","0.65000","161","73","88"
"1934","Saint Mary's (CA)","7","2","0","0.77778","125","40","85"
"1935","Saint Mary's (CA)","5","2","2","0.66667","115","37","78"
"1936","Saint Mary's (CA)","6","3","1","0.65000","140","80","60"
"1937","Saint Mary's (CA)","4","3","2","0.55556","71","50","21"
"1938","Saint Mary's (CA)","6","2","0","0.75000","106","41","65"
"1939","Saint Mary's (CA)","3","4","1","0.43750","84","57","27"
"1943","Iowa","1","6","1","0.18750","83","153","-70"
"1944","Iowa","1","7","0","0.12500","53","240","-187"
"1945","Iowa","2","7","0","0.22222","74","310","-236"
"1950","Iowa","3","5","1","0.38889","121","201","-80"
"1951","Iowa","2","5","2","0.33333","161","233","-72"
"1941","Hamilton (NY)","5","2","0","0.71429","150","64","86"
"1950","Washington St.","4","3","2","0.55556","168","182","-14"
"1951","Washington St.","7","3","0","0.70000","280","187","93"
"1952","Iowa","2","7","0","0.22222","121","220","-99"
"1953","Iowa","5","3","1","0.61111","187","91","96"
"1954","Iowa","5","4","0","0.55556","192","141","51"
"1955","Iowa","3","5","1","0.38889","166","173","-7"
"1956","Iowa","9","1","0","0.90000","219","84","135"
"1957","Iowa","7","1","1","0.83333","263","112","151"
"1958","Iowa","8","1","1","0.85000","272","146","126"
"1959","Iowa","5","4","0","0.55556","233","100","133"
"1960","Iowa","8","1","0","0.88889","234","108","126"
"1961","Iowa","5","4","0","0.55556","215","162","53"
"1962","Iowa","4","5","0","0.44444","127","166","-39"
"1963","Iowa","3","3","2","0.50000","126","112","14"
"1964","Iowa","3","6","0","0.33333","170","209","-39"
"1965","Iowa","1","9","0","0.10000","94","192","-98"
"1958","Utah","4","7","0","0.36364","161","187","-26"
"1959","Utah","5","5","0","0.50000","224","195","29"
"1960","Utah","7","3","0","0.70000","194","90","104"
"1961","Utah","6","4","0","0.60000","176","134","42"
"1962","Utah","4","5","1","0.45000","169","196","-27"
"1963","Utah","4","6","0","0.40000","204","187","17"
"1964","Utah","9","2","0","0.81818","234","68","166"
"1965","Utah","3","7","0","0.30000","177","164","13"
"1966","Iowa","2","8","0","0.20000","86","253","-167"
"1967","Iowa","1","8","1","0.15000","161","277","-116"
"1968","Iowa","5","5","0","0.50000","322","289","33"
"1969","Iowa","5","5","0","0.50000","255","275","-20"
"1970","Iowa","3","6","1","0.35000","129","259","-130"
"1963","Toledo (OH)","2","7","0","0.22222","118","176","-58"
"1964","Toledo (OH)","2","8","0","0.20000","127","218","-91"
"1965","Toledo (OH)","5","5","0","0.50000","104","96","8"
"1966","Toledo (OH)","2","7","1","0.25000","137","162","-25"
"1967","Toledo (OH)","9","1","0","0.90000","266","83","183"
"1968","Toledo (OH)","5","4","1","0.55000","230","156","74"
"1969","Toledo (OH)","11","0","0","1.00000","385","160","225"
"1970","Toledo (OH)","12","0","0","1.00000","384","88","296"
"1971","Iowa","1","10","0","0.09091","121","379","-258"
"1972","Iowa","3","7","1","0.31818","109","208","-99"
"1973","Iowa","0","11","0","0.00000","140","401","-261"
"1974","Iowa","3","8","0","0.27273","157","308","-151"
"1975","Iowa","3","8","0","0.27273","182","279","-97"
"1976","Iowa","5","6","0","0.45455","161","234","-73"
"1977","Iowa","5","6","0","0.45455","171","229","-58"
"1978","Iowa","2","9","0","0.18182","125","291","-166"
"1962","Southern Methodist (TX)","2","8","0","0.20000","88","130","-42"
"1963","Southern Methodist (TX)","4","7","0","0.36364","141","175","-34"
"1964","Southern Methodist (TX)","1","9","0","0.10000","55","177","-122"
"1965","Southern Methodist (TX)","4","5","1","0.45000","123","167","-44"
"1966","Southern Methodist (TX)","8","3","0","0.72727","210","170","40"
"1967","Southern Methodist (TX)","3","7","0","0.30000","135","214","-79"
"1968","Southern Methodist (TX)","8","3","0","0.72727","311","273","38"
"1969","Southern Methodist (TX)","3","7","0","0.30000","186","230","-44"
"1970","Southern Methodist (TX)","5","6","0","0.45455","153","228","-75"
"1971","Southern Methodist (TX)","4","7","0","0.36364","151","227","-76"
"1972","Southern Methodist (TX)","7","4","0","0.63636","269","154","115"
"1973","North Texas","5","5","1","0.50000","153","243","-90"
"1974","North Texas","2","7","2","0.27273","134","248","-114"
"1975","North Texas","7","4","0","0.63636","200","210","-10"
"1976","North Texas","7","4","0","0.63636","232","145","87"
"1977","North Texas","10","1","0","0.90909","320","179","141"
"1978","North Texas","9","2","0","0.81818","275","150","125"
"1979","Iowa","5","6","0","0.45455","239","216","23"
"1980","Iowa","4","7","0","0.36364","154","238","-84"
"1981","Iowa","8","4","0","0.66667","260","157","103"
"1982","Iowa","8","4","0","0.66667","229","230","-1"
"1983","Iowa","9","3","0","0.75000","380","189","191"
"1984","Iowa","8","4","1","0.65385","359","201","158"
"1985","Iowa","10","2","0","0.83333","440","187","253"
"1986","Iowa","9","3","0","0.75000","391","214","177"
"1987","Iowa","10","3","0","0.76923","380","250","130"
"1988","Iowa","6","4","3","0.57692","336","233","103"
"1989","Iowa","5","6","0","0.45455","197","278","-81"
"1990","Iowa","8","4","0","0.66667","427","288","139"
"1991","Iowa","10","1","1","0.87500","343","179","164"
"1992","Iowa","5","7","0","0.41667","243","278","-35"
"1993","Iowa","6","6","0","0.50000","214","293","-79"
"1994","Iowa","5","5","1","0.50000","307","324","-17"
"1995","Iowa","8","4","0","0.66667","368","259","109"
"1996","Iowa","9","3","0","0.75000","339","243","96"
"1997","Iowa","7","5","0","0.58333","411","159","252"
"1998","Iowa","3","8","0","0.27273","172","287","-115"
"1990","Maine","3","8","0","0.27273","200","281","-81"
"1991","Maine","3","8","0","0.27273","210","333","-123"
"1992","Maine","6","5","0","0.54545","254","274","-20"
"1999","Iowa","1","10","0","0.09091","162","347","-185"
"2000","Iowa","3","9","0","0.25000","203","330","-127"
"2001","Iowa","7","5","0","0.58333","391","258","133"
"2002","Iowa","11","2","0","0.84615","484","256","228"
"2003","Iowa","10","3","0","0.76923","373","210","163"
"2004","Iowa","10","2","0","0.83333","292","211","81"
"2005","Iowa","7","5","0","0.58333","360","240","120"
"2006","Iowa","6","7","0","0.46154","310","269","41"
"2007","Iowa","6","6","0","0.50000","222","225","-3"
"2008","Iowa","9","4","0","0.69231","394","169","225"
"2009","Iowa","11","2","0","0.84615","301","200","101"
"2010","Iowa","8","5","0","0.61538","376","221","155"
"2011","Iowa","7","6","0","0.53846","358","310","48"
"2012","Iowa","4","8","0","0.33333","232","275","-43"
"2013","Iowa","8","5","0","0.61538","342","246","96"
"1892","Iowa St.","1","0","1","0.75000","36","6","30"
"1893","Iowa St.","0","3","0","0.00000","14","62","-48"
"1895","Iowa St.","3","5","0","0.37500","108","56","52"
"1896","Georgia","4","0","0","1.00000","86","22","64"
"1897","Cornell (NY)","5","3","1","0.61111","133","42","91"
"1898","Cornell (NY)","10","2","0","0.83333","296","29","267"
"1899","Carlisle Indian School (PA)","9","2","0","0.81818","365","50","315"
"1900","Carlisle Indian School (PA)","6","4","1","0.59091","212","92","120"
"1901","Carlisle Indian School (PA)","5","7","1","0.42308","133","168","-35"
"1902","Carlisle Indian School (PA)","8","3","0","0.72727","251","51","200"
"1903","Carlisle Indian School (PA)","11","2","1","0.82143","274","52","222"
"1904","Cornell (NY)","7","3","0","0.70000","226","92","134"
"1905","Cornell (NY)","6","4","0","0.60000","173","59","114"
"1906","Cornell (NY)","8","1","2","0.81818","237","37","200"
"1907","Carlisle Indian School (PA)","10","1","0","0.90909","267","62","205"
"1908","Carlisle Indian School (PA)","10","2","1","0.80769","222","55","167"
"1909","Carlisle Indian School (PA)","8","3","1","0.70833","243","94","149"
"1910","Carlisle Indian School (PA)","8","6","0","0.57143","235","69","166"
"1911","Carlisle Indian School (PA)","11","1","0","0.91667","298","49","249"
"1912","Carlisle Indian School (PA)","12","1","1","0.89286","503","120","383"
"1913","Carlisle Indian School (PA)","10","1","1","0.87500","296","63","233"
"1914","Carlisle Indian School (PA)","5","9","1","0.36667","125","174","-49"
"1915","Pittsburgh (PA)","8","0","0","1.00000","247","19","228"
"1916","Pittsburgh (PA)","8","0","0","1.00000","255","25","230"
"1917","Pittsburgh (PA)","10","0","0","1.00000","260","21","239"
"1918","Pittsburgh (PA)","4","1","0","0.80000","140","16","124"
"1919","Pittsburgh (PA)","6","2","1","0.72222","119","66","53"
"1920","Pittsburgh (PA)","6","0","2","0.87500","146","44","102"
"1921","Pittsburgh (PA)","5","3","1","0.61111","133","51","82"
"1922","Pittsburgh (PA)","8","2","0","0.80000","190","43","147"
"1923","Pittsburgh (PA)","5","4","0","0.55556","83","39","44"
"1924","Stanford (CA)","7","1","1","0.83333","179","69","110"
"1925","Stanford (CA)","7","2","0","0.77778","231","71","160"
"1926","Stanford (CA)","10","0","1","0.95455","268","73","195"
"1927","Stanford (CA)","8","2","1","0.77273","162","82","80"
"1928","Stanford (CA)","8","3","1","0.70833","274","69","205"
"1929","Stanford (CA)","9","2","0","0.81818","288","53","235"
"1930","Stanford (CA)","9","1","1","0.86364","252","69","183"
"1931","Stanford (CA)","7","2","2","0.72727","160","44","116"
"1932","Stanford (CA)","6","4","1","0.59091","171","58","113"
"1933","Temple (PA)","5","3","0","0.62500","110","96","14"
"1934","Temple (PA)","7","1","2","0.80000","220","57","163"
"1935","Temple (PA)","7","3","0","0.70000","181","68","113"
"1936","Temple (PA)","6","3","2","0.63636","117","66","51"
"1937","Temple (PA)","3","2","4","0.55556","38","59","-21"
"1938","Temple (PA)","3","6","1","0.35000","97","170","-73"
"1894","Iowa St.","6","1","0","0.85714","192","32","160"
"1895","Iowa St.","3","3","0","0.50000","72","53","19"
"1896","Iowa St.","8","2","0","0.80000","303","46","257"
"1897","Iowa St.","3","1","0","0.75000","40","32","8"
"1898","Iowa St.","3","2","0","0.60000","49","50","-1"
"1899","Iowa St.","5","4","1","0.55000","117","38","79"
"1896","Alma (MI)","2","0","1","0.83333","36","32","4"
"1900","Iowa St.","2","5","1","0.31250","38","100","-62"
"1901","Iowa St.","2","6","2","0.30000","56","127","-71"
"1902","Iowa St.","6","3","1","0.65000","246","56","190"
"1903","Iowa St.","8","1","0","0.88889","202","59","143"
"1904","Iowa St.","7","2","0","0.77778","248","48","200"
"1905","Iowa St.","6","3","0","0.66667","203","93","110"
"1906","Iowa St.","9","1","0","0.90000","268","30","238"
"1907","Iowa St.","6","2","0","0.75000","138","40","98"
"1908","Iowa St.","6","3","0","0.66667","186","50","136"
"1909","Iowa St.","4","3","1","0.56250","82","62","20"
"1910","Iowa St.","4","4","0","0.50000","37","85","-48"
"1911","Iowa St.","6","1","1","0.81250","88","20","68"
"1912","Iowa St.","6","2","0","0.75000","151","45","106"
"1913","Iowa St.","4","4","0","0.50000","112","119","-7"
"1914","Iowa St.","4","3","0","0.57143","167","78","89"
"1913","Franklin & Marshall (PA)","6","2","0","0.75000","208","54","154"
"1914","Franklin & Marshall (PA)","6","2","1","0.72222","103","56","47"
"1915","Iowa St.","6","2","0","0.75000","129","75","54"
"1916","Iowa St.","5","2","1","0.68750","106","36","70"
"1917","Iowa St.","5","2","0","0.71429","129","20","109"
"1918","Iowa St.","0","3","0","0.00000","0","38","-38"
"1919","Iowa St.","5","2","1","0.68750","73","20","53"
"1924","Franklin & Marshall (PA)","3","5","1","0.38889","101","153","-52"
"1925","Franklin & Marshall (PA)","5","4","0","0.55556","88","75","13"
"1944","Franklin & Marshall (PA)","1","8","0","0.11111","69","109","-40"
"1945","Franklin & Marshall (PA)","4","0","1","0.90000","76","13","63"
"1913","Baylor (TX)","4","5","2","0.45455","74","222","-148"
"1917","Arkansas","5","1","1","0.78571","118","27","91"
"1918","Arkansas","3","2","0","0.60000","41","121","-80"
"1920","Iowa St.","4","4","0","0.50000","98","48","50"
"1921","Iowa St.","4","4","0","0.50000","87","74","13"
"1922","Iowa St.","2","6","0","0.25000","51","124","-73"
"1923","Iowa St.","4","3","1","0.56250","121","93","28"
"1924","Iowa St.","4","3","1","0.56250","87","68","19"
"1925","Iowa St.","4","3","1","0.56250","107","93","14"
"1929","Ohio St.","4","3","1","0.56250","95","69","26"
"1930","Ohio St.","5","2","1","0.68750","139","48","91"
"1931","Ohio St.","6","3","0","0.66667","194","74","120"
"1932","Ohio St.","4","1","3","0.68750","90","41","49"
"1933","Ohio St.","7","1","0","0.87500","161","26","135"
"1926","Iowa St.","4","3","1","0.56250","51","60","-9"
"1927","Iowa St.","4","3","1","0.56250","77","78","-1"
"1928","Iowa St.","2","5","1","0.31250","39","67","-28"
"1929","Iowa St.","1","7","0","0.12500","54","135","-81"
"1930","Iowa St.","0","9","0","0.00000","64","134","-70"
"1931","Iowa St.","5","3","0","0.62500","72","74","-2"
"1932","Iowa St.","3","4","1","0.43750","105","101","4"
"1933","Iowa St.","3","5","1","0.38889","73","120","-47"
"1934","Iowa St.","5","3","1","0.61111","132","66","66"
"1935","Iowa St.","2","4","3","0.38889","82","101","-19"
"1936","Iowa St.","3","3","2","0.50000","94","112","-18"
"1935","Fort Hays St. (KS)","8","2","0","0.80000","171","62","109"
"1937","Iowa St.","3","6","0","0.33333","50","161","-111"
"1938","Iowa St.","7","1","1","0.83333","125","64","61"
"1939","Iowa St.","2","7","0","0.22222","50","117","-67"
"1940","Iowa St.","4","5","0","0.44444","118","132","-14"
"1941","Colorado","3","4","1","0.43750","97","161","-64"
"1942","Colorado","7","2","0","0.77778","251","73","178"
"1943","Colorado","5","2","0","0.71429","134","47","87"
"1946","Colorado","5","4","1","0.55000","91","147","-56"
"1947","Colorado","4","5","0","0.44444","90","162","-72"
"1941","Iowa St.","2","6","1","0.27778","85","181","-96"
"1942","Iowa St.","1","2","0","0.33333","19","60","-41"
"1942","Iowa St.","2","4","0","0.33333","75","117","-42"
"1943","Iowa St.","4","4","0","0.50000","147","104","43"
"1944","Iowa St.","6","1","1","0.81250","203","39","164"
"1945","Iowa St.","4","3","1","0.56250","156","97","59"
"1946","Iowa St.","2","6","1","0.27778","77","239","-162"
"1932","Southeast Missouri St.","2","6","1","0.27778","64","83","-19"
"1933","Southeast Missouri St.","5","3","1","0.61111","132","80","52"
"1934","Southeast Missouri St.","8","1","0","0.88889","168","41","127"
"1935","Southeast Missouri St.","7","2","0","0.77778","122","46","76"
"1936","Southeast Missouri St.","4","5","0","0.44444","54","78","-24"
"1937","Southeast Missouri St.","9","0","0","1.00000","168","12","156"
"1938","Southeast Missouri St.","3","5","0","0.37500","57","76","-19"
"1939","Southeast Missouri St.","5","3","1","0.61111","88","36","52"
"1940","Southeast Missouri St.","4","4","2","0.50000","90","73","17"
"1941","Southeast Missouri St.","4","4","1","0.50000","162","111","51"
"1942","Southeast Missouri St.","5","2","1","0.68750","126","84","42"
"1943","Southeast Missouri St.","5","2","0","0.71429","118","45","73"
"1944","Southeast Missouri St.","4","3","0","0.57143","124","52","72"
"1946","Southeast Missouri St.","8","0","1","0.94444","200","38","162"
"1947","Iowa St.","3","6","0","0.33333","111","141","-30"
"1948","Iowa St.","4","6","0","0.40000","116","197","-81"
"1949","Iowa St.","5","3","1","0.61111","169","134","35"
"1950","Iowa St.","3","6","1","0.35000","174","200","-26"
"1951","Iowa St.","4","4","1","0.50000","211","216","-5"
"1952","Iowa St.","3","6","0","0.33333","158","199","-41"
"1953","Iowa St.","2","7","0","0.22222","120","211","-91"
"1949","Western Illinois","9","1","0","0.90000","285","83","202"
"1950","Western Illinois","7","1","0","0.87500","225","96","129"
"1951","Western Illinois","7","1","1","0.83333","337","94","243"
"1952","Western Illinois","7","2","0","0.77778","180","93","87"
"1953","Western Illinois","8","2","0","0.80000","235","78","157"
"1954","Iowa St.","3","6","0","0.33333","151","182","-31"
"1955","Iowa St.","1","7","1","0.16667","69","218","-149"
"1956","Iowa St.","2","8","0","0.20000","92","260","-168"
"1957","Iowa St.","4","5","1","0.45000","142","160","-18"
"1958","Texas A&M","4","6","0","0.40000","124","217","-93"
"1959","Texas A&M","3","7","0","0.30000","101","141","-40"
"1960","Texas A&M","1","6","3","0.25000","73","117","-44"
"1961","Texas A&M","4","5","1","0.45000","184","118","66"
"1958","Iowa St.","4","6","0","0.40000","127","88","39"
"1959","Iowa St.","7","3","0","0.70000","248","80","168"
"1960","Iowa St.","7","3","0","0.70000","185","136","49"
"1961","Iowa St.","5","5","0","0.50000","151","133","18"
"1962","Iowa St.","5","5","0","0.50000","235","235","0"
"1963","Iowa St.","4","5","0","0.44444","129","143","-14"
"1964","Iowa St.","1","8","1","0.15000","72","155","-83"
"1965","Iowa St.","5","4","1","0.55000","178","147","31"
"1966","Iowa St.","2","6","2","0.30000","160","211","-51"
"1967","Iowa St.","2","8","0","0.20000","86","275","-189"
"1968","Iowa St.","3","7","0","0.30000","178","263","-85"
"1969","Iowa St.","3","7","0","0.30000","152","231","-79"
"1970","Iowa St.","5","6","0","0.45455","248","284","-36"
"1971","Iowa St.","8","4","0","0.66667","337","250","87"
"1972","Iowa St.","5","6","1","0.45833","319","238","81"
"1973","Pittsburgh (PA)","6","5","1","0.54167","225","211","14"
"1974","Pittsburgh (PA)","7","4","0","0.63636","227","202","25"
"1975","Pittsburgh (PA)","8","4","0","0.66667","322","161","161"
"1976","Pittsburgh (PA)","12","0","0","1.00000","381","133","248"
"1977","Tennessee","4","7","0","0.36364","229","229","0"
"1978","Tennessee","5","5","1","0.50000","251","209","42"
"1979","Tennessee","7","5","0","0.58333","311","235","76"
"1980","Tennessee","5","6","0","0.45455","256","189","67"
"1981","Tennessee","8","4","0","0.66667","244","265","-21"
"1982","Tennessee","6","5","1","0.54167","281","239","42"
"1983","Tennessee","9","3","0","0.75000","282","165","117"
"1984","Tennessee","7","4","1","0.62500","327","276","51"
"1985","Tennessee","9","1","2","0.83333","325","140","185"
"1986","Tennessee","7","5","0","0.58333","293","249","44"
"1987","Tennessee","10","2","1","0.80769","422","246","176"
"1988","Tennessee","5","6","0","0.45455","212","286","-74"
"1989","Tennessee","11","1","0","0.91667","346","217","129"
"1990","Tennessee","9","2","2","0.76923","465","220","245"
"1991","Tennessee","9","3","0","0.75000","352","263","89"
"1992","Tennessee","5","3","0","0.62500","206","125","81"
"1993","Pittsburgh (PA)","3","8","0","0.27273","168","371","-203"
"1994","Pittsburgh (PA)","3","8","0","0.27273","246","307","-61"
"1995","Pittsburgh (PA)","2","9","0","0.18182","217","329","-112"
"1996","Pittsburgh (PA)","4","7","0","0.36364","214","430","-216"
"1973","Iowa St.","4","7","0","0.36364","245","236","9"
"1974","Iowa St.","4","7","0","0.36364","186","198","-12"
"1975","Iowa St.","4","7","0","0.36364","161","263","-102"
"1976","Iowa St.","8","3","0","0.72727","369","216","153"
"1977","Iowa St.","8","4","0","0.66667","249","178","71"
"1978","Iowa St.","8","4","0","0.66667","219","188","31"
"1979","Ohio St.","11","1","0","0.91667","390","126","264"
"1980","Ohio St.","9","3","0","0.75000","387","181","206"
"1981","Ohio St.","9","3","0","0.75000","387","253","134"
"1982","Ohio St.","9","3","0","0.75000","348","208","140"
"1983","Ohio St.","9","3","0","0.75000","410","206","204"
"1984","Ohio St.","9","3","0","0.75000","391","200","191"
"1985","Ohio St.","9","3","0","0.75000","325","212","113"
"1986","Ohio St.","10","3","0","0.76923","347","179","168"
"1987","Ohio St.","6","4","1","0.59091","224","181","43"
"1988","Northern Iowa","5","6","0","0.45455","292","239","53"
"1989","Colorado St.","5","5","1","0.50000","350","303","47"
"1990","Colorado St.","9","4","0","0.69231","372","302","70"
"1991","Colorado St.","3","8","0","0.27273","265","375","-110"
"1992","Colorado St.","5","7","0","0.41667","281","334","-53"
"1979","Iowa St.","3","8","0","0.27273","137","221","-84"
"1980","Iowa St.","6","5","0","0.54545","245","184","61"
"1981","Iowa St.","5","5","1","0.50000","189","218","-29"
"1982","Iowa St.","4","6","1","0.40909","213","221","-8"
"1976","Boise St. (ID)","5","5","1","0.50000","283","197","86"
"1977","Boise St. (ID)","9","2","0","0.81818","317","181","136"
"1978","Boise St. (ID)","7","4","0","0.63636","269","182","87"
"1979","Boise St. (ID)","10","1","0","0.90909","347","140","207"
"1980","Boise St. (ID)","10","3","0","0.76923","317","179","138"
"1981","Boise St. (ID)","10","3","0","0.76923","317","213","104"
"1982","Boise St. (ID)","8","3","0","0.72727","252","211","41"
"1983","Iowa St.","4","7","0","0.36364","248","385","-137"
"1984","Iowa St.","2","7","2","0.27273","149","263","-114"
"1985","Iowa St.","5","6","0","0.45455","155","318","-163"
"1986","Iowa St.","6","5","0","0.54545","257","244","13"
"1978","Washington St.","4","6","1","0.40909","276","296","-20"
"1979","Washington St.","5","6","0","0.45455","241","366","-125"
"1980","Washington St.","4","7","0","0.36364","287","271","16"
"1981","Washington St.","8","3","1","0.70833","297","197","100"
"1982","Washington St.","3","7","1","0.31818","170","255","-85"
"1983","Washington St.","7","4","0","0.63636","237","211","26"
"1984","Washington St.","6","5","0","0.54545","317","319","-2"
"1985","Washington St.","4","7","0","0.36364","313","282","31"
"1986","Washington St.","3","7","1","0.31818","221","312","-91"
"1987","Iowa St.","3","8","0","0.27273","195","417","-222"
"1988","Iowa St.","5","6","0","0.45455","195","258","-63"
"1989","Iowa St.","6","5","0","0.54545","294","305","-11"
"1990","Iowa St.","4","6","1","0.40909","270","307","-37"
"1991","Iowa St.","3","7","1","0.31818","157","266","-109"
"1992","Iowa St.","4","7","0","0.36364","231","242","-11"
"1993","Iowa St.","3","8","0","0.27273","251","324","-73"
"1994","Iowa St.","0","10","1","0.04545","192","363","-171"
"1995","Iowa St.","3","8","0","0.27273","264","409","-145"
"1996","Iowa St.","2","9","0","0.18182","314","401","-87"
"1997","Iowa St.","1","10","0","0.09091","214","493","-279"
"1998","Iowa St.","3","8","0","0.27273","221","328","-107"
"1999","Iowa St.","4","7","0","0.36364","247","272","-25"
"2000","Iowa St.","9","3","0","0.75000","343","322","21"
"2001","Iowa St.","7","5","0","0.58333","309","245","64"
"2002","Iowa St.","7","7","0","0.50000","404","396","8"
"2003","Iowa St.","2","10","0","0.16667","173","437","-264"
"2004","Iowa St.","7","5","0","0.58333","246","259","-13"
"2005","Iowa St.","7","5","0","0.58333","339","230","109"
"2006","Iowa St.","4","8","0","0.33333","226","369","-143"
"2011","North Texas","5","7","0","0.41667","298","368","-70"
"2012","North Texas","4","8","0","0.33333","251","334","-83"
"2013","North Texas","9","4","0","0.69231","414","231","183"
"2007","Iowa St.","3","9","0","0.25000","218","381","-163"
"2008","Iowa St.","2","10","0","0.16667","304","430","-126"
"2009","Auburn (AL)","8","5","0","0.61538","433","358","75"
"2010","Auburn (AL)","14","0","0","1.00000","577","337","240"
"2011","Auburn (AL)","8","5","0","0.61538","334","376","-42"
"2012","Auburn (AL)","3","9","0","0.25000","224","340","-116"
"2009","Iowa St.","7","6","0","0.53846","267","284","-17"
"2010","Iowa St.","5","7","0","0.41667","260","346","-86"
"2011","Iowa St.","6","7","0","0.46154","295","382","-87"
"2012","Iowa St.","6","7","0","0.46154","319","311","8"
"2013","Iowa St.","3","9","0","0.25000","298","432","-134"
"1890","Kansas","1","2","0","0.33333","33","52","-19"
"1891","Kansas","6","1","1","0.81250","162","60","102"
"1892","Kansas","7","1","0","0.87500","144","36","108"
"1893","Kansas","2","5","0","0.28571","85","108","-23"
"1888","North Carolina","1","1","0","0.50000","50","25","25"
"1894","Kansas","4","3","1","0.56250","130","72","58"
"1895","Kansas","6","1","0","0.85714","192","14","178"
"1896","Kansas","7","3","0","0.70000","136","40","96"
"1897","Kansas","8","2","0","0.80000","252","20","232"
"1898","Kansas","10","1","0","0.90909","174","29","145"
"1898","Nebraska","8","3","0","0.72727","270","78","192"
"1899","Kansas","10","0","0","1.00000","280","37","243"
"1900","Stanford (CA)","7","2","1","0.75000","154","20","134"
"1901","Michigan","11","0","0","1.00000","550","0","550"
"1902","Michigan","11","0","0","1.00000","644","12","632"
"1903","Michigan","11","0","1","0.95833","565","6","559"
"1904","Michigan","10","0","0","1.00000","567","22","545"
"1905","Michigan","12","1","0","0.92308","495","2","493"
"1906","Michigan","4","1","1","0.75000","72","30","42"
"1907","Michigan","5","1","0","0.83333","107","6","101"
"1908","Michigan","5","2","1","0.68750","128","81","47"
"1909","Michigan","6","1","0","0.85714","115","34","81"
"1910","Michigan","3","0","3","0.75000","29","9","20"
"1911","Michigan","5","1","2","0.75000","90","38","52"
"1912","Michigan","5","2","0","0.71429","158","65","93"
"1913","Michigan","6","1","0","0.85714","175","21","154"
"1914","Michigan","6","3","0","0.66667","233","68","165"
"1915","Michigan","4","3","1","0.56250","130","81","49"
"1916","Michigan","7","2","0","0.77778","253","56","197"
"1917","Michigan","8","2","0","0.80000","304","53","251"
"1918","Michigan","5","0","0","1.00000","96","6","90"
"1919","Michigan","3","4","0","0.42857","93","102","-9"
"1920","Michigan","5","2","0","0.71429","121","21","100"
"1921","Michigan","5","1","1","0.78571","187","21","166"
"1922","Michigan","6","0","1","0.92857","183","13","170"
"1923","Michigan","8","0","0","1.00000","150","12","138"
"1925","Michigan","7","1","0","0.87500","227","3","224"
"1926","Michigan","7","1","0","0.87500","191","38","153"
"1900","Kansas","2","5","2","0.33333","75","118","-43"
"1902","Sewanee (TN)","7","2","0","0.77778","117","28","89"
"1900","Franklin & Marshall (PA)","4","5","0","0.44444","95","117","-22"
"1901","Kansas","3","5","2","0.40000","92","147","-55"
"1902","Kansas","6","4","0","0.60000","108","93","15"
"1903","Wisconsin","6","3","1","0.65000","305","67","238"
"1904","Wisconsin","5","3","0","0.62500","265","74","191"
"1903","Kansas","6","3","0","0.66667","118","39","79"
"1904","Beloit (WI)","5","5","1","0.50000","161","117","44"
"1904","Kansas","8","1","1","0.85000","179","38","141"
"1905","Kansas","10","1","0","0.90909","250","26","224"
"1906","Kansas","7","2","2","0.72727","148","55","93"
"1907","Kansas","5","3","0","0.62500","111","57","54"
"1908","Kansas","9","0","0","1.00000","131","20","111"
"1909","Kansas","8","1","0","0.88889","172","22","150"
"1910","Kansas","6","1","1","0.81250","75","22","53"
"1911","Kansas","4","2","2","0.62500","81","44","37"
"1899","Central Missouri St.","6","1","0","0.85714","130","28","102"
"1902","Central Missouri St.","6","3","0","0.66667","193","55","138"
"1903","Pittsburgh (PA)","0","9","1","0.05000","26","271","-245"
"1904","Pittsburgh (PA)","10","0","0","1.00000","406","5","401"
"1905","Pittsburgh (PA)","10","2","0","0.83333","405","36","369"
"1912","Kansas","4","4","0","0.50000","128","45","83"
"1913","Kansas","5","3","0","0.62500","120","40","80"
"1914","Kansas","5","2","1","0.68750","158","84","74"
"1902","North Carolina","5","1","3","0.72222","122","34","88"
"1903","North Carolina","6","3","0","0.66667","137","72","65"
"1907","New York (NY)","5","2","0","0.71429","69","69","0"
"1908","New York (NY)","2","3","2","0.42857","27","35","-8"
"1909","New York (NY)","6","1","1","0.81250","141","20","121"
"1910","New York (NY)","2","4","1","0.35714","47","59","-12"
"1911","New York (NY)","1","3","3","0.35714","16","42","-26"
"1912","New York (NY)","2","6","0","0.25000","32","174","-142"
"1915","Kansas","6","2","0","0.75000","153","79","74"
"1916","Kansas","4","3","1","0.56250","68","72","-4"
"1917","Kansas","6","2","0","0.75000","126","46","80"
"1918","Kansas","2","2","0","0.50000","33","66","-33"
"1919","Kansas","3","2","3","0.56250","85","35","50"
"1912","Central Missouri St.","6","2","0","0.75000","256","54","202"
"1913","Central Missouri St.","7","2","0","0.77778","237","77","160"
"1914","Central Missouri St.","5","4","0","0.55556","185","108","77"
"1915","Central Missouri St.","4","2","2","0.62500","121","62","59"
"1916","Central Missouri St.","6","3","0","0.66667","185","65","120"
"1917","Central Missouri St.","2","5","0","0.28571","58","186","-128"
"1920","Kansas","5","2","1","0.68750","117","60","57"
"1920","Michigan St.","4","6","0","0.40000","270","166","104"
"1921","Kansas","4","3","0","0.57143","92","97","-5"
"1922","Kansas","3","4","1","0.43750","104","75","29"
"1923","Kansas","5","0","3","0.81250","125","6","119"
"1924","Kansas","2","5","1","0.31250","91","56","35"
"1925","Kansas","2","5","1","0.31250","30","68","-38"
"1927","Butler (IN)","4","3","1","0.56250","155","133","22"
"1928","Butler (IN)","6","2","0","0.75000","170","44","126"
"1929","Butler (IN)","4","4","0","0.50000","85","67","18"
"1945","Nebraska","4","5","0","0.44444","145","200","-55"
"1948","Nebraska","2","8","0","0.20000","137","273","-136"
"1926","Kansas","2","6","0","0.25000","34","135","-101"
"1927","Kansas","3","4","1","0.43750","89","146","-57"
"1914","Emporia St. (KS)","5","1","1","0.78571","190","13","177"
"1915","Emporia St. (KS)","5","2","2","0.66667","130","91","39"
"1916","Emporia St. (KS)","6","3","1","0.65000","131","75","56"
"1917","Emporia St. (KS)","5","3","1","0.61111","107","115","-8"
"1918","Oregon St.","2","4","0","0.33333","33","46","-13"
"1919","Oregon St.","4","4","1","0.50000","143","64","79"
"1920","Emporia St. (KS)","0","6","2","0.12500","101","127","-26"
"1921","Emporia St. (KS)","7","0","0","1.00000","196","24","172"
"1922","Emporia St. (KS)","6","2","0","0.75000","155","46","109"
"1923","Emporia St. (KS)","5","1","1","0.78571","112","45","67"
"1924","Emporia St. (KS)","4","4","1","0.50000","72","63","9"
"1925","Emporia St. (KS)","4","3","1","0.56250","76","56","20"
"1926","Emporia St. (KS)","7","0","0","1.00000","149","3","146"
"1927","Emporia St. (KS)","7","0","1","0.93750","145","20","125"
"1928","Kansas","2","4","2","0.37500","34","66","-32"
"1929","Kansas","4","4","0","0.50000","97","50","47"
"1930","Kansas","6","2","0","0.75000","144","50","94"
"1931","Kansas","5","5","0","0.50000","112","54","58"
"1932","Kansas","1","1","0","0.50000","19","33","-14"
"1927","Oklahoma","3","3","2","0.50000","117","101","16"
"1928","Oklahoma","5","3","0","0.62500","120","88","32"
"1929","Oklahoma","3","3","2","0.50000","81","81","0"
"1930","Oklahoma","4","3","1","0.56250","100","57","43"
"1931","Oklahoma","4","7","1","0.37500","88","108","-20"
"1932","Kansas","4","2","0","0.66667","70","44","26"
"1933","Kansas","5","4","1","0.55000","102","51","51"
"1934","Kansas","3","4","3","0.45000","74","48","26"
"1935","Kansas","4","4","1","0.50000","102","118","-16"
"1936","Kansas","1","6","1","0.18750","35","153","-118"
"1937","Kansas","3","4","2","0.44444","72","74","-2"
"1938","Kansas","3","6","0","0.33333","132","169","-37"
"1912","Howard Payne (TX)","2","3","1","0.41667","152","119","33"
"1913","Howard Payne (TX)","3","4","2","0.44444","79","66","13"
"1923","Missouri","2","3","3","0.43750","31","40","-9"
"1924","Missouri","7","2","0","0.77778","110","41","69"
"1925","Missouri","6","1","1","0.81250","110","44","66"
"1926","Missouri","5","1","2","0.75000","122","33","89"
"1927","Missouri","7","2","0","0.77778","129","90","39"
"1928","Missouri","4","4","0","0.50000","138","102","36"
"1929","Missouri","5","2","1","0.68750","78","28","50"
"1930","Missouri","2","5","2","0.33333","41","132","-91"
"1931","Missouri","2","8","0","0.20000","72","193","-121"
"1934","New Mexico","8","1","0","0.88889","251","73","178"
"1935","New Mexico","6","4","0","0.60000","145","102","43"
"1936","New Mexico","2","7","0","0.22222","71","95","-24"
"1939","Kansas","2","6","0","0.25000","47","107","-60"
"1940","Kansas","2","7","0","0.22222","75","183","-108"
"1941","Kansas","3","6","0","0.33333","74","222","-148"
"1942","Kansas","2","8","0","0.20000","77","248","-171"
"1943","Kansas","4","5","1","0.45000","96","107","-11"
"1944","Kansas","3","6","1","0.35000","128","153","-25"
"1945","Kansas","4","5","1","0.45000","139","175","-36"
"1937","New Hampshire","7","1","0","0.87500","144","31","113"
"1938","New Hampshire","3","6","0","0.33333","42","112","-70"
"1939","New Hampshire","3","5","0","0.37500","71","126","-55"
"1940","New Hampshire","5","3","0","0.62500","121","86","35"
"1941","New Hampshire","4","3","1","0.56250","153","62","91"
"1946","Kansas","7","2","1","0.75000","157","145","12"
"1947","Kansas","8","1","2","0.81818","304","102","202"
"1948","Navy (MD)","0","8","1","0.05556","77","227","-150"
"1949","Navy (MD)","3","5","1","0.38889","151","238","-87"
"1950","Baylor (TX)","7","3","0","0.70000","183","128","55"
"1951","Baylor (TX)","8","2","1","0.77273","245","131","114"
"1952","Baylor (TX)","4","4","2","0.50000","187","181","6"
"1953","Baylor (TX)","7","3","0","0.70000","219","166","53"
"1954","Baylor (TX)","7","4","0","0.63636","250","174","76"
"1955","Baylor (TX)","5","5","0","0.50000","146","143","3"
"1948","Kansas","7","3","0","0.70000","199","137","62"
"1949","Kansas","5","5","0","0.50000","259","183","76"
"1950","Kansas","6","4","0","0.60000","284","188","96"
"1951","Kansas","8","2","0","0.80000","316","208","108"
"1952","Kansas","7","3","0","0.70000","214","110","104"
"1953","Kansas","2","8","0","0.20000","83","179","-96"
"1954","Kansas","0","10","0","0.00000","93","377","-284"
"1955","Kansas","3","6","1","0.35000","93","222","-129"
"1956","Kansas","3","6","1","0.35000","163","215","-52"
"1957","Kansas","5","4","1","0.55000","115","230","-115"
"1953","Wichita St. (KS)","4","4","1","0.50000","172","110","62"
"1954","Wichita St. (KS)","9","1","0","0.90000","325","86","239"
"1955","Arkansas","5","4","1","0.55000","126","114","12"
"1956","Arkansas","6","4","0","0.60000","160","155","5"
"1957","Arkansas","6","4","0","0.60000","187","134","53"
"1958","Kansas","4","5","1","0.45000","87","175","-88"
"1959","Kansas","5","5","0","0.50000","163","134","29"
"1960","Kansas","5","4","1","0.55000","219","89","130"
"1961","Kansas","7","3","1","0.68182","269","88","181"
"1962","Kansas","6","3","1","0.65000","214","116","98"
"1963","Kansas","5","5","0","0.50000","207","122","85"
"1964","Kansas","6","4","0","0.60000","136","146","-10"
"1965","Kansas","2","8","0","0.20000","119","215","-96"
"1966","Kansas","2","7","1","0.25000","106","188","-82"
"1967","Kansas","5","5","0","0.50000","166","146","20"
"1968","Kansas","9","2","0","0.81818","394","190","204"
"1969","Kansas","1","9","0","0.10000","176","290","-114"
"1970","Kansas","5","6","0","0.45455","270","277","-7"
"1971","UCLA","2","7","1","0.25000","166","243","-77"
"1972","UCLA","8","3","0","0.72727","351","239","112"
"1973","UCLA","9","2","0","0.81818","470","199","271"
"1974","Georgia Tech","6","5","0","0.54545","238","212","26"
"1975","Georgia Tech","7","4","0","0.63636","270","200","70"
"1976","Georgia Tech","4","6","1","0.40909","221","267","-46"
"1977","Georgia Tech","6","5","0","0.54545","224","221","3"
"1978","Georgia Tech","7","5","0","0.58333","270","253","17"
"1979","Georgia Tech","4","6","1","0.40909","152","190","-38"
"1975","Kansas","7","5","0","0.58333","262","180","82"
"1976","Kansas","6","5","0","0.54545","260","251","9"
"1977","Kansas","4","6","1","0.40909","131","269","-138"
"1978","Kansas","1","10","0","0.09091","124","345","-221"
"1971","Kansas","4","7","0","0.36364","187","286","-99"
"1972","Kansas","5","6","0","0.45455","208","305","-97"
"1973","Kansas","7","4","1","0.62500","253","220","33"
"1974","Kansas","4","7","0","0.36364","157","247","-90"
"1979","Kansas","3","8","0","0.27273","172","346","-174"
"1980","Kansas","4","5","2","0.45455","171","208","-37"
"1981","Kansas","8","4","0","0.66667","188","195","-7"
"1982","Kansas","2","7","2","0.27273","150","276","-126"
"1978","Murray St. (KY)","4","7","0","0.36364","236","237","-1"
"1979","Murray St. (KY)","9","2","1","0.79167","272","144","128"
"1980","Murray St. (KY)","9","2","0","0.81818","230","100","130"
"1981","Cincinnati (OH)","6","5","0","0.54545","171","187","-16"
"1982","Cincinnati (OH)","6","5","0","0.54545","276","206","70"
"1983","Kansas","4","6","1","0.40909","296","320","-24"
"1984","Kansas","5","6","0","0.45455","218","298","-80"
"1985","Kansas","6","6","0","0.50000","294","281","13"
"1986","Pittsburgh (PA)","6","4","1","0.59091","253","209","44"
"1987","Pittsburgh (PA)","8","4","0","0.66667","230","146","84"
"1988","Pittsburgh (PA)","6","5","0","0.54545","300","183","117"
"1989","Pittsburgh (PA)","7","3","1","0.68182","302","240","62"
"1986","Kansas","3","8","0","0.27273","112","327","-215"
"1987","Kansas","1","9","1","0.13636","135","398","-263"
"1986","Kent St. (OH)","5","6","0","0.45455","179","288","-109"
"1987","Kent St. (OH)","7","4","0","0.63636","233","212","21"
"1988","Kansas","1","10","0","0.09091","189","496","-307"
"1989","Kansas","4","7","0","0.36364","248","383","-135"
"1990","Kansas","3","7","1","0.31818","213","365","-152"
"1991","Kansas","6","5","0","0.54545","313","244","69"
"1992","Kansas","8","4","0","0.66667","373","262","111"
"1993","Kansas","5","7","0","0.41667","242","256","-14"
"1994","Kansas","6","5","0","0.54545","314","242","72"
"1995","Kansas","10","2","0","0.83333","345","261","84"
"1996","Kansas","4","7","0","0.36364","300","358","-58"
"1997","Minnesota","3","9","0","0.25000","238","334","-96"
"1998","Minnesota","5","6","0","0.45455","229","249","-20"
"1999","Minnesota","8","4","0","0.66667","368","196","172"
"2000","Minnesota","6","6","0","0.50000","375","318","57"
"2001","Minnesota","4","7","0","0.36364","308","299","9"
"2002","Minnesota","8","5","0","0.61538","376","319","57"
"2003","Minnesota","10","3","0","0.76923","503","285","218"
"2004","Minnesota","7","5","0","0.58333","361","273","88"
"2005","Minnesota","7","5","0","0.58333","429","348","81"
"2006","Minnesota","6","7","0","0.46154","376","338","38"
"1989","Northern Iowa","8","3","0","0.72727","302","211","91"
"1990","Northern Iowa","8","4","0","0.66667","334","209","125"
"1991","Northern Iowa","11","2","0","0.84615","417","220","197"
"1992","Northern Iowa","12","2","0","0.85714","405","202","203"
"1993","Northern Iowa","8","4","0","0.66667","350","238","112"
"1994","Northern Iowa","8","4","0","0.66667","271","204","67"
"1995","Northern Iowa","8","5","0","0.61538","337","236","101"
"1996","Northern Iowa","12","2","0","0.85714","457","255","202"
"1997","Kansas","5","6","0","0.45455","177","279","-102"
"1998","Kansas","4","7","0","0.36364","280","341","-61"
"1999","Kansas","5","7","0","0.41667","294","354","-60"
"2000","Kansas","4","7","0","0.36364","261","359","-98"
"2001","Kansas","3","8","0","0.27273","182","398","-216"
"2006","Missouri St.","2","9","0","0.18182","194","308","-114"
"2007","Missouri St.","6","5","0","0.54545","399","388","11"
"2008","Missouri St.","4","7","0","0.36364","266","389","-123"
"2009","Missouri St.","6","5","0","0.54545","217","246","-29"
"2010","Missouri St.","5","6","0","0.45455","334","374","-40"
"2011","Missouri St.","2","9","0","0.18182","222","408","-186"
"2012","Missouri St.","3","8","0","0.27273","192","279","-87"
"2013","Missouri St.","5","7","0","0.41667","328","276","52"
"2002","Kansas","2","10","0","0.16667","248","507","-259"
"2003","Kansas","6","7","0","0.46154","384","396","-12"
"2004","Kansas","4","7","0","0.36364","262","235","27"
"2005","Kansas","7","5","0","0.58333","269","264","5"
"2006","Kansas","6","6","0","0.50000","348","306","42"
"2007","Kansas","12","1","0","0.92308","556","213","343"
"2008","Kansas","8","5","0","0.61538","434","375","59"
"2009","Kansas","5","7","0","0.41667","353","341","12"
"2006","Buffalo (NY)","2","10","0","0.16667","220","431","-211"
"2007","Buffalo (NY)","5","7","0","0.41667","291","331","-40"
"2008","Buffalo (NY)","8","6","0","0.57143","424","395","29"
"2009","Buffalo (NY)","5","7","0","0.41667","289","285","4"
"2010","Kansas","3","9","0","0.25000","205","413","-208"
"2011","Kansas","2","10","0","0.16667","268","525","-257"
"2012","Liberty (VA)","6","5","0","0.54545","299","244","55"
"2013","Liberty (VA)","8","4","0","0.66667","447","211","236"
"2005","Notre Dame (IN)","9","3","0","0.75000","440","294","146"
"2006","Notre Dame (IN)","10","3","0","0.76923","403","310","93"
"2007","Notre Dame (IN)","3","9","0","0.25000","197","345","-148"
"2008","Notre Dame (IN)","7","6","0","0.53846","321","288","33"
"2009","Notre Dame (IN)","6","6","0","0.50000","361","311","50"
"2012","Kansas","1","11","0","0.08333","219","433","-214"
"2013","Kansas","3","9","0","0.25000","184","382","-198"
"1896","Kansas St.","0","1","1","0.25000","6","20","-14"
"1897","Kansas St.","1","2","1","0.37500","4","40","-36"
"1898","Kansas St.","1","1","2","0.50000","32","16","16"
"1899","Kansas St.","2","3","0","0.40000","23","72","-49"
"1900","Kansas St.","2","4","0","0.33333","47","100","-53"
"1901","Kansas St.","3","4","1","0.43750","65","87","-22"
"1902","Kansas St.","2","6","0","0.25000","46","121","-75"
"1902","Drake (IA)","4","3","1","0.56250","121","29","92"
"1903","Kansas St.","3","4","1","0.43750","56","103","-47"
"1904","Kansas St.","1","6","0","0.14286","48","186","-138"
"1905","Kansas St.","6","2","0","0.75000","140","51","89"
"1906","Kansas St.","5","2","0","0.71429","103","37","66"
"1907","Kansas St.","5","3","0","0.62500","135","56","79"
"1908","Kansas St.","6","2","0","0.75000","182","74","108"
"1909","Kansas St.","7","2","0","0.77778","320","11","309"
"1910","Kansas St.","10","1","0","0.90909","336","28","308"
"1910","Alabama","4","4","0","0.50000","65","107","-42"
"1911","Kansas St.","5","4","1","0.55000","47","87","-40"
"1912","Kansas St.","8","2","0","0.80000","204","103","101"
"1913","Kansas St.","3","4","1","0.43750","97","122","-25"
"1914","Kansas St.","1","5","1","0.21429","44","150","-106"
"1918","Wisconsin","3","3","0","0.50000","42","44","-2"
"1906","Washington St.","6","0","0","1.00000","44","0","44"
"1907","Washington St.","7","1","0","0.87500","282","19","263"
"1912","Washington St.","2","3","0","0.40000","17","71","-54"
"1913","Washington St.","4","4","0","0.50000","111","61","50"
"1914","Washington St.","2","4","0","0.33333","10","75","-65"
"1915","Kansas St.","3","4","1","0.43750","43","84","-41"
"1916","Tennessee","8","0","1","0.94444","168","19","149"
"1919","Tennessee","3","3","3","0.50000","103","62","41"
"1920","Tennessee","7","2","0","0.77778","243","40","203"
"1911","Tennessee","3","4","2","0.44444","82","93","-11"
"1912","Tennessee","4","4","0","0.50000","294","80","214"
"1913","Tennessee","6","3","0","0.66667","283","37","246"
"1914","Tennessee","9","0","0","1.00000","374","37","337"
"1915","Tennessee","4","4","0","0.50000","303","58","245"
"1916","Kansas St.","6","1","1","0.81250","154","36","118"
"1917","Kansas St.","6","2","0","0.75000","215","25","190"
"1918","Kansas St.","4","1","0","0.80000","95","29","66"
"1919","Kansas St.","3","5","1","0.38889","72","109","-37"
"1919","Northwestern (IL)","2","5","0","0.28571","49","111","-62"
"1920","Kansas St.","3","3","3","0.50000","93","55","38"
"1921","Kansas St.","5","3","0","0.62500","84","64","20"
"1922","Kansas St.","5","1","2","0.75000","154","61","93"
"1923","Kansas St.","4","2","2","0.62500","107","72","35"
"1924","Kansas St.","3","4","1","0.43750","68","79","-11"
"1925","Kansas St.","5","2","1","0.68750","70","43","27"
"1926","Kansas St.","5","3","0","0.62500","85","42","43"
"1927","Kansas St.","3","5","0","0.37500","101","146","-45"
"1928","Florida","8","1","0","0.88889","336","44","292"
"1929","Florida","8","2","0","0.80000","187","73","114"
"1930","Florida","6","3","1","0.65000","199","60","139"
"1931","Florida","2","6","2","0.30000","73","168","-95"
"1932","Florida","3","6","0","0.33333","108","136","-28"
"1933","Michigan St.","4","2","2","0.62500","73","49","24"
"1934","Michigan St.","8","1","0","0.88889","153","56","97"
"1935","Michigan St.","6","2","0","0.75000","207","57","150"
"1936","Michigan St.","6","1","2","0.77778","143","40","103"
"1937","Michigan St.","8","2","0","0.80000","117","42","75"
"1938","Michigan St.","6","3","0","0.66667","133","59","74"
"1939","Michigan St.","4","4","1","0.50000","102","92","10"
"1940","Michigan St.","3","4","1","0.43750","108","76","32"
"1941","Michigan St.","5","3","1","0.61111","150","77","73"
"1942","Michigan St.","4","3","2","0.55556","120","99","21"
"1944","Michigan St.","6","1","0","0.85714","167","31","136"
"1945","Michigan St.","5","3","1","0.61111","120","128","-8"
"1946","Michigan St.","5","5","0","0.50000","181","202","-21"
"1922","Centenary (LA)","8","1","0","0.88889","295","41","254"
"1923","Centenary (LA)","10","2","0","0.83333","371","40","331"
"1924","Centenary (LA)","8","1","0","0.88889","177","59","118"
"1928","Kansas St.","3","5","0","0.37500","94","94","0"
"1929","Kansas St.","3","5","0","0.37500","55","102","-47"
"1930","Kansas St.","5","3","0","0.62500","91","66","25"
"1931","Kansas St.","8","2","0","0.80000","162","39","123"
"1932","Kansas St.","4","4","0","0.50000","160","80","80"
"1933","Kansas St.","6","2","1","0.72222","105","29","76"
"1934","Indiana","3","3","2","0.50000","67","110","-43"
"1935","Indiana","4","3","1","0.56250","70","55","15"
"1936","Indiana","5","2","1","0.68750","123","63","60"
"1937","Indiana","5","3","0","0.62500","72","32","40"
"1938","Indiana","1","6","1","0.18750","21","67","-46"
"1939","Indiana","2","4","2","0.37500","70","96","-26"
"1940","Indiana","3","5","0","0.37500","69","100","-31"
"1941","Indiana","2","6","0","0.25000","101","126","-25"
"1942","Indiana","7","3","0","0.70000","256","79","177"
"1943","Indiana","4","4","2","0.50000","193","106","87"
"1944","Indiana","7","3","0","0.70000","292","79","213"
"1945","Indiana","9","0","1","0.95000","279","56","223"
"1946","Indiana","6","3","0","0.66667","129","95","34"
"1947","Indiana","5","3","1","0.61111","156","102","54"
"1929","Oklahoma St.","4","3","2","0.55556","107","79","28"
"1930","Oklahoma St.","7","2","1","0.75000","124","40","84"
"1931","Oklahoma St.","8","2","1","0.77273","183","52","131"
"1932","Oklahoma St.","9","1","2","0.83333","178","48","130"
"1933","Oklahoma St.","6","2","1","0.72222","132","57","75"
"1934","Kansas St.","7","2","1","0.75000","149","81","68"
"1935","Northwestern (IL)","4","3","1","0.56250","90","79","11"
"1936","Northwestern (IL)","7","1","0","0.87500","132","73","59"
"1937","Northwestern (IL)","4","4","0","0.50000","68","40","28"
"1938","Northwestern (IL)","4","2","2","0.62500","93","32","61"
"1939","Northwestern (IL)","3","4","1","0.43750","47","67","-20"
"1940","Northwestern (IL)","6","2","0","0.75000","170","64","106"
"1941","Northwestern (IL)","5","3","0","0.62500","173","67","106"
"1942","Northwestern (IL)","1","9","0","0.10000","96","209","-113"
"1943","Northwestern (IL)","6","2","0","0.75000","189","64","125"
"1944","Northwestern (IL)","1","7","1","0.16667","102","160","-58"
"1945","Northwestern (IL)","4","4","1","0.50000","127","148","-21"
"1946","Northwestern (IL)","4","4","1","0.50000","156","136","20"
"1947","California","9","1","0","0.90000","275","111","164"
"1948","California","10","1","0","0.90909","291","100","191"
"1949","California","10","1","0","0.90909","319","131","188"
"1950","California","9","1","1","0.86364","224","90","134"
"1951","California","8","2","0","0.80000","307","166","141"
"1952","California","7","3","0","0.70000","247","127","120"
"1953","California","4","4","2","0.50000","220","170","50"
"1954","California","5","5","0","0.50000","249","177","72"
"1955","California","2","7","1","0.25000","107","216","-109"
"1956","California","3","7","0","0.30000","135","181","-46"
"1935","Kansas St.","2","4","3","0.38889","40","49","-9"
"1936","Kansas St.","4","3","2","0.55556","137","89","48"
"1937","Kansas St.","4","5","0","0.44444","76","84","-8"
"1938","Kansas St.","4","4","1","0.50000","108","134","-26"
"1939","Kansas St.","4","5","0","0.44444","117","108","9"
"1940","Kansas St.","2","7","0","0.22222","73","145","-72"
"1941","Kansas St.","2","5","2","0.33333","67","168","-101"
"1946","Kansas St.","0","9","0","0.00000","41","233","-192"
"1924","Doane (NE)","1","6","1","0.18750","39","122","-83"
"1925","Doane (NE)","5","3","0","0.62500","158","30","128"
"1926","Doane (NE)","5","2","2","0.66667","180","18","162"
"1927","Doane (NE)","6","1","1","0.81250","41","13","28"
"1942","Kansas St.","3","8","0","0.27273","79","334","-255"
"1943","Kansas St.","1","7","0","0.12500","48","209","-161"
"1944","Kansas St.","2","5","2","0.33333","45","215","-170"
"1945","Kansas St.","1","7","0","0.12500","71","268","-197"
"1947","Kansas St.","0","10","0","0.00000","71","283","-212"
"1942","Wichita St. (KS)","5","4","0","0.55556","125","106","19"
"1946","Wichita St. (KS)","5","5","0","0.50000","119","135","-16"
"1947","Wichita St. (KS)","7","4","0","0.63636","270","115","155"
"1948","Kansas St.","1","9","0","0.10000","78","323","-245"
"1949","Kansas St.","2","8","0","0.20000","191","257","-66"
"1950","Kansas St.","1","9","1","0.13636","122","355","-233"
"1951","Kansas St.","0","9","0","0.00000","73","228","-155"
"1952","Kansas St.","1","9","0","0.10000","81","255","-174"
"1953","Kansas St.","6","3","1","0.65000","198","116","82"
"1954","Kansas St.","7","3","0","0.70000","191","154","37"
"1955","Houston (TX)","6","4","0","0.60000","176","139","37"
"1956","Houston (TX)","7","2","1","0.75000","185","90","95"
"1957","Southern Methodist (TX)","4","5","1","0.45000","127","175","-48"
"1958","Southern Methodist (TX)","6","4","0","0.60000","203","134","69"
"1959","Southern Methodist (TX)","5","4","1","0.55000","147","133","14"
"1960","Southern Methodist (TX)","0","9","1","0.05000","31","221","-190"
"1961","Southern Methodist (TX)","2","7","1","0.25000","92","191","-99"
"1968","Utah","3","7","0","0.30000","162","234","-72"
"1969","Utah","8","2","0","0.80000","231","107","124"
"1970","Utah","6","4","0","0.60000","208","176","32"
"1971","Utah","3","8","0","0.27273","244","315","-71"
"1972","Utah","6","5","0","0.54545","354","336","18"
"1973","Utah","7","5","0","0.58333","385","344","41"
"1955","Kansas St.","4","6","0","0.40000","165","191","-26"
"1956","Kansas St.","3","7","0","0.30000","143","259","-116"
"1957","Kansas St.","3","6","1","0.35000","124","166","-42"
"1958","Kansas St.","3","7","0","0.30000","110","192","-82"
"1959","Kansas St.","2","8","0","0.20000","109","266","-157"
"1960","Drake (IA)","4","5","0","0.44444","86","169","-83"
"1961","Drake (IA)","5","4","0","0.55556","140","119","21"
"1962","Drake (IA)","8","2","0","0.80000","204","108","96"
"1963","Drake (IA)","4","4","0","0.50000","133","121","12"
"1964","Drake (IA)","6","4","0","0.60000","208","186","22"
"1960","Kansas St.","1","9","0","0.10000","78","316","-238"
"1961","Kansas St.","2","8","0","0.20000","58","232","-174"
"1962","Kansas St.","0","10","0","0.00000","39","283","-244"
"1963","Kansas St.","2","7","0","0.22222","91","222","-131"
"1964","Kansas St.","3","7","0","0.30000","64","186","-122"
"1965","Kansas St.","0","10","0","0.00000","43","296","-253"
"1966","Kansas St.","0","9","1","0.05000","66","226","-160"
"1974","Southern Illinois","2","9","0","0.18182","147","302","-155"
"1975","Southern Illinois","1","9","1","0.13636","179","364","-185"
"1967","Kansas St.","1","9","0","0.10000","90","263","-173"
"1968","Kansas St.","4","6","0","0.40000","194","247","-53"
"1969","Kansas St.","5","5","0","0.50000","316","233","83"
"1970","Kansas St.","6","5","0","0.54545","190","218","-28"
"1971","Kansas St.","5","6","0","0.45455","219","296","-77"
"1972","Kansas St.","3","8","0","0.27273","169","407","-238"
"1973","Kansas St.","5","6","0","0.45455","176","260","-84"
"1974","Kansas St.","4","7","0","0.36364","193","283","-90"
"1975","Louisville (KY)","2","9","0","0.18182","148","316","-168"
"1976","Louisville (KY)","5","6","0","0.45455","177","234","-57"
"1977","Louisville (KY)","7","4","1","0.62500","291","194","97"
"1978","Louisville (KY)","7","4","0","0.63636","319","202","117"
"1979","Louisville (KY)","4","6","1","0.40909","167","202","-35"
"1980","Tulane (LA)","7","5","0","0.58333","279","243","36"
"1981","Tulane (LA)","6","5","0","0.54545","213","144","69"
"1982","Tulane (LA)","4","7","0","0.36364","201","271","-70"
"1966","Southern Illinois","4","5","1","0.45000","152","196","-44"
"1975","Kansas St.","3","8","0","0.27273","89","248","-159"
"1976","Kansas St.","1","10","0","0.09091","155","347","-192"
"1977","Kansas St.","2","9","0","0.18182","131","286","-155"
"1978","Kansas St.","4","7","0","0.36364","201","342","-141"
"1979","Kansas St.","3","8","0","0.27273","154","225","-71"
"1980","Kansas St.","3","8","0","0.27273","129","212","-83"
"1981","Kansas St.","2","9","0","0.18182","164","297","-133"
"1982","Kansas St.","6","5","1","0.54167","230","180","50"
"1983","Kansas St.","3","8","0","0.27273","186","343","-157"
"1984","Kansas St.","3","7","1","0.31818","185","330","-145"
"1985","Kansas St.","1","10","0","0.09091","101","295","-194"
"1978","Wabash (IN)","8","1","0","0.88889","171","59","112"
"1979","Wabash (IN)","8","1","0","0.88889","288","76","212"
"1980","Wabash (IN)","8","0","1","0.94444","293","57","236"
"1981","Wabash (IN)","8","1","0","0.88889","272","73","199"
"1982","Wabash (IN)","10","0","0","1.00000","293","117","176"
"1984","Marshall (WV)","6","5","0","0.54545","238","226","12"
"1985","Marshall (WV)","7","3","1","0.68182","193","197","-4"
"1986","Kansas St.","2","9","0","0.18182","134","343","-209"
"1987","Kansas St.","0","10","1","0.04545","135","421","-286"
"1988","Kansas St.","0","11","0","0.00000","171","448","-277"
"2008","Ball St. (IN)","0","1","0","0.00000","13","45","-32"
"2009","Ball St. (IN)","2","10","0","0.16667","230","338","-108"
"2010","Ball St. (IN)","4","8","0","0.33333","264","365","-101"
"2013","Eastern Michigan","1","2","0","0.33333","52","132","-80"
"1989","Kansas St.","1","10","0","0.09091","134","349","-215"
"1990","Kansas St.","5","6","0","0.45455","255","293","-38"
"1991","Kansas St.","7","4","0","0.63636","263","226","37"
"1992","Kansas St.","5","6","0","0.45455","195","233","-38"
"1993","Kansas St.","9","2","1","0.79167","340","227","113"
"1994","Kansas St.","9","3","0","0.75000","312","168","144"
"1995","Kansas St.","10","2","0","0.83333","456","166","290"
"1996","Kansas St.","9","3","0","0.75000","340","191","149"
"1997","Kansas St.","11","1","0","0.91667","418","177","241"
"1998","Kansas St.","11","2","0","0.84615","610","197","413"
"1999","Kansas St.","11","1","0","0.91667","457","164","293"
"2000","Kansas St.","11","3","0","0.78571","549","261","288"
"2001","Kansas St.","6","6","0","0.50000","330","205","125"
"2002","Kansas St.","11","2","0","0.84615","582","154","428"
"2003","Kansas St.","11","4","0","0.73333","549","244","305"
"2004","Kansas St.","4","7","0","0.36364","326","337","-11"
"2005","Kansas St.","5","6","0","0.45455","289","305","-16"
"2009","Kansas St.","6","6","0","0.50000","276","280","-4"
"2010","Kansas St.","7","6","0","0.53846","437","378","59"
"2011","Kansas St.","10","3","0","0.76923","413","363","50"
"2012","Kansas St.","11","2","0","0.84615","505","288","217"
"2013","Kansas St.","8","5","0","0.61538","432","298","134"
"2006","Kansas St.","7","6","0","0.53846","296","309","-13"
"2007","Kansas St.","5","7","0","0.41667","422","370","52"
"2008","Kansas St.","5","7","0","0.41667","419","430","-11"
"1920","Kent St. (OH)","1","2","0","0.33333","7","13","-6"
"1921","Kent St. (OH)","0","2","1","0.16667","0","20","-20"
"1922","Kent St. (OH)","0","7","0","0.00000","0","146","-146"
"1923","Kent St. (OH)","0","5","0","0.00000","6","260","-254"
"1924","Kent St. (OH)","0","4","0","0.00000","0","89","-89"
"1925","Kent St. (OH)","1","1","3","0.50000","13","24","-11"
"1926","Kent St. (OH)","2","6","0","0.25000","35","176","-141"
"1927","Kent St. (OH)","1","5","1","0.21429","25","80","-55"
"1928","Kent St. (OH)","4","2","2","0.62500","89","32","57"
"1929","Kent St. (OH)","1","7","0","0.12500","20","161","-141"
"1930","Kent St. (OH)","3","3","1","0.50000","64","42","22"
"1931","Kent St. (OH)","3","4","0","0.42857","59","80","-21"
"1932","Kent St. (OH)","0","5","2","0.14286","0","80","-80"
"1933","Kent St. (OH)","2","2","3","0.50000","31","31","0"
"1934","Kent St. (OH)","2","3","3","0.43750","45","90","-45"
"1935","Kent St. (OH)","3","5","0","0.37500","127","108","19"
"1936","Kent St. (OH)","4","4","0","0.50000","103","59","44"
"1937","Kent St. (OH)","3","4","1","0.43750","78","73","5"
"1938","Kent St. (OH)","6","2","0","0.75000","174","69","105"
"1939","Kent St. (OH)","3","4","1","0.43750","66","140","-74"
"1940","Kent St. (OH)","8","1","0","0.88889","186","43","143"
"1941","Kent St. (OH)","2","5","1","0.31250","109","100","9"
"1942","Kent St. (OH)","5","3","0","0.62500","114","113","1"
"1946","Kent St. (OH)","6","2","0","0.75000","143","47","96"
"1947","Kent St. (OH)","4","4","0","0.50000","89","95","-6"
"1948","Kent St. (OH)","6","2","1","0.72222","227","89","138"
"1949","Kent St. (OH)","5","3","0","0.62500","166","126","40"
"1950","Kent St. (OH)","5","4","0","0.55556","215","120","95"
"1951","Kent St. (OH)","4","3","2","0.55556","241","162","79"
"1952","Kent St. (OH)","5","4","0","0.55556","204","180","24"
"1953","Kent St. (OH)","7","2","0","0.77778","250","103","147"
"1954","Kent St. (OH)","8","2","0","0.80000","331","130","201"
"1955","Kent St. (OH)","6","2","1","0.72222","184","87","97"
"1956","Kent St. (OH)","7","2","0","0.77778","208","76","132"
"1957","Kent St. (OH)","3","6","0","0.33333","114","138","-24"
"1958","Kent St. (OH)","7","2","0","0.77778","137","95","42"
"1959","Kent St. (OH)","5","3","0","0.62500","144","124","20"
"1960","Kent St. (OH)","6","3","0","0.66667","118","129","-11"
"1961","Kent St. (OH)","2","8","0","0.20000","126","181","-55"
"1962","Kent St. (OH)","3","6","0","0.33333","107","185","-78"
"1963","Kent St. (OH)","3","5","1","0.38889","107","122","-15"
"1964","Kent St. (OH)","3","5","1","0.38889","87","121","-34"
"1965","Kent St. (OH)","5","4","1","0.55000","144","114","30"
"1966","Kent St. (OH)","4","6","0","0.40000","211","161","50"
"1967","Kent St. (OH)","4","6","0","0.40000","195","144","51"
"1968","Kent St. (OH)","1","9","0","0.10000","101","230","-129"
"1969","Kent St. (OH)","5","5","0","0.50000","166","198","-32"
"1970","Kent St. (OH)","3","7","0","0.30000","161","222","-61"
"1971","Kent St. (OH)","3","8","0","0.27273","169","304","-135"
"1972","Kent St. (OH)","6","5","1","0.54167","191","196","-5"
"1973","Kent St. (OH)","9","2","0","0.81818","300","131","169"
"1974","Kent St. (OH)","7","4","0","0.63636","254","161","93"
"1975","Washington","6","5","0","0.54545","196","250","-54"
"1976","Washington","5","6","0","0.45455","237","207","30"
"1977","Washington","10","2","0","0.83333","344","194","150"
"1978","Washington","7","4","0","0.63636","270","155","115"
"1979","Washington","10","2","0","0.83333","321","154","167"
"1980","Washington","9","3","0","0.75000","333","198","135"
"1981","Washington","10","2","0","0.83333","281","171","110"
"1982","Washington","10","2","0","0.83333","354","193","161"
"1983","Washington","8","4","0","0.66667","285","178","107"
"1984","Washington","11","1","0","0.91667","352","145","207"
"1985","Washington","7","5","0","0.58333","238","225","13"
"1986","Washington","8","3","1","0.70833","378","197","181"
"1987","Washington","7","4","1","0.62500","295","254","41"
"1988","Washington","6","5","0","0.54545","254","223","31"
"1989","Washington","8","4","0","0.66667","332","225","107"
"1990","Washington","10","2","0","0.83333","440","184","256"
"1991","Washington","12","0","0","1.00000","495","115","380"
"1992","Washington","9","3","0","0.75000","337","186","151"
"1975","Kent St. (OH)","4","7","0","0.36364","202","289","-87"
"1976","Kent St. (OH)","8","4","0","0.66667","280","206","74"
"1977","Kent St. (OH)","6","5","0","0.54545","200","241","-41"
"1978","Kent St. (OH)","4","7","0","0.36364","158","248","-90"
"1979","Kent St. (OH)","1","10","0","0.09091","127","298","-171"
"1980","Kent St. (OH)","3","8","0","0.27273","159","279","-120"
"1976","Eastern Michigan","2","9","0","0.18182","132","355","-223"
"1977","Eastern Michigan","8","3","0","0.72727","239","195","44"
"1978","Boston College (MA)","0","11","0","0.00000","153","294","-141"
"1979","Boston College (MA)","5","6","0","0.45455","215","217","-2"
"1980","Boston College (MA)","7","4","0","0.63636","199","186","13"
"1981","Kent St. (OH)","4","7","0","0.36364","144","172","-28"
"1982","Kent St. (OH)","0","11","0","0.00000","114","270","-156"
"1983","Kent St. (OH)","1","10","0","0.09091","157","260","-103"
"1984","Kent St. (OH)","4","7","0","0.36364","135","199","-64"
"1985","Kent St. (OH)","3","8","0","0.27273","212","277","-65"
"1986","Kent St. (OH)","5","6","0","0.45455","179","288","-109"
"1987","Kent St. (OH)","7","4","0","0.63636","233","212","21"
"1988","Kansas","1","10","0","0.09091","189","496","-307"
"1989","Kansas","4","7","0","0.36364","248","383","-135"
"1990","Kansas","3","7","1","0.31818","213","365","-152"
"1991","Kansas","6","5","0","0.54545","313","244","69"
"1992","Kansas","8","4","0","0.66667","373","262","111"
"1993","Kansas","5","7","0","0.41667","242","256","-14"
"1994","Kansas","6","5","0","0.54545","314","242","72"
"1995","Kansas","10","2","0","0.83333","345","261","84"
"1996","Kansas","4","7","0","0.36364","300","358","-58"
"1997","Minnesota","3","9","0","0.25000","238","334","-96"
"1998","Minnesota","5","6","0","0.45455","229","249","-20"
"1999","Minnesota","8","4","0","0.66667","368","196","172"
"2000","Minnesota","6","6","0","0.50000","375","318","57"
"2001","Minnesota","4","7","0","0.36364","308","299","9"
"2002","Minnesota","8","5","0","0.61538","376","319","57"
"2003","Minnesota","10","3","0","0.76923","503","285","218"
"2004","Minnesota","7","5","0","0.58333","361","273","88"
"2005","Minnesota","7","5","0","0.58333","429","348","81"
"2006","Minnesota","6","7","0","0.46154","376","338","38"
"1974","Miami (OH)","10","0","1","0.95455","303","86","217"
"1975","Miami (OH)","11","1","0","0.91667","306","141","165"
"1976","Miami (OH)","3","8","0","0.27273","160","208","-48"
"1977","Miami (OH)","10","1","0","0.90909","262","173","89"
"1978","North Carolina","5","6","0","0.45455","199","218","-19"
"1979","North Carolina","8","3","1","0.70833","290","167","123"
"1980","North Carolina","11","1","0","0.91667","297","130","167"
"1981","North Carolina","10","2","0","0.83333","375","150","225"
"1982","North Carolina","8","4","0","0.66667","348","149","199"
"1983","North Carolina","8","4","0","0.66667","337","216","121"
"1984","North Carolina","5","5","1","0.50000","234","274","-40"
"1985","North Carolina","5","6","0","0.45455","224","223","1"
"1986","North Carolina","7","4","1","0.62500","305","279","26"
"1987","North Carolina","5","6","0","0.45455","214","207","7"
"1988","Kent St. (OH)","5","6","0","0.45455","256","250","6"
"1989","Kent St. (OH)","0","11","0","0.00000","179","377","-198"
"1990","Kent St. (OH)","2","9","0","0.18182","177","328","-151"
"1991","Kent St. (OH)","1","10","0","0.09091","159","307","-148"
"1992","Kent St. (OH)","2","9","0","0.18182","133","301","-168"
"1993","Kent St. (OH)","0","11","0","0.00000","149","357","-208"
"1994","Kent St. (OH)","2","9","0","0.18182","140","293","-153"
"1995","Kent St. (OH)","1","9","1","0.13636","128","390","-262"
"1996","Kent St. (OH)","2","9","0","0.18182","255","492","-237"
"1997","Kent St. (OH)","3","8","0","0.27273","337","490","-153"
"1998","Kent St. (OH)","0","11","0","0.00000","149","454","-305"
"1999","Kent St. (OH)","2","9","0","0.18182","213","376","-163"
"2000","Kent St. (OH)","1","10","0","0.09091","128","359","-231"
"2001","Kent St. (OH)","6","5","0","0.54545","248","281","-33"
"2002","Kent St. (OH)","3","9","0","0.25000","202","424","-222"
"2003","Kent St. (OH)","5","7","0","0.41667","321","396","-75"
"2004","Kent St. (OH)","5","6","0","0.45455","335","264","71"
"2005","Kent St. (OH)","1","10","0","0.09091","180","331","-151"
"2006","Kent St. (OH)","6","6","0","0.50000","214","241","-27"
"2007","Kent St. (OH)","3","9","0","0.25000","259","350","-91"
"2008","Kent St. (OH)","4","8","0","0.33333","308","380","-72"
"2009","Kent St. (OH)","5","7","0","0.41667","231","269","-38"
"2010","Kent St. (OH)","5","7","0","0.41667","256","275","-19"
"2013","New Mexico St.","2","10","0","0.16667","251","535","-284"
"2011","Kent St. (OH)","5","7","0","0.41667","205","291","-86"
"2012","Kent St. (OH)","11","3","0","0.78571","463","343","120"
"2013","Purdue (IN)","1","11","0","0.08333","179","456","-277"
"2013","Kent St. (OH)","4","8","0","0.33333","249","323","-74"
"1872","Stevens Tech (NJ)","0","1","0","0.00000","0","6","-6"
"1873","New York (NY)","3","3","0","0.50000","15","13","2"
"1874","Stevens Tech (NJ)","2","3","0","0.40000","10","20","-10"
"1875","Stevens Tech (NJ)","4","4","0","0.50000","21","20","1"
"1876","New York (NY)","2","3","1","0.41667","16","19","-3"
"1877","Stevens Tech (NJ)","3","1","2","0.66667","9","14","-5"
"1878","Stevens Tech (NJ)","3","3","3","0.50000","3","9","-6"
"1879","Stevens Tech (NJ)","2","3","5","0.45000","8","14","-6"
"1880","Stevens Tech (NJ)","1","5","0","0.16667","3","16","-13"
"1881","Stevens Tech (NJ)","3","8","3","0.32143","16","29","-13"
"1882","Lawrence (WI)","7","8","1","0.46875","17","25","-8"
"1883","Stevens Tech (NJ)","7","6","1","0.53571","187","128","59"
"1884","Fordham (NY)","9","10","0","0.47368","221","261","-40"
"1885","Georgetown (DC)","5","17","1","0.23913","359","612","-253"
"1886","New York (NY)","9","15","2","0.38462","180","565","-385"
"1887","Fordham (NY)","8","12","1","0.40476","157","445","-288"
"1888","Amherst (MA)","6","17","3","0.28846","192","791","-599"
"1889","New York (NY)","8","21","4","0.30303","278","647","-369"
"1890","New York (NY)","25","14","2","0.63415","727","538","189"
"1891","Delaware","32","30","7","0.51449","966","971","-5"
"1892","Beloit (WI)","29","31","3","0.48413","726","797","-71"
"1893","Marquette (WI)","39","34","3","0.53289","1091","885","206"
"1894","Manhattan (NY)","32","29","7","0.52206","853","692","161"
"1895","Delaware","44","35","6","0.55294","889","813","76"
"1896","Manhattan (NY)","51","49","6","0.50943","949","1164","-215"
"1897","Stevens Tech (NJ)","37","50","4","0.42857","661","1048","-387"
"1898","Manhattan (NY)","37","43","9","0.46629","781","1050","-269"
"1899","Manhattan (NY)","34","40","6","0.46250","594","1063","-469"
"1900","Manhattan (NY)","43","47","11","0.48020","991","1049","-58"
"1901","Ferris St. (MI)","51","44","7","0.53431","906","852","54"
"1902","Indiana St.","56","48","5","0.53670","1053","927","126"
"1903","Manhattan (NY)","30","49","7","0.38953","762","1319","-557"
"1904","Saint Francis (NY)","44","53","9","0.45755","787","1363","-576"
"1905","Bluffton (OH)","38","59","5","0.39706","850","1433","-583"
"1906","Ferris St. (MI)","32","43","12","0.43678","677","854","-177"
"1907","Ferris St. (MI)","32","48","10","0.41111","722","1208","-486"
"1908","Western Illinois","36","45","10","0.45055","760","1069","-309"
"1909","Delaware Valley (PA)","27","52","2","0.34568","682","1287","-605"
"1910","East Stroudsburg (PA)","23","31","3","0.42982","583","738","-155"
"1911","Western Illinois","32","44","7","0.42771","661","902","-241"
"1912","Indiana (PA)","36","56","7","0.39899","1134","1463","-329"
"1913","Saint Francis (NY)","52","67","8","0.44094","1672","2360","-688"
"1914","Delaware Valley (PA)","41","50","6","0.45361","1217","1585","-368"
"1915","Western Illinois","34","35","11","0.49375","932","1217","-285"
"1916","Morgan St. (MD)","44","43","7","0.50532","1493","1270","223"
"1917","Morgan St. (MD)","21","21","2","0.50000","408","883","-475"
"1918","Oklahoma Baptist University","7","16","2","0.32000","258","358","-100"
"1919","Western Illinois","53","41","8","0.55882","1478","1056","422"
"1920","Virginia Union","28","39","2","0.42029","506","893","-387"
"1921","Cooper Union (NY)","19","34","3","0.36607","441","1112","-671"
"1922","Cooper Union (NY)","27","34","6","0.44776","703","832","-129"
"1923","Cooper Union (NY)","31","45","2","0.41026","718","1112","-394"
"1924","East Stroudsburg (PA)","34","40","6","0.46250","946","1175","-229"
"1925","Saint Anselm (NH)","32","28","10","0.52857","847","802","45"
"1926","Saint Anselm (NH)","22","30","4","0.42857","515","702","-187"
"1927","Bethune-Cookman (FL)","20","29","8","0.42105","674","783","-109"
"1928","Saint Anselm (NH)","28","24","7","0.53390","564","1095","-531"
"1929","Saint Anselm (NH)","25","32","5","0.44355","616","843","-227"
"1930","Saint Anselm (NH)","31","27","10","0.52941","643","549","94"
"1931","Campbell (NC)","21","17","4","0.54762","465","428","37"
"1932","Campbell (NC)","7","30","3","0.21250","254","760","-506"
"1933","Campbell (NC)","11","13","3","0.46296","262","324","-62"
"1934","Bowie St. (MD)","4","7","2","0.38462","116","94","22"
"1935","Florida Southern","7","12","1","0.37500","170","162","8"
"1936","Bowie St. (MD)","5","2","1","0.68750","154","97","57"
"1937","Bowie St. (MD)","6","3","0","0.66667","98","87","11"
"1938","West Alabama","7","5","0","0.58333","151","88","63"
"1939","Elizabeth City St. (NC)","7","13","0","0.35000","150","307","-157"
"1940","Elizabeth City St. (NC)","6","5","4","0.53333","128","67","61"
"1941","Arkansas-Pine Bluff","3","9","5","0.32353","178","223","-45"
"1942","Brevard College (NC)","10","6","2","0.61111","225","189","36"
"1943","Clark Atlanta (GA)","6","8","0","0.42857","127","206","-79"
"1944","Abilene Christian (TX)","9","11","1","0.45238","158","255","-97"
"1945","Benedict (SC)","10","15","2","0.40741","299","296","3"
"1946","Elizabeth City St. (NC)","7","20","3","0.28333","144","540","-396"
"1947","Clark Atlanta (GA)","3","6","2","0.36364","49","230","-181"
"1948","Virginia-Lynchburg","4","6","1","0.40909","77","302","-225"
"1949","Virginia-Lynchburg","0","3","1","0.12500","7","70","-63"
"1950","Virginia-Lynchburg","2","3","0","0.40000","53","98","-45"
"1951","Lane (TN)","8","6","0","0.57143","295","234","61"
"1952","Lane (TN)","9","5","1","0.63333","220","206","14"
"1953","Lane (TN)","1","7","0","0.12500","58","215","-157"
"1954","Lane (TN)","2","6","0","0.25000","105","135","-30"
"1955","Lane (TN)","2","4","0","0.33333","83","129","-46"
"1957","Louisiana College","2","7","0","0.22222","106","179","-73"
"1959","Azusa Pacific (CA)","2","3","0","0.40000","117","90","27"
"1960","Azusa Pacific (CA)","4","3","1","0.56250","103","76","27"
"1961","Azusa Pacific (CA)","3","3","0","0.50000","123","147","-24"
"1963","San Francisco (CA)","2","5","0","0.28571","58","98","-40"
"1964","New York (NY)","0","2","0","0.00000","20","48","-28"
"1965","Adelphi (NY)","4","8","0","0.33333","198","216","-18"
"1966","Fairfield (CT)","18","22","2","0.45238","545","652","-107"
"1967","La Salle (PA)","25","31","0","0.44643","846","1080","-234"
"1968","Centenary (LA)","17","42","2","0.29508","726","1393","-667"
"1969","Bluffton (OH)","33","43","0","0.43421","1058","1548","-490"
"1970","Saint John's (NY)","35","54","1","0.39444","1379","1783","-404"
"1971","Bluffton (OH)","43","45","1","0.48876","1360","1384","-24"
"1972","Marquette (WI)","39","44","2","0.47059","1217","1351","-134"
"1973","Brooklyn (NY)","30","52","1","0.36747","1007","1611","-604"
"1974","Marquette (WI)","33","36","3","0.47917","959","1169","-210"
"1975","Marquette (WI)","31","22","4","0.57895","1042","932","110"
"1976","Bluffton (OH)","23","33","1","0.41228","862","1186","-324"
"1977","Manhattan (NY)","14","28","1","0.33721","568","923","-355"
"1978","Fairfield (CT)","5","7","1","0.42308","194","203","-9"
"1979","Fairfield (CT)","7","8","0","0.46667","247","260","-13"
"1980","Westfield St. (MA)","6","5","4","0.53333","184","196","-12"
"1981","San Francisco (CA)","17","14","0","0.54839","567","498","69"
"1982","Manhattan (NY)","18","16","0","0.52941","580","644","-64"
"1983","SUNY-Stony Brook (NY)","15","11","0","0.57692","474","453","21"
"1984","Stonehill (MA)","7","12","0","0.36842","231","439","-208"
"1985","Manhattan (NY)","10","10","0","0.50000","313","316","-3"
"1986","Marquette (WI)","13","17","0","0.43333","497","564","-67"
"1987","Marquette (WI)","10","17","0","0.37037","389","487","-98"
"1988","Marquette (WI)","1","5","0","0.16667","80","125","-45"
"1989","Marquette (WI)","4","4","0","0.50000","209","151","58"
"1990","Marquette (WI)","1","7","0","0.12500","80","180","-100"
"1991","Marquette (WI)","1","5","0","0.16667","106","182","-76"
"1992","Marquette (WI)","2","5","0","0.28571","81","129","-48"
"1993","Marquette (WI)","7","1","0","0.87500","212","126","86"
"1994","Marquette (WI)","1","6","0","0.14286","125","184","-59"
"1995","Marquette (WI)","3","4","0","0.42857","141","191","-50"
"1996","Marquette (WI)","3","5","0","0.37500","139","182","-43"
"1998","Madison College (WI)","2","15","0","0.11765","221","613","-392"
"1999","Marquette (WI)","0","7","0","0.00000","110","298","-188"
"2000","Marquette (WI)","1","5","0","0.16667","60","96","-36"
"2001","Marquette (WI)","2","6","0","0.25000","144","179","-35"
"2002","Marquette (WI)","3","4","0","0.42857","127","208","-81"
"2003","Marquette (WI)","1","6","0","0.14286","71","151","-80"
"2004","Marquette (WI)","0","6","0","0.00000","53","238","-185"
"2005","Marquette (WI)","2","5","0","0.28571","92","226","-134"
"2006","Marquette (WI)","1","6","0","0.14286","62","206","-144"
"2007","Marquette (WI)","2","5","0","0.28571","140","215","-75"
"2008","Marquette (WI)","0","7","0","0.00000","61","304","-243"
"2009","Marquette (WI)","0","1","0","0.00000","0","22","-22"
"1885","Minnesota","0","2","0","0.00000","13","27","-14"
"1890","Kentucky","1","0","0","1.00000","8","2","6"
"1896","Saint John's (NY)","1","0","0","1.00000","6","0","6"
"1898","Emporia St. (KS)","0","2","0","0.00000","0","60","-60"
"1900","Boston College (MA)","1","0","0","1.00000","5","0","5"
"1901","Saint John's (NY)","0","1","0","0.00000","0","61","-61"
"1902","La Salle (PA)","0","4","0","0.00000","12","65","-53"
"1904","Louisiana-Lafayette","2","0","1","0.83333","28","4","24"
"1908","Saint John's (NY)","0","2","0","0.00000","0","18","-18"
"1909","North Carolina A&T","0","1","0","0.00000","0","11","-11"
"1910","Clarion (PA)","0","1","0","0.00000","0","39","-39"
"1917","Texas St.","1","0","0","1.00000","12","0","12"
"1924","Manhattan (NY)","4","4","0","0.50000","74","69","5"
"1929","Campbellsville (KY)","0","1","0","0.00000","6","54","-48"
"1943","William & Mary Freshmen (VA)","4","2","0","0.66667","157","56","101"
"1892","Kentucky","2","4","1","0.35714","40","74","-34"
"1893","Kentucky","5","2","1","0.68750","280","110","170"
"1894","Kentucky","5","2","0","0.71429","220","121","99"
"1895","Kentucky","4","5","0","0.44444","64","94","-30"
"1897","Colgate (NY)","5","2","1","0.68750","66","26","40"
"1898","Colgate (NY)","2","5","0","0.28571","23","78","-55"
"1896","Kentucky","3","6","0","0.33333","122","134","-12"
"1897","Kentucky","2","4","0","0.33333","28","118","-90"
"1898","Kentucky","7","0","0","1.00000","180","0","180"
"1899","Kentucky","5","2","2","0.66667","98","44","54"
"1900","Kentucky","5","5","0","0.50000","74","64","10"
"1901","Kentucky","2","6","1","0.27778","39","87","-48"
"1902","Kentucky","3","5","1","0.38889","72","83","-11"
"1901","Washington","3","3","0","0.50000","43","42","1"
"1903","Kentucky","7","1","0","0.87500","204","22","182"
"1904","Kentucky","9","1","0","0.90000","276","15","261"
"1905","Kentucky","6","3","1","0.65000","209","171","38"
"1906","Kentucky","4","3","0","0.57143","110","67","43"
"1907","Kentucky","9","1","1","0.86364","181","42","139"
"1908","Kentucky","4","3","0","0.57143","87","81","6"
"1911","Kentucky","7","3","0","0.70000","97","41","56"
"1899","Hamilton (NY)","8","2","1","0.77273","282","67","215"
"1900","Syracuse (NY)","7","2","1","0.75000","208","60","148"
"1901","Syracuse (NY)","7","1","0","0.87500","185","27","158"
"1902","Syracuse (NY)","6","2","1","0.72222","172","93","79"
"1903","Hamilton (NY)","6","3","0","0.66667","136","91","45"
"1904","Ohio St.","6","5","0","0.54545","219","123","96"
"1905","Ohio St.","8","2","2","0.75000","197","63","134"
"1908","Colgate (NY)","4","3","0","0.57143","78","25","53"
"1909","Kentucky","9","1","0","0.90000","261","29","232"
"1910","Kentucky","7","2","0","0.77778","140","29","111"
"1911","Miami (OH)","2","4","2","0.37500","57","45","12"
"1912","Kentucky","7","2","0","0.77778","250","41","209"
"1913","West Virginia","3","4","2","0.44444","109","137","-28"
"1914","Tulane (LA)","3","3","1","0.50000","145","147","-2"
"1911","Virginia Military Institute","7","1","0","0.87500","204","27","177"
"1912","Virginia Military Institute","6","1","0","0.85714","122","36","86"
"1913","Kentucky","6","2","0","0.75000","157","58","99"
"1914","Kentucky","5","3","0","0.62500","328","93","235"
"1910","Kentucky Wesleyan","1","3","1","0.30000","28","104","-76"
"1915","Kentucky","6","1","1","0.81250","149","38","111"
"1916","Kentucky","4","1","2","0.71429","152","51","101"
"1914","Texas Christian","4","4","2","0.50000","117","118","-1"
"1917","Kentucky","3","5","1","0.38889","104","56","48"
"1914","North Dakota","3","5","0","0.37500","131","96","35"
"1915","North Dakota","2","2","3","0.50000","56","58","-2"
"1916","North Dakota","5","2","0","0.71429","116","68","48"
"1917","North Dakota","2","4","0","0.33333","63","80","-17"
"1918","Kentucky","2","1","0","0.66667","45","43","2"
"1919","Kentucky","3","4","1","0.43750","31","136","-105"
"1906","South Dakota St.","3","1","0","0.75000","52","34","18"
"1907","South Dakota St.","5","2","0","0.71429","108","42","66"
"1908","Marquette (WI)","7","5","2","0.57143","238","77","161"
"1909","Marquette (WI)","2","2","1","0.50000","38","16","22"
"1910","Marquette (WI)","6","1","2","0.77778","267","11","256"
"1911","Marquette (WI)","7","0","2","0.88889","168","31","137"
"1912","Wisconsin","7","0","0","1.00000","246","29","217"
"1913","Wisconsin","3","3","1","0.50000","100","66","34"
"1914","Wisconsin","4","2","1","0.64286","102","51","51"
"1915","Wisconsin","4","3","0","0.57143","235","54","181"
"1917","Texas","4","4","0","0.50000","89","40","49"
"1918","Texas","9","0","0","1.00000","194","14","180"
"1919","Texas","6","3","0","0.66667","181","63","118"
"1920","Kentucky","3","4","1","0.43750","113","109","4"
"1921","Kentucky","4","3","1","0.56250","157","89","68"
"1922","Kentucky","6","3","0","0.66667","167","56","111"
"1923","Kentucky","4","3","2","0.55556","135","53","82"
"1914","Northwestern (IL)","1","6","0","0.14286","13","176","-163"
"1915","Northwestern (IL)","2","5","0","0.28571","69","112","-43"
"1916","Northwestern (IL)","6","1","0","0.85714","144","55","89"
"1917","Northwestern (IL)","5","2","0","0.71429","145","85","60"
"1918","Northwestern (IL)","2","2","1","0.50000","75","61","14"
"1920","Denver (CO)","2","4","0","0.33333","26","82","-56"
"1921","Denver (CO)","4","2","1","0.64286","133","78","55"
"1922","Denver (CO)","6","1","1","0.81250","107","48","59"
"1924","Kentucky","4","5","0","0.44444","129","99","30"
"1925","Kentucky","6","3","0","0.66667","92","97","-5"
"1926","Kentucky","2","6","1","0.27778","84","91","-7"
"1927","Kentucky","3","6","1","0.35000","115","161","-46"
"1928","Kentucky","4","3","1","0.56250","100","41","59"
"1929","Kentucky","6","1","1","0.81250","237","54","183"
"1930","Kentucky","5","3","0","0.62500","207","55","152"
"1931","Kentucky","5","2","2","0.66667","130","48","82"
"1932","Kentucky","4","5","0","0.44444","116","77","39"
"1933","Kentucky","5","5","0","0.50000","91","116","-25"
"1934","South Dakota","2","7","0","0.22222","62","180","-118"
"1935","South Dakota","5","3","1","0.61111","83","125","-42"
"1936","South Dakota","4","3","2","0.55556","98","89","9"
"1937","South Dakota","6","4","0","0.60000","157","65","92"
"1938","South Dakota","7","1","0","0.87500","125","40","85"
"1939","South Dakota","4","5","0","0.44444","61","106","-45"
"1940","South Dakota","4","5","1","0.45000","110","162","-52"
"1941","South Dakota","6","2","0","0.75000","159","66","93"
"1946","South Dakota","2","4","0","0.33333","38","107","-69"
"1947","South Dakota","7","2","0","0.77778","164","152","12"
"1948","South Dakota","7","3","0","0.70000","293","130","163"
"1949","South Dakota","2","5","2","0.33333","166","195","-29"
"1950","South Dakota","4","5","0","0.44444","201","180","21"
"1951","South Dakota","7","1","0","0.87500","218","107","111"
"1952","South Dakota","4","3","1","0.56250","179","192","-13"
"1953","South Dakota","2","6","0","0.25000","115","149","-34"
"1954","South Dakota","5","4","0","0.55556","243","214","29"
"1955","South Dakota","4","4","0","0.50000","194","151","43"
"1923","Creighton (NE)","5","5","0","0.50000","127","80","47"
"1924","Creighton (NE)","6","1","2","0.77778","182","57","125"
"1925","Creighton (NE)","6","3","1","0.65000","169","102","67"
"1926","Creighton (NE)","4","4","1","0.50000","107","107","0"
"1927","Creighton (NE)","6","1","1","0.81250","103","46","57"
"1928","Creighton (NE)","3","5","1","0.38889","86","119","-33"
"1929","Creighton (NE)","2","6","0","0.25000","68","183","-115"
"1930","Auburn (AL)","3","7","0","0.30000","101","135","-34"
"1931","Auburn (AL)","5","3","1","0.61111","114","78","36"
"1932","Auburn (AL)","9","0","1","0.95000","275","54","221"
"1933","Auburn (AL)","5","5","0","0.50000","133","104","29"
"1934","Kentucky","5","5","0","0.50000","123","86","37"
"1935","Kentucky","5","4","0","0.55556","167","94","73"
"1936","Kentucky","6","4","0","0.60000","179","84","95"
"1937","Kentucky","4","6","0","0.40000","93","130","-37"
"1938","Kentucky","2","7","0","0.22222","150","160","-10"
"1939","Kentucky","6","2","1","0.72222","161","64","97"
"1940","Kentucky","5","3","2","0.60000","190","107","83"
"1941","Kentucky","5","4","0","0.55556","151","154","-3"
"1942","Kentucky","3","6","1","0.35000","155","154","1"
"1944","Kentucky","3","6","0","0.33333","125","147","-22"
"1945","Kentucky","2","8","0","0.20000","96","217","-121"
"1945","Maryland","6","2","1","0.72222","219","105","114"
"1946","Kentucky","7","3","0","0.70000","233","97","136"
"1947","Kentucky","8","3","0","0.72727","175","73","102"
"1948","Kentucky","5","3","2","0.60000","199","128","71"
"1949","Kentucky","9","3","0","0.75000","317","74","243"
"1950","Kentucky","11","1","0","0.91667","393","69","324"
"1951","Kentucky","8","4","0","0.66667","314","121","193"
"1952","Kentucky","5","4","2","0.54545","161","173","-12"
"1953","Kentucky","7","2","1","0.75000","201","116","85"
"1954","Texas A&M","1","9","0","0.10000","97","177","-80"
"1955","Texas A&M","7","2","1","0.75000","160","89","71"
"1956","Texas A&M","9","0","1","0.95000","223","81","142"
"1957","Texas A&M","8","3","0","0.72727","158","50","108"
"1958","Alabama","5","4","1","0.55000","106","75","31"
"1959","Alabama","7","2","2","0.72727","95","59","36"
"1960","Alabama","8","1","2","0.81818","183","56","127"
"1961","Alabama","11","0","0","1.00000","297","25","272"
"1962","Alabama","10","1","0","0.90909","289","39","250"
"1963","Alabama","9","2","0","0.81818","227","95","132"
"1964","Alabama","10","1","0","0.90909","250","88","162"
"1965","Alabama","9","1","1","0.86364","256","107","149"
"1966","Alabama","11","0","0","1.00000","301","44","257"
"1967","Alabama","8","2","1","0.77273","204","131","73"
"1968","Alabama","8","3","0","0.72727","184","139","45"
"1969","Alabama","6","5","0","0.54545","314","268","46"
"1970","Alabama","6","5","1","0.54167","334","264","70"
"1971","Alabama","11","1","0","0.91667","368","122","246"
"1972","Alabama","10","2","0","0.83333","406","150","256"
"1973","Alabama","11","1","0","0.91667","477","113","364"
"1974","Alabama","11","1","0","0.91667","329","96","233"
"1975","Alabama","11","1","0","0.91667","374","72","302"
"1976","Alabama","9","3","0","0.75000","327","140","187"
"1977","Alabama","11","1","0","0.91667","380","139","241"
"1978","Alabama","11","1","0","0.91667","345","168","177"
"1979","Alabama","12","0","0","1.00000","383","67","316"
"1980","Alabama","10","2","0","0.83333","352","98","254"
"1981","Alabama","9","2","1","0.79167","296","151","145"
"1982","Alabama","8","4","0","0.66667","338","216","122"
"1954","Kentucky","7","3","0","0.70000","151","125","26"
"1955","Kentucky","6","3","1","0.65000","178","131","47"
"1956","Kentucky","6","4","0","0.60000","119","105","14"
"1957","Kentucky","3","7","0","0.30000","128","127","1"
"1958","Kentucky","5","4","1","0.55000","136","115","21"
"1959","Kentucky","4","6","0","0.40000","140","107","33"
"1960","Kentucky","5","4","1","0.55000","206","81","125"
"1961","Kentucky","5","5","0","0.50000","138","123","15"
"1962","Kentucky","3","5","2","0.40000","85","101","-16"
"1963","Kentucky","3","6","1","0.35000","142","168","-26"
"1964","Kentucky","5","5","0","0.50000","150","194","-44"
"1965","Kentucky","6","4","0","0.60000","202","160","42"
"1966","Kentucky","3","6","1","0.35000","107","196","-89"
"1967","Kentucky","2","8","0","0.20000","111","230","-119"
"1968","Kentucky","3","7","0","0.30000","141","206","-65"
"1976","Troy (AL)","8","1","1","0.85000","206","119","87"
"1977","Troy (AL)","6","4","0","0.60000","214","194","20"
"1978","Troy (AL)","8","2","0","0.80000","229","144","85"
"1979","Troy (AL)","6","3","1","0.65000","234","116","118"
"1980","Troy (AL)","8","2","0","0.80000","282","105","177"
"1981","Troy (AL)","3","7","0","0.30000","182","192","-10"
"1982","Troy (AL)","2","8","0","0.20000","177","210","-33"
"1969","Kentucky","2","8","0","0.20000","104","295","-191"
"1970","Kentucky","2","9","0","0.18182","131","233","-102"
"1971","Kentucky","3","8","0","0.27273","144","284","-140"
"1972","Kentucky","3","8","0","0.27273","131","232","-101"
"1971","Miami (FL)","4","7","0","0.36364","174","221","-47"
"1972","Miami (FL)","5","6","0","0.45455","214","170","44"
"1973","Kentucky","5","6","0","0.45455","226","196","30"
"1974","Kentucky","6","5","0","0.54545","248","194","54"
"1975","Kentucky","2","8","1","0.22727","132","183","-51"
"1976","Kentucky","9","3","0","0.75000","209","151","58"
"1977","Kentucky","10","1","0","0.90909","252","111","141"
"1978","Kentucky","4","6","1","0.40909","193","189","4"
"1979","Kentucky","5","6","0","0.45455","180","143","37"
"1980","Kentucky","3","8","0","0.27273","167","280","-113"
"1981","Kentucky","3","8","0","0.27273","134","222","-88"
"1961","Virginia Tech","4","5","0","0.44444","93","112","-19"
"1962","Virginia Tech","5","5","0","0.50000","137","137","0"
"1963","Virginia Tech","8","2","0","0.80000","216","126","90"
"1964","Virginia Tech","6","4","0","0.60000","224","178","46"
"1965","Virginia Tech","7","3","0","0.70000","188","134","54"
"1966","Virginia Tech","8","2","1","0.77273","245","104","141"
"1967","Virginia Tech","7","3","0","0.70000","183","112","71"
"1968","Virginia Tech","7","4","0","0.63636","240","165","75"
"1969","Virginia Tech","4","5","1","0.45000","234","110","124"
"1970","Virginia Tech","5","6","0","0.45455","199","228","-29"
"1972","Maryland","5","5","1","0.50000","243","217","26"
"1973","Maryland","8","4","0","0.66667","335","141","194"
"1974","Maryland","8","4","0","0.66667","316","104","212"
"1975","Maryland","9","2","1","0.79167","312","150","162"
"1976","Maryland","11","1","0","0.91667","294","115","179"
"1977","Maryland","8","4","0","0.66667","254","179","75"
"1978","Maryland","9","3","0","0.75000","261","167","94"
"1979","Maryland","7","4","0","0.63636","198","135","63"
"1980","Maryland","8","4","0","0.66667","211","165","46"
"1981","Maryland","4","6","1","0.40909","232","194","38"
"1982","Kentucky","0","10","1","0.04545","96","287","-191"
"1983","Kentucky","6","5","1","0.54167","228","237","-9"
"1984","Kentucky","9","3","0","0.75000","293","221","72"
"1985","Kentucky","5","6","0","0.45455","194","211","-17"
"1986","Kentucky","5","5","1","0.50000","228","207","21"
"1987","Kentucky","5","6","0","0.45455","258","187","71"
"1988","Kentucky","5","6","0","0.45455","217","208","9"
"1989","Kentucky","6","5","0","0.54545","212","220","-8"
"1980","Georgia Tech","1","9","1","0.13636","113","260","-147"
"1981","Georgia Tech","1","10","0","0.09091","124","309","-185"
"1982","Georgia Tech","6","5","0","0.54545","239","286","-47"
"1983","Georgia Tech","3","8","0","0.27273","222","313","-91"
"1984","Georgia Tech","6","4","1","0.59091","296","201","95"
"1985","Georgia Tech","9","2","1","0.79167","252","132","120"
"1986","Georgia Tech","5","5","1","0.50000","282","211","71"
"1987","Alabama","7","5","0","0.58333","268","213","55"
"1988","Alabama","9","3","0","0.75000","317","188","129"
"1989","Alabama","10","2","0","0.83333","357","217","140"
"1990","Kentucky","4","7","0","0.36364","228","316","-88"
"1991","Kentucky","3","8","0","0.27273","190","268","-78"
"1992","Kentucky","4","7","0","0.36364","207","280","-73"
"1993","Kentucky","6","6","0","0.50000","220","209","11"
"1994","Kentucky","1","10","0","0.09091","149","405","-256"
"1995","Kentucky","4","7","0","0.36364","223","269","-46"
"1996","Kentucky","4","7","0","0.36364","138","322","-184"
"2010","Georgia St.","6","5","0","0.54545","302","286","16"
"2011","Georgia St.","3","8","0","0.27273","249","343","-94"
"2012","Georgia St.","1","10","0","0.09091","191","424","-233"
"1997","Kentucky","5","6","0","0.45455","348","362","-14"
"1998","Kentucky","7","5","0","0.58333","431","375","56"
"1999","Kentucky","6","6","0","0.50000","328","343","-15"
"2000","Kentucky","2","9","0","0.18182","254","383","-129"
"2003","Southeastern Louisiana","5","7","0","0.41667","369","382","-13"
"2004","Southeastern Louisiana","7","4","0","0.63636","425","271","154"
"2005","New Mexico St.","0","12","0","0.00000","198","465","-267"
"2006","New Mexico St.","4","8","0","0.33333","374","369","5"
"2007","New Mexico St.","4","9","0","0.30769","312","471","-159"
"2008","New Mexico St.","3","9","0","0.25000","266","409","-143"
"2001","Kentucky","2","9","0","0.18182","259","367","-108"
"2002","Kentucky","7","5","0","0.58333","385","301","84"
"2003","Baylor (TX)","3","9","0","0.25000","191","455","-264"
"2004","Baylor (TX)","3","8","0","0.27273","224","406","-182"
"2005","Baylor (TX)","5","6","0","0.45455","236","291","-55"
"2006","Baylor (TX)","4","8","0","0.33333","283","391","-108"
"2007","Baylor (TX)","3","9","0","0.25000","218","444","-226"
"1977","Oregon","3","8","0","0.27273","164","377","-213"
"1978","Oregon","1","10","0","0.09091","173","212","-39"
"1979","Oregon","4","7","0","0.36364","200","212","-12"
"1980","Oregon","6","3","2","0.63636","263","193","70"
"1981","Oregon","2","9","0","0.18182","155","247","-92"
"1982","Oregon","2","8","1","0.22727","103","223","-120"
"1983","Oregon","4","6","1","0.40909","152","224","-72"
"1984","Oregon","6","5","0","0.54545","241","247","-6"
"1985","Oregon","5","6","0","0.45455","273","300","-27"
"1986","Oregon","5","6","0","0.45455","235","338","-103"
"1987","Oregon","6","5","0","0.54545","230","228","2"
"1988","Oregon","6","6","0","0.50000","296","247","49"
"1989","Oregon","8","4","0","0.66667","379","251","128"
"1990","Oregon","8","4","0","0.66667","341","221","120"
"1991","Oregon","3","8","0","0.27273","186","248","-62"
"1992","Oregon","6","6","0","0.50000","265","222","43"
"1993","Oregon","5","6","0","0.45455","278","276","2"
"1994","Oregon","9","4","0","0.69231","349","250","99"
"2003","Kentucky","4","8","0","0.33333","328","321","7"
"2004","Kentucky","2","9","0","0.18182","173","341","-168"
"2005","Kentucky","3","8","0","0.27273","239","375","-136"
"2006","Kentucky","8","5","0","0.61538","347","369","-22"
"2007","Kentucky","8","5","0","0.61538","475","385","90"
"2008","Kentucky","7","6","0","0.53846","294","279","15"
"2009","Kentucky","7","6","0","0.53846","339","295","44"
"2010","Kentucky","6","7","0","0.46154","406","369","37"
"2011","Kentucky","5","7","0","0.41667","190","296","-106"
"2012","Kentucky","2","10","0","0.16667","215","372","-157"
"2013","Kentucky","2","10","0","0.16667","246","374","-128"
"1893","Louisiana St.","0","1","0","0.00000","0","34","-34"
"1894","Louisiana St.","2","1","0","0.66667","72","26","46"
"1895","Louisiana St.","3","0","0","1.00000","36","16","20"
"1896","Louisiana St.","6","0","0","1.00000","136","4","132"
"1897","Louisiana St.","1","1","0","0.50000","28","34","-6"
"1899","Louisiana St.","2","4","0","0.33333","86","126","-40"
"1898","Louisiana St.","1","0","0","1.00000","37","0","37"
"1900","Louisiana St.","2","2","0","0.50000","85","35","50"
"1901","Louisiana St.","5","1","0","0.83333","156","50","106"
"1902","Louisiana St.","6","1","0","0.85714","80","27","53"
"1903","Louisiana St.","4","5","0","0.44444","70","93","-23"
"1904","Louisiana St.","3","4","0","0.42857","38","38","0"
"1905","Louisiana St.","3","0","0","1.00000","36","0","36"
"1906","Louisiana St.","2","2","2","0.50000","40","37","3"
"1904","Butler (IN)","8","1","0","0.88889","223","70","153"
"1905","Butler (IN)","7","3","0","0.70000","300","66","234"
"1906","Pittsburgh (PA)","6","4","0","0.60000","229","55","174"
"1907","Louisiana St.","7","3","0","0.70000","266","52","214"
"1908","Louisiana St.","10","0","0","1.00000","442","11","431"
"1910","Maine","5","1","2","0.75000","71","18","53"
"1911","Maine","6","2","0","0.75000","89","8","81"
"1916","Susquehanna (PA)","4","5","0","0.44444","131","172","-41"
"1917","Susquehanna (PA)","1","0","0","1.00000","1","0","1"
"1918","Bucknell (PA)","6","0","0","1.00000","236","7","229"
"1919","Susquehanna (PA)","5","4","1","0.55000","311","76","235"
"1924","Susquehanna (PA)","3","5","0","0.37500","81","202","-121"
"1925","Susquehanna (PA)","1","6","2","0.22222","37","207","-170"
"1909","Louisiana St.","4","1","0","0.80000","124","15","109"
"1909","Louisiana St.","2","1","0","0.66667","64","22","42"
"1910","Louisiana St.","1","5","0","0.16667","45","119","-74"
"1911","Louisiana St.","6","3","0","0.66667","186","34","152"
"1912","Louisiana St.","4","3","0","0.57143","165","36","129"
"1913","Louisiana St.","6","1","2","0.77778","200","29","171"
"1914","Louisiana St.","4","4","1","0.50000","163","148","15"
"1915","Louisiana St.","6","2","0","0.75000","126","49","77"
"1916","Louisiana St.","4","1","0","0.80000","146","14","132"
"1917","Wake Forest (NC)","1","6","1","0.18750","59","215","-156"
"1916","Louisiana St.","2","0","0","1.00000","30","10","20"
"1919","Louisiana St.","6","2","0","0.75000","161","35","126"
"1922","Louisiana St.","3","7","0","0.30000","72","244","-172"
"1916","Louisiana St.","1","0","2","0.66667","62","21","41"
"1917","Texas A&M","8","0","0","1.00000","270","0","270"
"1919","Texas A&M","10","0","0","1.00000","275","0","275"
"1920","Texas A&M","6","1","1","0.81250","229","7","222"
"1921","Texas A&M","6","1","2","0.77778","110","57","53"
"1922","Texas A&M","5","4","0","0.55556","166","69","97"
"1923","Texas A&M","5","3","1","0.61111","135","23","112"
"1924","Texas A&M","7","2","1","0.75000","229","35","194"
"1925","Texas A&M","7","1","1","0.83333","191","25","166"
"1926","Texas A&M","5","3","1","0.61111","184","59","125"
"1927","Texas A&M","8","0","1","0.94444","262","32","230"
"1928","Texas A&M","5","4","1","0.55000","205","77","128"
"1929","Nebraska","4","1","3","0.68750","93","62","31"
"1930","Nebraska","4","3","2","0.55556","119","61","58"
"1931","Nebraska","8","2","0","0.80000","136","82","54"
"1932","Nebraska","7","1","1","0.83333","105","52","53"
"1933","Nebraska","8","1","0","0.88889","138","19","119"
"1934","Nebraska","6","3","0","0.66667","106","89","17"
"1935","Nebraska","6","2","1","0.72222","138","71","67"
"1936","Nebraska","7","2","0","0.77778","185","49","136"
"1937","Texas","2","6","1","0.27778","60","103","-43"
"1938","Texas","1","8","0","0.11111","52","162","-110"
"1939","Texas","5","4","0","0.55556","106","125","-19"
"1940","Texas","8","2","0","0.80000","172","77","95"
"1941","Texas","8","1","1","0.85000","338","55","283"
"1942","Texas","9","2","0","0.81818","244","49","195"
"1943","Texas","7","1","1","0.83333","277","54","223"
"1944","Texas","5","4","0","0.55556","119","76","43"
"1945","Texas","10","1","0","0.90909","257","86","171"
"1946","Texas","8","2","0","0.80000","290","68","222"
"1917","Louisiana St.","3","5","0","0.37500","112","94","18"
"1908","Georgia","5","2","1","0.68750","71","45","26"
"1909","Virginia Tech","6","1","0","0.85714","148","27","121"
"1910","Virginia Tech","6","2","0","0.75000","109","18","91"
"1911","North Carolina","6","1","1","0.81250","66","31","35"
"1912","Virginia Tech","5","4","0","0.55556","202","92","110"
"1913","Virginia Tech","7","1","1","0.83333","175","60","115"
"1914","Virginia Tech","6","2","1","0.72222","143","33","110"
"1915","Virginia Tech","4","4","0","0.50000","91","109","-18"
"1920","Louisiana St.","5","3","1","0.61111","206","63","143"
"1921","Louisiana St.","6","1","1","0.81250","180","56","124"
"1925","South Carolina","7","3","0","0.70000","150","27","123"
"1926","South Carolina","6","4","0","0.60000","159","62","97"
"1928","William & Mary (VA)","6","3","2","0.63636","218","54","164"
"1929","William & Mary (VA)","8","2","0","0.80000","250","77","173"
"1930","William & Mary (VA)","7","2","1","0.75000","247","39","208"
"1936","William & Mary (VA)","1","8","0","0.11111","51","112","-61"
"1937","William & Mary (VA)","4","5","0","0.44444","129","103","26"
"1938","William & Mary (VA)","3","7","0","0.30000","105","154","-49"
"1904","Auburn (AL)","7","0","0","1.00000","170","11","159"
"1905","Auburn (AL)","4","4","0","0.50000","148","96","52"
"1906","Auburn (AL)","1","5","1","0.21429","24","41","-17"
"1908","Auburn (AL)","6","1","0","0.85714","158","10","148"
"1909","Auburn (AL)","6","2","0","0.75000","140","39","101"
"1910","Auburn (AL)","6","1","0","0.85714","176","9","167"
"1911","Auburn (AL)","5","2","1","0.68750","103","45","58"
"1912","Auburn (AL)","7","1","1","0.83333","206","45","161"
"1913","Auburn (AL)","8","0","0","1.00000","224","13","211"
"1914","Auburn (AL)","8","0","1","0.94444","193","0","193"
"1915","Auburn (AL)","6","2","0","0.75000","182","24","158"
"1916","Auburn (AL)","6","2","0","0.75000","191","56","135"
"1917","Auburn (AL)","6","2","1","0.72222","199","102","97"
"1918","Auburn (AL)","2","5","0","0.28571","84","116","-32"
"1919","Auburn (AL)","8","1","0","0.88889","132","33","99"
"1920","Auburn (AL)","7","2","0","0.77778","332","49","283"
"1921","Auburn (AL)","5","3","0","0.62500","162","52","110"
"1922","Auburn (AL)","8","2","0","0.80000","276","48","228"
"1923","Louisiana St.","3","5","1","0.38889","103","121","-18"
"1924","Louisiana St.","5","4","0","0.55556","124","81","43"
"1925","Louisiana St.","5","3","1","0.61111","90","70","20"
"1926","Louisiana St.","6","3","0","0.66667","128","45","83"
"1927","Louisiana St.","4","4","1","0.50000","128","83","45"
"1928","Louisiana St.","6","2","1","0.72222","180","45","135"
"1929","Louisiana St.","6","3","0","0.66667","246","118","128"
"1930","Louisiana St.","6","4","0","0.60000","296","72","224"
"1931","Louisiana St.","5","4","0","0.55556","137","90","47"
"1935","Cincinnati (OH)","7","2","0","0.77778","241","49","192"
"1936","Cincinnati (OH)","1","5","3","0.27778","57","124","-67"
"1937","Cincinnati (OH)","0","5","0","0.00000","6","108","-102"
"1926","Army (NY)","7","1","1","0.83333","240","71","169"
"1927","Army (NY)","9","1","0","0.90000","197","37","160"
"1928","Army (NY)","8","2","0","0.80000","215","79","136"
"1929","Army (NY)","6","4","1","0.59091","276","132","144"
"1932","Louisiana St.","6","3","1","0.65000","187","31","156"
"1933","Louisiana St.","7","0","3","0.85000","176","27","149"
"1934","Louisiana St.","7","2","2","0.72727","172","77","95"
"1935","Oklahoma","6","3","0","0.66667","99","44","55"
"1936","Oklahoma","3","3","3","0.50000","84","67","17"
"1937","Nebraska","6","1","2","0.77778","99","42","57"
"1938","Nebraska","3","5","1","0.38889","68","84","-16"
"1939","Nebraska","7","1","1","0.83333","115","70","45"
"1940","Nebraska","8","2","0","0.80000","183","75","108"
"1941","Nebraska","4","5","0","0.44444","93","81","12"
"1926","Mercer (GA)","4","4","2","0.50000","138","98","40"
"1927","Mercer (GA)","5","4","0","0.55556","191","111","80"
"1928","Mercer (GA)","3","5","1","0.38889","73","231","-158"
"1935","Louisiana St.","9","2","0","0.81818","223","41","182"
"1936","Louisiana St.","9","1","1","0.86364","295","54","241"
"1937","Louisiana St.","9","2","0","0.81818","234","33","201"
"1938","Louisiana St.","6","4","0","0.60000","160","89","71"
"1939","Louisiana St.","4","5","0","0.44444","111","116","-5"
"1940","Louisiana St.","6","4","0","0.60000","139","112","27"
"1941","Louisiana St.","4","4","2","0.50000","119","93","26"
"1942","Louisiana St.","7","3","0","0.70000","192","117","75"
"1943","Louisiana St.","6","3","0","0.66667","162","158","4"
"1944","Louisiana St.","2","5","1","0.31250","92","101","-9"
"1945","Louisiana St.","7","2","0","0.77778","245","92","153"
"1946","Louisiana St.","9","1","1","0.86364","240","123","117"
"1947","Louisiana St.","5","3","1","0.61111","149","161","-12"
"1937","Louisiana College","3","6","0","0.33333","69","189","-120"
"1938","Louisiana College","4","4","1","0.50000","77","89","-12"
"1948","Louisiana St.","3","7","0","0.30000","99","271","-172"
"1949","Louisiana St.","8","3","0","0.72727","231","109","122"
"1950","Louisiana St.","4","5","2","0.45455","165","151","14"
"1951","Louisiana St.","7","3","1","0.68182","128","111","17"
"1952","Louisiana St.","3","7","0","0.30000","148","214","-66"
"1953","Louisiana St.","5","3","3","0.59091","194","159","35"
"1954","Louisiana St.","5","6","0","0.45455","125","173","-48"
"1955","Louisiana St.","3","5","2","0.40000","139","149","-10"
"1956","Louisiana St.","3","7","0","0.30000","104","197","-93"
"1957","Louisiana St.","5","5","0","0.50000","159","110","49"
"1958","Louisiana St.","11","0","0","1.00000","282","53","229"
"1959","Louisiana St.","9","2","0","0.81818","164","50","114"
"1960","Louisiana St.","5","4","1","0.55000","105","50","55"
"1961","Louisiana St.","10","1","0","0.90909","259","57","202"
"1962","Army (NY)","6","4","0","0.60000","152","104","48"
"1963","Army (NY)","7","3","0","0.70000","177","97","80"
"1964","Army (NY)","4","6","0","0.40000","118","143","-25"
"1965","Army (NY)","4","5","1","0.45000","119","132","-13"
"1966","South Carolina","1","9","0","0.10000","95","216","-121"
"1967","South Carolina","5","5","0","0.50000","159","166","-7"
"1968","South Carolina","4","6","0","0.40000","214","223","-9"
"1969","South Carolina","7","4","0","0.63636","189","195","-6"
"1970","South Carolina","4","6","1","0.40909","285","253","32"
"1971","South Carolina","6","5","0","0.54545","191","196","-5"
"1972","South Carolina","4","7","0","0.36364","214","232","-18"
"1973","South Carolina","7","4","0","0.63636","347","261","86"
"1974","South Carolina","4","7","0","0.36364","223","312","-89"
"1962","Louisiana St.","9","1","1","0.86364","175","34","141"
"1963","Louisiana St.","7","4","0","0.63636","142","112","30"
"1964","Louisiana St.","8","2","1","0.77273","128","89","39"
"1965","Louisiana St.","8","3","0","0.72727","265","164","101"
"1966","Louisiana St.","5","4","1","0.55000","135","124","11"
"1967","Louisiana St.","7","3","1","0.68182","268","127","141"
"1968","Louisiana St.","8","3","0","0.72727","221","171","50"
"1969","Louisiana St.","9","1","0","0.90000","349","91","258"
"1970","Louisiana St.","9","3","0","0.75000","289","113","176"
"1971","Louisiana St.","9","3","0","0.75000","353","153","200"
"1972","Louisiana St.","9","2","1","0.79167","252","145","107"
"1973","Louisiana St.","9","3","0","0.75000","267","169","98"
"1974","Louisiana St.","5","5","1","0.50000","202","168","34"
"1975","Louisiana St.","5","6","0","0.45455","159","202","-43"
"1976","Louisiana St.","7","3","1","0.68182","255","149","106"
"1977","Louisiana St.","8","4","0","0.66667","389","220","169"
"1978","Louisiana St.","8","4","0","0.66667","279","193","86"
"1979","Louisiana St.","7","5","0","0.58333","275","151","124"
"1980","Louisiana St.","7","4","0","0.63636","213","193","20"
"1981","Louisiana St.","3","7","1","0.31818","169","272","-103"
"1982","Louisiana St.","8","3","1","0.70833","385","191","194"
"1983","Louisiana St.","4","7","0","0.36364","251","253","-2"
"1984","Louisiana St.","8","3","1","0.70833","315","226","89"
"1985","Louisiana St.","9","2","1","0.79167","227","134","93"
"1986","Louisiana St.","9","3","0","0.75000","306","185","121"
"1987","Louisiana St.","10","1","1","0.87500","365","184","181"
"1988","Louisiana St.","8","4","0","0.66667","249","204","45"
"1989","Louisiana St.","4","7","0","0.36364","295","252","43"
"1990","Louisiana St.","5","6","0","0.45455","183","238","-55"
"1988","Southern Mississippi","10","2","0","0.83333","353","284","69"
"1989","Southern Mississippi","5","6","0","0.45455","240","252","-12"
"1990","Southern Mississippi","8","3","0","0.72727","193","141","52"
"1991","Louisiana St.","5","6","0","0.45455","248","263","-15"
"1992","Louisiana St.","2","9","0","0.18182","175","261","-86"
"1993","Louisiana St.","5","6","0","0.45455","190","308","-118"
"1994","Louisiana St.","4","7","0","0.36364","270","271","-1"
"1991","Vanderbilt (TN)","5","6","0","0.45455","205","267","-62"
"1992","Vanderbilt (TN)","4","7","0","0.36364","224","277","-53"
"1993","Vanderbilt (TN)","5","6","0","0.45455","137","290","-153"
"1994","Vanderbilt (TN)","5","6","0","0.45455","203","277","-74"
"1995","Louisiana St.","7","4","1","0.62500","324","186","138"
"1996","Louisiana St.","10","2","0","0.83333","335","210","125"
"1997","Louisiana St.","9","3","0","0.75000","373","188","185"
"1998","Louisiana St.","4","7","0","0.36364","337","279","58"
"1999","Louisiana St.","2","8","0","0.20000","188","249","-61"
"2002","Indiana","3","9","0","0.25000","258","445","-187"
"2003","Indiana","2","10","0","0.16667","177","388","-211"
"2004","Indiana","3","8","0","0.27273","262","343","-81"
"1977","California (PA)","2","8","0","0.20000","125","338","-213"
"1978","California (PA)","2","7","1","0.25000","111","196","-85"
"1979","California (PA)","3","7","0","0.30000","106","175","-69"
"1980","California (PA)","2","8","0","0.20000","107","204","-97"
"1999","Louisiana St.","1","0","0","1.00000","35","10","25"
"1990","Toledo (OH)","9","2","0","0.81818","284","178","106"
"1995","Michigan St.","6","5","1","0.54167","287","338","-51"
"1996","Michigan St.","6","6","0","0.50000","358","302","56"
"1997","Michigan St.","7","5","0","0.58333","342","237","105"
"1998","Michigan St.","6","6","0","0.50000","336","294","42"
"1999","Michigan St.","9","2","0","0.81818","341","211","130"
"2000","Louisiana St.","8","4","0","0.66667","320","235","85"
"2001","Louisiana St.","10","3","0","0.76923","418","302","116"
"2002","Louisiana St.","8","5","0","0.61538","323","238","85"
"2003","Louisiana St.","13","1","0","0.92857","475","154","321"
"2004","Louisiana St.","9","3","0","0.75000","344","205","139"
"2007","Alabama","2","6","0","0.25000","352","286","66"
"2008","Alabama","12","2","0","0.85714","422","200","222"
"2009","Alabama","14","0","0","1.00000","449","164","285"
"2010","Alabama","10","3","0","0.76923","464","176","288"
"2011","Alabama","12","1","0","0.92308","453","106","347"
"2012","Alabama","13","1","0","0.92857","542","153","389"
"2013","Alabama","11","2","0","0.84615","496","181","315"
"2001","Oklahoma St.","4","7","0","0.36364","242","281","-39"
"2002","Oklahoma St.","8","5","0","0.61538","446","356","90"
"2003","Oklahoma St.","9","4","0","0.69231","467","326","141"
"2004","Oklahoma St.","7","5","0","0.58333","387","301","86"
"2005","Louisiana St.","11","2","0","0.84615","383","185","198"
"2006","Louisiana St.","11","2","0","0.84615","438","164","274"
"2007","Louisiana St.","12","2","0","0.85714","541","279","262"
"2008","Louisiana St.","8","5","0","0.61538","402","314","88"
"2009","Louisiana St.","9","4","0","0.69231","323","211","112"
"2010","Louisiana St.","11","2","0","0.84615","386","237","149"
"2011","Louisiana St.","13","1","0","0.92857","500","158","342"
"2012","Louisiana St.","10","3","0","0.76923","387","228","159"
"2013","Louisiana St.","10","3","0","0.76923","465","286","179"
"1901","Louisiana Tech","0","2","0","0.00000","0","73","-73"
"1872","Stevens Tech (NJ)","0","1","0","0.00000","0","6","-6"
"1873","New York (NY)","3","3","0","0.50000","15","13","2"
"1874","Stevens Tech (NJ)","2","3","0","0.40000","10","20","-10"
"1875","Stevens Tech (NJ)","4","4","0","0.50000","21","20","1"
"1876","New York (NY)","2","3","1","0.41667","16","19","-3"
"1877","Stevens Tech (NJ)","3","1","2","0.66667","9","14","-5"
"1878","Stevens Tech (NJ)","3","3","3","0.50000","3","9","-6"
"1879","Stevens Tech (NJ)","2","3","5","0.45000","8","14","-6"
"1880","Stevens Tech (NJ)","1","5","0","0.16667","3","16","-13"
"1881","Stevens Tech (NJ)","3","8","3","0.32143","16","29","-13"
"1882","Lawrence (WI)","7","8","1","0.46875","17","25","-8"
"1883","Stevens Tech (NJ)","7","6","1","0.53571","187","128","59"
"1884","Fordham (NY)","9","10","0","0.47368","221","261","-40"
"1885","Georgetown (DC)","5","17","1","0.23913","359","612","-253"
"1886","New York (NY)","9","15","2","0.38462","180","565","-385"
"1887","Fordham (NY)","8","12","1","0.40476","157","445","-288"
"1888","Amherst (MA)","6","17","3","0.28846","192","791","-599"
"1889","New York (NY)","8","21","4","0.30303","278","647","-369"
"1890","New York (NY)","25","14","2","0.63415","727","538","189"
"1891","Delaware","32","30","7","0.51449","966","971","-5"
"1892","Beloit (WI)","29","31","3","0.48413","726","797","-71"
"1893","Marquette (WI)","39","34","3","0.53289","1091","885","206"
"1894","Manhattan (NY)","32","29","7","0.52206","853","692","161"
"1895","Delaware","44","35","6","0.55294","889","813","76"
"1896","Manhattan (NY)","51","49","6","0.50943","949","1164","-215"
"1897","Stevens Tech (NJ)","37","50","4","0.42857","661","1048","-387"
"1898","Manhattan (NY)","37","43","9","0.46629","781","1050","-269"
"1899","Manhattan (NY)","34","40","6","0.46250","594","1063","-469"
"1900","Manhattan (NY)","43","47","11","0.48020","991","1049","-58"
"1901","Ferris St. (MI)","51","44","7","0.53431","906","852","54"
"1902","Indiana St.","56","48","5","0.53670","1053","927","126"
"1903","Manhattan (NY)","30","49","7","0.38953","762","1319","-557"
"1904","Saint Francis (NY)","44","53","9","0.45755","787","1363","-576"
"1905","Bluffton (OH)","38","59","5","0.39706","850","1433","-583"
"1906","Ferris St. (MI)","32","43","12","0.43678","677","854","-177"
"1907","Ferris St. (MI)","32","48","10","0.41111","722","1208","-486"
"1908","Western Illinois","36","45","10","0.45055","760","1069","-309"
"1909","Delaware Valley (PA)","27","52","2","0.34568","682","1287","-605"
"1910","East Stroudsburg (PA)","23","31","3","0.42982","583","738","-155"
"1911","Western Illinois","32","44","7","0.42771","661","902","-241"
"1912","Indiana (PA)","36","56","7","0.39899","1134","1463","-329"
"1913","Saint Francis (NY)","52","67","8","0.44094","1672","2360","-688"
"1914","Delaware Valley (PA)","41","50","6","0.45361","1217","1585","-368"
"1915","Western Illinois","34","35","11","0.49375","932","1217","-285"
"1916","Morgan St. (MD)","44","43","7","0.50532","1493","1270","223"
"1917","Morgan St. (MD)","21","21","2","0.50000","408","883","-475"
"1918","Oklahoma Baptist University","7","16","2","0.32000","258","358","-100"
"1919","Western Illinois","53","41","8","0.55882","1478","1056","422"
"1920","Virginia Union","28","39","2","0.42029","506","893","-387"
"1921","Cooper Union (NY)","19","34","3","0.36607","441","1112","-671"
"1922","Cooper Union (NY)","27","34","6","0.44776","703","832","-129"
"1923","Cooper Union (NY)","31","45","2","0.41026","718","1112","-394"
"1924","East Stroudsburg (PA)","34","40","6","0.46250","946","1175","-229"
"1925","Saint Anselm (NH)","32","28","10","0.52857","847","802","45"
"1926","Saint Anselm (NH)","22","30","4","0.42857","515","702","-187"
"1927","Bethune-Cookman (FL)","20","29","8","0.42105","674","783","-109"
"1928","Saint Anselm (NH)","28","24","7","0.53390","564","1095","-531"
"1929","Saint Anselm (NH)","25","32","5","0.44355","616","843","-227"
"1930","Saint Anselm (NH)","31","27","10","0.52941","643","549","94"
"1931","Campbell (NC)","21","17","4","0.54762","465","428","37"
"1932","Campbell (NC)","7","30","3","0.21250","254","760","-506"
"1933","Campbell (NC)","11","13","3","0.46296","262","324","-62"
"1934","Bowie St. (MD)","4","7","2","0.38462","116","94","22"
"1935","Florida Southern","7","12","1","0.37500","170","162","8"
"1936","Bowie St. (MD)","5","2","1","0.68750","154","97","57"
"1937","Bowie St. (MD)","6","3","0","0.66667","98","87","11"
"1938","West Alabama","7","5","0","0.58333","151","88","63"
"1939","Elizabeth City St. (NC)","7","13","0","0.35000","150","307","-157"
"1940","Elizabeth City St. (NC)","6","5","4","0.53333","128","67","61"
"1941","Arkansas-Pine Bluff","3","9","5","0.32353","178","223","-45"
"1942","Brevard College (NC)","10","6","2","0.61111","225","189","36"
"1943","Clark Atlanta (GA)","6","8","0","0.42857","127","206","-79"
"1944","Abilene Christian (TX)","9","11","1","0.45238","158","255","-97"
"1945","Benedict (SC)","10","15","2","0.40741","299","296","3"
"1946","Elizabeth City St. (NC)","7","20","3","0.28333","144","540","-396"
"1947","Clark Atlanta (GA)","3","6","2","0.36364","49","230","-181"
"1948","Virginia-Lynchburg","4","6","1","0.40909","77","302","-225"
"1949","Virginia-Lynchburg","0","3","1","0.12500","7","70","-63"
"1950","Virginia-Lynchburg","2","3","0","0.40000","53","98","-45"
"1951","Lane (TN)","8","6","0","0.57143","295","234","61"
"1952","Lane (TN)","9","5","1","0.63333","220","206","14"
"1953","Lane (TN)","1","7","0","0.12500","58","215","-157"
"1954","Lane (TN)","2","6","0","0.25000","105","135","-30"
"1955","Lane (TN)","2","4","0","0.33333","83","129","-46"
"1957","Louisiana College","2","7","0","0.22222","106","179","-73"
"1959","Azusa Pacific (CA)","2","3","0","0.40000","117","90","27"
"1960","Azusa Pacific (CA)","4","3","1","0.56250","103","76","27"
"1961","Azusa Pacific (CA)","3","3","0","0.50000","123","147","-24"
"1963","San Francisco (CA)","2","5","0","0.28571","58","98","-40"
"1964","New York (NY)","0","2","0","0.00000","20","48","-28"
"1965","Adelphi (NY)","4","8","0","0.33333","198","216","-18"
"1966","Fairfield (CT)","18","22","2","0.45238","545","652","-107"
"1967","La Salle (PA)","25","31","0","0.44643","846","1080","-234"
"1968","Centenary (LA)","17","42","2","0.29508","726","1393","-667"
"1969","Bluffton (OH)","33","43","0","0.43421","1058","1548","-490"
"1970","Saint John's (NY)","35","54","1","0.39444","1379","1783","-404"
"1971","Bluffton (OH)","43","45","1","0.48876","1360","1384","-24"
"1972","Marquette (WI)","39","44","2","0.47059","1217","1351","-134"
"1973","Brooklyn (NY)","30","52","1","0.36747","1007","1611","-604"
"1974","Marquette (WI)","33","36","3","0.47917","959","1169","-210"
"1975","Marquette (WI)","31","22","4","0.57895","1042","932","110"
"1976","Bluffton (OH)","23","33","1","0.41228","862","1186","-324"
"1977","Manhattan (NY)","14","28","1","0.33721","568","923","-355"
"1978","Fairfield (CT)","5","7","1","0.42308","194","203","-9"
"1979","Fairfield (CT)","7","8","0","0.46667","247","260","-13"
"1980","Westfield St. (MA)","6","5","4","0.53333","184","196","-12"
"1981","San Francisco (CA)","17","14","0","0.54839","567","498","69"
"1982","Manhattan (NY)","18","16","0","0.52941","580","644","-64"
"1983","SUNY-Stony Brook (NY)","15","11","0","0.57692","474","453","21"
"1984","Stonehill (MA)","7","12","0","0.36842","231","439","-208"
"1985","Manhattan (NY)","10","10","0","0.50000","313","316","-3"
"1986","Marquette (WI)","13","17","0","0.43333","497","564","-67"
"1987","Marquette (WI)","10","17","0","0.37037","389","487","-98"
"1988","Marquette (WI)","1","5","0","0.16667","80","125","-45"
"1989","Marquette (WI)","4","4","0","0.50000","209","151","58"
"1990","Marquette (WI)","1","7","0","0.12500","80","180","-100"
"1991","Marquette (WI)","1","5","0","0.16667","106","182","-76"
"1992","Marquette (WI)","2","5","0","0.28571","81","129","-48"
"1993","Marquette (WI)","7","1","0","0.87500","212","126","86"
"1994","Marquette (WI)","1","6","0","0.14286","125","184","-59"
"1995","Marquette (WI)","3","4","0","0.42857","141","191","-50"
"1996","Marquette (WI)","3","5","0","0.37500","139","182","-43"
"1998","Madison College (WI)","2","15","0","0.11765","221","613","-392"
"1999","Marquette (WI)","0","7","0","0.00000","110","298","-188"
"2000","Marquette (WI)","1","5","0","0.16667","60","96","-36"
"2001","Marquette (WI)","2","6","0","0.25000","144","179","-35"
"2002","Marquette (WI)","3","4","0","0.42857","127","208","-81"
"2003","Marquette (WI)","1","6","0","0.14286","71","151","-80"
"2004","Marquette (WI)","0","6","0","0.00000","53","238","-185"
"2005","Marquette (WI)","2","5","0","0.28571","92","226","-134"
"2006","Marquette (WI)","1","6","0","0.14286","62","206","-144"
"2007","Marquette (WI)","2","5","0","0.28571","140","215","-75"
"2008","Marquette (WI)","0","7","0","0.00000","61","304","-243"
"2009","Marquette (WI)","0","1","0","0.00000","0","22","-22"
"1904","Louisiana Tech","1","3","0","0.25000","11","60","-49"
"1905","Louisiana Tech","0","1","0","0.00000","0","16","-16"
"1906","Louisiana Tech","2","1","3","0.58333","36","22","14"
"1907","Louisiana Tech","9","1","0","0.90000","248","37","211"
"1908","Louisiana Tech","4","3","1","0.56250","205","91","114"
"1909","Louisiana Tech","5","1","0","0.83333","184","23","161"
"1910","Louisiana Tech","7","0","0","1.00000","265","6","259"
"1911","Louisiana Tech","4","1","1","0.75000","98","23","75"
"1912","Louisiana Tech","1","2","1","0.37500","33","28","5"
"1913","Louisiana Tech","3","4","1","0.43750","105","72","33"
"1914","Louisiana Tech","2","4","0","0.33333","55","129","-74"
"1915","Louisiana Tech","3","1","2","0.66667","110","33","77"
"1919","Louisiana Tech","0","3","0","0.00000","13","48","-35"
"1916","Louisiana Tech","2","4","0","0.33333","40","66","-26"
"1917","Louisiana Tech","2","3","1","0.41667","72","137","-65"
"1920","Louisiana Tech","5","1","0","0.83333","38","19","19"
"1921","Louisiana Tech","6","0","0","1.00000","106","20","86"
"1915","Washington St.","7","0","0","1.00000","204","10","194"
"1916","Washington St.","4","2","0","0.66667","136","25","111"
"1917","Washington St.","6","0","1","0.92857","112","3","109"
"1921","Purdue (IN)","1","6","0","0.14286","9","95","-86"
"1922","Louisiana Tech","5","1","1","0.78571","290","26","264"
"1923","Louisiana Tech","6","2","0","0.75000","194","63","131"
"1924","Wyoming","2","6","0","0.25000","59","133","-74"
"1925","Wyoming","6","3","0","0.66667","147","83","64"
"1926","Wyoming","2","4","2","0.37500","152","91","61"
"1908","Southwestern (TX)","3","2","0","0.60000","51","60","-9"
"1909","Southwestern (TX)","1","4","2","0.28571","35","51","-16"
"1910","Southwestern (TX)","2","4","1","0.35714","79","75","4"
"1911","Southwestern (TX)","2","3","2","0.42857","45","47","-2"
"1912","Rice (TX)","3","2","0","0.60000","40","125","-85"
"1913","Rice (TX)","4","0","0","1.00000","81","14","67"
"1914","Rice (TX)","3","2","3","0.56250","59","113","-54"
"1915","Rice (TX)","5","3","0","0.62500","122","143","-21"
"1916","Rice (TX)","6","1","2","0.77778","346","62","284"
"1917","Rice (TX)","8","1","0","0.88889","249","55","194"
"1919","Rice (TX)","8","1","0","0.88889","190","60","130"
"1920","Rice (TX)","4","2","2","0.62500","105","28","77"
"1921","Rice (TX)","4","4","1","0.50000","144","128","16"
"1922","Rice (TX)","4","4","0","0.50000","96","128","-32"
"1923","Rice (TX)","3","5","0","0.37500","35","94","-59"
"1924","Louisiana Tech","1","6","1","0.18750","42","139","-97"
"1915","William & Vashti (IL)","5","2","0","0.71429","286","30","256"
"1925","Louisiana Tech","1","6","2","0.22222","28","176","-148"
"1926","Louisiana Tech","5","2","2","0.66667","134","60","74"
"1927","Louisiana Tech","3","5","0","0.37500","83","118","-35"
"1926","North Dakota","4","4","0","0.50000","63","121","-58"
"1927","North Dakota","4","4","0","0.50000","88","103","-15"
"1928","Louisiana Tech","2","7","0","0.22222","48","235","-187"
"1929","Louisiana Tech","3","4","3","0.45000","96","143","-47"
"1928","Auburn (AL)","1","8","0","0.11111","37","154","-117"
"1929","Auburn (AL)","2","3","0","0.40000","22","86","-64"
"1930","Louisiana Tech","3","6","0","0.33333","39","187","-148"
"1931","Louisiana Tech","7","0","0","1.00000","167","36","131"
"1932","Louisiana Tech","4","4","0","0.50000","113","83","30"
"1933","Louisiana Tech","1","7","0","0.12500","32","143","-111"
"1929","Samford (AL)","5","4","2","0.54545","160","59","101"
"1930","Samford (AL)","5","5","0","0.50000","147","103","44"
"1931","Samford (AL)","8","2","2","0.75000","206","88","118"
"1932","Samford (AL)","3","7","0","0.30000","61","174","-113"
"1933","Samford (AL)","7","1","2","0.80000","201","46","155"
"1934","Louisiana Tech","4","6","0","0.40000","89","116","-27"
"1935","Louisiana Tech","8","1","0","0.88889","255","42","213"
"1936","Louisiana Tech","6","2","1","0.72222","153","47","106"
"1937","Louisiana Tech","6","3","2","0.63636","120","60","60"
"1938","Louisiana Tech","3","7","1","0.31818","98","163","-65"
"1939","Louisiana Tech","5","6","0","0.45455","125","127","-2"
"1940","Louisiana Tech","6","4","0","0.60000","106","109","-3"
"1941","Louisiana Tech","5","4","1","0.55000","134","112","22"
"1942","Louisiana Tech","6","3","0","0.66667","252","90","162"
"1944","Louisiana Tech","3","5","1","0.38889","120","114","6"
"1945","Louisiana Tech","6","4","0","0.60000","133","123","10"
"1946","Louisiana Tech","7","3","0","0.70000","195","87","108"
"1947","Louisiana Tech","5","4","0","0.55556","154","107","47"
"1948","Louisiana Tech","7","2","1","0.75000","183","142","41"
"1949","Louisiana Tech","7","2","0","0.77778","231","97","134"
"1950","Louisiana Tech","5","4","1","0.55000","152","165","-13"
"1951","Louisiana Tech","4","5","0","0.44444","157","192","-35"
"1952","Louisiana Tech","6","1","2","0.77778","181","117","64"
"1953","Louisiana Tech","6","3","0","0.66667","222","119","103"
"1954","Louisiana Tech","6","3","0","0.66667","189","131","58"
"1955","Louisiana Tech","9","1","0","0.90000","251","97","154"
"1956","Louisiana Tech","4","3","2","0.55556","101","68","33"
"1957","Louisiana Tech","6","4","0","0.60000","165","141","24"
"1958","Louisiana Tech","7","3","0","0.70000","206","104","102"
"1959","Louisiana Tech","9","1","0","0.90000","191","48","143"
"1960","Louisiana Tech","8","2","0","0.80000","151","96","55"
"1961","Louisiana Tech","5","4","0","0.55556","156","109","47"
"1962","Louisiana Tech","4","4","0","0.50000","125","124","1"
"1963","Louisiana Tech","6","3","0","0.66667","188","103","85"
"1964","Louisiana Tech","9","1","0","0.90000","157","64","93"
"1965","Louisiana Tech","4","4","0","0.50000","161","122","39"
"1966","Louisiana Tech","1","9","0","0.10000","83","205","-122"
"1967","Louisiana Tech","3","7","0","0.30000","156","242","-86"
"1968","Louisiana Tech","9","2","0","0.81818","337","195","142"
"1969","Louisiana Tech","8","2","0","0.80000","331","201","130"
"1970","Louisiana Tech","2","8","0","0.20000","165","175","-10"
"1971","Louisiana Tech","9","2","0","0.81818","288","175","113"
"1972","Louisiana Tech","12","0","0","1.00000","333","134","199"
"1973","Louisiana Tech","12","1","0","0.92308","355","106","249"
"1974","Louisiana Tech","11","1","0","0.91667","318","145","173"
"1975","Louisiana Tech","8","2","0","0.80000","297","185","112"
"1976","Louisiana Tech","6","5","0","0.54545","336","247","89"
"1977","Louisiana Tech","9","1","2","0.83333","305","147","158"
"1978","Louisiana Tech","6","5","0","0.54545","228","186","42"
"1979","Louisiana Tech","1","0","0","1.00000","13","10","3"
"1979","Louisiana Tech","2","8","0","0.20000","99","212","-113"
"1974","Southeastern Louisiana","6","4","0","0.60000","217","197","20"
"1975","Southeastern Louisiana","4","7","0","0.36364","217","246","-29"
"1976","Southeastern Louisiana","9","1","1","0.86364","237","148","89"
"1977","Southeastern Louisiana","6","4","0","0.60000","189","135","54"
"1978","Southeastern Louisiana","7","3","1","0.68182","198","78","120"
"1979","Southeastern Louisiana","6","5","0","0.54545","191","135","56"
"1980","Louisiana Tech","5","6","0","0.45455","193","220","-27"
"1981","Louisiana Tech","4","6","1","0.40909","205","241","-36"
"1982","Louisiana Tech","10","3","0","0.76923","340","177","163"
"1983","Mississippi","7","5","0","0.58333","179","264","-85"
"1984","Mississippi","4","6","1","0.40909","194","203","-9"
"1985","Mississippi","4","6","1","0.40909","210","276","-66"
"1986","Mississippi","8","3","1","0.70833","240","167","73"
"1987","Mississippi","3","8","0","0.27273","223","309","-86"
"1988","Mississippi","5","6","0","0.45455","221","223","-2"
"1989","Mississippi","8","4","0","0.66667","309","314","-5"
"1990","Mississippi","9","3","0","0.75000","260","226","34"
"1991","Mississippi","5","6","0","0.45455","242","223","19"
"1992","Mississippi","9","3","0","0.75000","243","174","69"
"1993","Mississippi","6","5","0","0.54545","242","142","100"
"1975","Northwestern St. (LA)","1","10","0","0.09091","108","316","-208"
"1976","Northwestern St. (LA)","5","5","0","0.50000","190","181","9"
"1977","Northwestern St. (LA)","6","5","0","0.54545","196","183","13"
"1978","Northwestern St. (LA)","5","6","0","0.45455","158","282","-124"
"1979","Northwestern St. (LA)","3","6","0","0.33333","143","253","-110"
"1980","Northwestern St. (LA)","8","3","0","0.72727","266","191","75"
"1981","Northwestern St. (LA)","4","6","0","0.40000","322","266","56"
"1982","Northwestern St. (LA)","6","5","0","0.54545","259","212","47"
"1983","Louisiana Tech","4","7","0","0.36364","152","195","-43"
"1984","Louisiana Tech","10","5","0","0.66667","310","204","106"
"1985","Louisiana Tech","8","3","0","0.72727","259","176","83"
"1986","Louisiana Tech","6","4","1","0.59091","206","223","-17"
"1987","Louisiana Tech","3","8","0","0.27273","108","197","-89"
"1997","North Carolina","1","0","0","1.00000","42","3","39"
"1998","North Carolina","7","5","0","0.58333","288","283","5"
"1999","North Carolina","3","8","0","0.27273","186","272","-86"
"2000","North Carolina","6","5","0","0.54545","269","284","-15"
"1988","Louisiana Tech","4","7","0","0.36364","185","352","-167"
"1989","Louisiana Tech","4","6","0","0.40000","283","265","18"
"1990","Louisiana Tech","8","3","1","0.70833","365","219","146"
"1991","Louisiana Tech","8","1","2","0.81818","280","194","86"
"1992","Louisiana Tech","5","6","0","0.45455","199","167","32"
"1993","Louisiana Tech","3","8","0","0.27273","143","332","-189"
"1994","Louisiana Tech","3","8","0","0.27273","164","274","-110"
"1995","Louisiana Tech","5","6","0","0.45455","320","371","-51"
"1996","Louisiana Tech","6","5","0","0.54545","351","342","9"
"1997","Louisiana Tech","9","2","0","0.81818","364","281","83"
"1998","Louisiana Tech","6","6","0","0.50000","493","402","91"
"2001","Brigham Young (UT)","12","2","0","0.85714","618","424","194"
"2002","Brigham Young (UT)","5","7","0","0.41667","272","333","-61"
"2003","Brigham Young (UT)","4","8","0","0.33333","196","310","-114"
"2004","Brigham Young (UT)","5","6","0","0.45455","267","295","-28"
"1999","Louisiana Tech","8","3","0","0.72727","389","306","83"
"2000","Louisiana Tech","3","9","0","0.25000","317","396","-79"
"2001","Louisiana Tech","7","5","0","0.58333","406","390","16"
"2002","Louisiana Tech","4","8","0","0.33333","320","426","-106"
"2003","Louisiana Tech","5","7","0","0.41667","310","394","-84"
"2004","Louisiana Tech","6","6","0","0.50000","308","385","-77"
"2005","Louisiana Tech","7","4","0","0.63636","316","281","35"
"2006","Louisiana Tech","3","10","0","0.23077","242","542","-300"
"2007","Louisiana Tech","5","7","0","0.41667","249","368","-119"
"2008","Louisiana Tech","8","5","0","0.61538","320","308","12"
"2009","Louisiana Tech","4","8","0","0.33333","350","309","41"
"2010","Tennessee","6","7","0","0.46154","351","326","25"
"2011","Tennessee","5","7","0","0.41667","244","271","-27"
"2012","Tennessee","4","7","0","0.36364","397","411","-14"
"2010","Louisiana Tech","5","7","0","0.41667","321","368","-47"
"2011","Louisiana Tech","8","5","0","0.61538","391","301","90"
"2012","Louisiana Tech","9","3","0","0.75000","618","462","156"
"2013","California","1","11","0","0.08333","276","551","-275"
"1994","Connecticut","4","7","0","0.36364","240","264","-24"
"1995","Connecticut","8","3","0","0.72727","279","200","79"
"1996","Connecticut","4","6","0","0.40000","244","191","53"
"1997","Connecticut","7","4","0","0.63636","398","246","152"
"1998","Connecticut","10","3","0","0.76923","461","413","48"
"2005","East Carolina (NC)","5","6","0","0.45455","267","317","-50"
"2006","East Carolina (NC)","7","6","0","0.53846","280","270","10"
"2007","East Carolina (NC)","8","5","0","0.61538","403","395","8"
"2008","East Carolina (NC)","9","5","0","0.64286","328","295","33"
"2009","East Carolina (NC)","9","5","0","0.64286","378","307","71"
"2010","South Florida","8","5","0","0.61538","313","260","53"
"2011","South Florida","5","7","0","0.41667","351","272","79"
"2012","South Florida","3","9","0","0.25000","247","329","-82"
"2013","Louisiana Tech","4","8","0","0.33333","230","315","-85"
"1872","Stevens Tech (NJ)","0","1","0","0.00000","0","6","-6"
"1873","New York (NY)","3","3","0","0.50000","15","13","2"
"1874","Stevens Tech (NJ)","2","3","0","0.40000","10","20","-10"
"1875","Stevens Tech (NJ)","4","4","0","0.50000","21","20","1"
"1876","New York (NY)","2","3","1","0.41667","16","19","-3"
"1877","Stevens Tech (NJ)","3","1","2","0.66667","9","14","-5"
"1878","Stevens Tech (NJ)","3","3","3","0.50000","3","9","-6"
"1879","Stevens Tech (NJ)","2","3","5","0.45000","8","14","-6"
"1880","Stevens Tech (NJ)","1","5","0","0.16667","3","16","-13"
"1881","Stevens Tech (NJ)","3","8","3","0.32143","16","29","-13"
"1882","Lawrence (WI)","7","8","1","0.46875","17","25","-8"
"1883","Stevens Tech (NJ)","7","6","1","0.53571","187","128","59"
"1884","Fordham (NY)","9","10","0","0.47368","221","261","-40"
"1885","Georgetown (DC)","5","17","1","0.23913","359","612","-253"
"1886","New York (NY)","9","15","2","0.38462","180","565","-385"
"1887","Fordham (NY)","8","12","1","0.40476","157","445","-288"
"1888","Amherst (MA)","6","17","3","0.28846","192","791","-599"
"1889","New York (NY)","8","21","4","0.30303","278","647","-369"
"1890","New York (NY)","25","14","2","0.63415","727","538","189"
"1891","Delaware","32","30","7","0.51449","966","971","-5"
"1892","Beloit (WI)","29","31","3","0.48413","726","797","-71"
"1893","Marquette (WI)","39","34","3","0.53289","1091","885","206"
"1894","Manhattan (NY)","32","29","7","0.52206","853","692","161"
"1895","Delaware","44","35","6","0.55294","889","813","76"
"1896","Manhattan (NY)","51","49","6","0.50943","949","1164","-215"
"1897","Stevens Tech (NJ)","37","50","4","0.42857","661","1048","-387"
"1898","Manhattan (NY)","37","43","9","0.46629","781","1050","-269"
"1899","Manhattan (NY)","34","40","6","0.46250","594","1063","-469"
"1900","Manhattan (NY)","43","47","11","0.48020","991","1049","-58"
"1901","Ferris St. (MI)","51","44","7","0.53431","906","852","54"
"1902","Indiana St.","56","48","5","0.53670","1053","927","126"
"1903","Manhattan (NY)","30","49","7","0.38953","762","1319","-557"
"1904","Saint Francis (NY)","44","53","9","0.45755","787","1363","-576"
"1905","Bluffton (OH)","38","59","5","0.39706","850","1433","-583"
"1906","Ferris St. (MI)","32","43","12","0.43678","677","854","-177"
"1907","Ferris St. (MI)","32","48","10","0.41111","722","1208","-486"
"1908","Western Illinois","36","45","10","0.45055","760","1069","-309"
"1909","Delaware Valley (PA)","27","52","2","0.34568","682","1287","-605"
"1910","East Stroudsburg (PA)","23","31","3","0.42982","583","738","-155"
"1911","Western Illinois","32","44","7","0.42771","661","902","-241"
"1912","Indiana (PA)","36","56","7","0.39899","1134","1463","-329"
"1913","Saint Francis (NY)","52","67","8","0.44094","1672","2360","-688"
"1914","Delaware Valley (PA)","41","50","6","0.45361","1217","1585","-368"
"1915","Western Illinois","34","35","11","0.49375","932","1217","-285"
"1916","Morgan St. (MD)","44","43","7","0.50532","1493","1270","223"
"1917","Morgan St. (MD)","21","21","2","0.50000","408","883","-475"
"1918","Oklahoma Baptist University","7","16","2","0.32000","258","358","-100"
"1919","Western Illinois","53","41","8","0.55882","1478","1056","422"
"1920","Virginia Union","28","39","2","0.42029","506","893","-387"
"1921","Cooper Union (NY)","19","34","3","0.36607","441","1112","-671"
"1922","Cooper Union (NY)","27","34","6","0.44776","703","832","-129"
"1923","Cooper Union (NY)","31","45","2","0.41026","718","1112","-394"
"1924","East Stroudsburg (PA)","34","40","6","0.46250","946","1175","-229"
"1925","Saint Anselm (NH)","32","28","10","0.52857","847","802","45"
"1926","Saint Anselm (NH)","22","30","4","0.42857","515","702","-187"
"1927","Bethune-Cookman (FL)","20","29","8","0.42105","674","783","-109"
"1928","Saint Anselm (NH)","28","24","7","0.53390","564","1095","-531"
"1929","Saint Anselm (NH)","25","32","5","0.44355","616","843","-227"
"1930","Saint Anselm (NH)","31","27","10","0.52941","643","549","94"
"1931","Campbell (NC)","21","17","4","0.54762","465","428","37"
"1932","Campbell (NC)","7","30","3","0.21250","254","760","-506"
"1933","Campbell (NC)","11","13","3","0.46296","262","324","-62"
"1934","Bowie St. (MD)","4","7","2","0.38462","116","94","22"
"1935","Florida Southern","7","12","1","0.37500","170","162","8"
"1936","Bowie St. (MD)","5","2","1","0.68750","154","97","57"
"1937","Bowie St. (MD)","6","3","0","0.66667","98","87","11"
"1938","West Alabama","7","5","0","0.58333","151","88","63"
"1939","Elizabeth City St. (NC)","7","13","0","0.35000","150","307","-157"
"1940","Elizabeth City St. (NC)","6","5","4","0.53333","128","67","61"
"1941","Arkansas-Pine Bluff","3","9","5","0.32353","178","223","-45"
"1942","Brevard College (NC)","10","6","2","0.61111","225","189","36"
"1943","Clark Atlanta (GA)","6","8","0","0.42857","127","206","-79"
"1944","Abilene Christian (TX)","9","11","1","0.45238","158","255","-97"
"1945","Benedict (SC)","10","15","2","0.40741","299","296","3"
"1946","Elizabeth City St. (NC)","7","20","3","0.28333","144","540","-396"
"1947","Clark Atlanta (GA)","3","6","2","0.36364","49","230","-181"
"1948","Virginia-Lynchburg","4","6","1","0.40909","77","302","-225"
"1949","Virginia-Lynchburg","0","3","1","0.12500","7","70","-63"
"1950","Virginia-Lynchburg","2","3","0","0.40000","53","98","-45"
"1951","Lane (TN)","8","6","0","0.57143","295","234","61"
"1952","Lane (TN)","9","5","1","0.63333","220","206","14"
"1953","Lane (TN)","1","7","0","0.12500","58","215","-157"
"1954","Lane (TN)","2","6","0","0.25000","105","135","-30"
"1955","Lane (TN)","2","4","0","0.33333","83","129","-46"
"1957","Louisiana College","2","7","0","0.22222","106","179","-73"
"1959","Azusa Pacific (CA)","2","3","0","0.40000","117","90","27"
"1960","Azusa Pacific (CA)","4","3","1","0.56250","103","76","27"
"1961","Azusa Pacific (CA)","3","3","0","0.50000","123","147","-24"
"1963","San Francisco (CA)","2","5","0","0.28571","58","98","-40"
"1964","New York (NY)","0","2","0","0.00000","20","48","-28"
"1965","Adelphi (NY)","4","8","0","0.33333","198","216","-18"
"1966","Fairfield (CT)","18","22","2","0.45238","545","652","-107"
"1967","La Salle (PA)","25","31","0","0.44643","846","1080","-234"
"1968","Centenary (LA)","17","42","2","0.29508","726","1393","-667"
"1969","Bluffton (OH)","33","43","0","0.43421","1058","1548","-490"
"1970","Saint John's (NY)","35","54","1","0.39444","1379","1783","-404"
"1971","Bluffton (OH)","43","45","1","0.48876","1360","1384","-24"
"1972","Marquette (WI)","39","44","2","0.47059","1217","1351","-134"
"1973","Brooklyn (NY)","30","52","1","0.36747","1007","1611","-604"
"1974","Marquette (WI)","33","36","3","0.47917","959","1169","-210"
"1975","Marquette (WI)","31","22","4","0.57895","1042","932","110"
"1976","Bluffton (OH)","23","33","1","0.41228","862","1186","-324"
"1977","Manhattan (NY)","14","28","1","0.33721","568","923","-355"
"1978","Fairfield (CT)","5","7","1","0.42308","194","203","-9"
"1979","Fairfield (CT)","7","8","0","0.46667","247","260","-13"
"1980","Westfield St. (MA)","6","5","4","0.53333","184","196","-12"
"1981","San Francisco (CA)","17","14","0","0.54839","567","498","69"
"1982","Manhattan (NY)","18","16","0","0.52941","580","644","-64"
"1983","SUNY-Stony Brook (NY)","15","11","0","0.57692","474","453","21"
"1984","Stonehill (MA)","7","12","0","0.36842","231","439","-208"
"1985","Manhattan (NY)","10","10","0","0.50000","313","316","-3"
"1986","Marquette (WI)","13","17","0","0.43333","497","564","-67"
"1987","Marquette (WI)","10","17","0","0.37037","389","487","-98"
"1988","Marquette (WI)","1","5","0","0.16667","80","125","-45"
"1989","Marquette (WI)","4","4","0","0.50000","209","151","58"
"1990","Marquette (WI)","1","7","0","0.12500","80","180","-100"
"1991","Marquette (WI)","1","5","0","0.16667","106","182","-76"
"1992","Marquette (WI)","2","5","0","0.28571","81","129","-48"
"1993","Marquette (WI)","7","1","0","0.87500","212","126","86"
"1994","Marquette (WI)","1","6","0","0.14286","125","184","-59"
"1995","Marquette (WI)","3","4","0","0.42857","141","191","-50"
"1996","Marquette (WI)","3","5","0","0.37500","139","182","-43"
"1998","Madison College (WI)","2","15","0","0.11765","221","613","-392"
"1999","Marquette (WI)","0","7","0","0.00000","110","298","-188"
"2000","Marquette (WI)","1","5","0","0.16667","60","96","-36"
"2001","Marquette (WI)","2","6","0","0.25000","144","179","-35"
"2002","Marquette (WI)","3","4","0","0.42857","127","208","-81"
"2003","Marquette (WI)","1","6","0","0.14286","71","151","-80"
"2004","Marquette (WI)","0","6","0","0.00000","53","238","-185"
"2005","Marquette (WI)","2","5","0","0.28571","92","226","-134"
"2006","Marquette (WI)","1","6","0","0.14286","62","206","-144"
"2007","Marquette (WI)","2","5","0","0.28571","140","215","-75"
"2008","Marquette (WI)","0","7","0","0.00000","61","304","-243"
"2009","Marquette (WI)","0","1","0","0.00000","0","22","-22"
"1885","Minnesota","0","2","0","0.00000","13","27","-14"
"1890","Kentucky","1","0","0","1.00000","8","2","6"
"1896","Saint John's (NY)","1","0","0","1.00000","6","0","6"
"1898","Emporia St. (KS)","0","2","0","0.00000","0","60","-60"
"1900","Boston College (MA)","1","0","0","1.00000","5","0","5"
"1901","Saint John's (NY)","0","1","0","0.00000","0","61","-61"
"1902","La Salle (PA)","0","4","0","0.00000","12","65","-53"
"1904","Louisiana-Lafayette","2","0","1","0.83333","28","4","24"
"1908","Saint John's (NY)","0","2","0","0.00000","0","18","-18"
"1909","North Carolina A&T","0","1","0","0.00000","0","11","-11"
"1910","Clarion (PA)","0","1","0","0.00000","0","39","-39"
"1917","Texas St.","1","0","0","1.00000","12","0","12"
"1924","Manhattan (NY)","4","4","0","0.50000","74","69","5"
"1929","Campbellsville (KY)","0","1","0","0.00000","6","54","-48"
"1943","William & Mary Freshmen (VA)","4","2","0","0.66667","157","56","101"
"1908","Louisiana-Lafayette","6","0","0","1.00000","93","16","77"
"1909","Louisiana-Lafayette","5","2","1","0.68750","200","59","141"
"1910","Louisiana-Lafayette","6","2","1","0.72222","110","123","-13"
"1911","Louisiana-Lafayette","1","4","1","0.25000","35","95","-60"
"1913","Louisiana-Lafayette","4","4","0","0.50000","148","155","-7"
"1917","Louisiana-Lafayette","8","2","0","0.80000","336","46","290"
"1918","Louisiana-Lafayette","4","1","0","0.80000","166","100","66"
"1912","Louisiana-Lafayette","3","4","0","0.42857","90","239","-149"
"1913","Northwestern St. (LA)","4","1","1","0.75000","213","67","146"
"1914","Northwestern St. (LA)","4","1","1","0.75000","203","19","184"
"1915","Northwestern St. (LA)","4","2","0","0.66667","288","45","243"
"1916","Northwestern St. (LA)","1","2","0","0.33333","84","46","38"
"1917","Northwestern St. (LA)","2","1","0","0.66667","57","34","23"
"1919","Northwestern St. (LA)","5","2","0","0.71429","105","25","80"
"1920","Northwestern St. (LA)","5","1","1","0.78571","76","47","29"
"1921","Northwestern St. (LA)","3","3","1","0.50000","37","134","-97"
"1922","Northwestern St. (LA)","4","2","1","0.64286","73","47","26"
"1923","Northwestern St. (LA)","3","6","0","0.33333","65","209","-144"
"1924","Northwestern St. (LA)","4","2","1","0.64286","91","63","28"
"1925","Northwestern St. (LA)","5","3","1","0.61111","101","70","31"
"1926","Northwestern St. (LA)","3","5","1","0.38889","88","160","-72"
"1927","Northwestern St. (LA)","2","3","2","0.42857","63","85","-22"
"1928","Northwestern St. (LA)","5","4","0","0.55556","152","153","-1"
"1929","Northwestern St. (LA)","4","3","2","0.55556","125","117","8"
"1930","Northwestern St. (LA)","7","2","0","0.77778","151","107","44"
"1931","Northwestern St. (LA)","5","4","0","0.55556","184","95","89"
"1932","Northwestern St. (LA)","7","1","0","0.87500","162","53","109"
"1933","Northwestern St. (LA)","5","3","1","0.61111","141","48","93"
"1914","Louisiana-Lafayette","5","3","0","0.62500","200","107","93"
"1915","Louisiana-Lafayette","5","2","1","0.68750","127","41","86"
"1915","Parsons (IA)","4","4","0","0.50000","185","96","89"
"1920","Louisiana-Lafayette","2","8","0","0.20000","83","232","-149"
"1916","Louisiana-Lafayette","7","1","0","0.87500","240","30","210"
"1919","Louisiana-Lafayette","2","4","2","0.37500","70","146","-76"
"1921","Louisiana-Lafayette","9","2","0","0.81818","217","104","113"
"1922","Louisiana-Lafayette","3","4","2","0.44444","84","54","30"
"1923","Louisiana-Lafayette","7","3","0","0.70000","240","107","133"
"1924","Louisiana-Lafayette","6","2","1","0.72222","214","93","121"
"1925","Louisiana-Lafayette","7","2","0","0.77778","176","72","104"
"1926","Louisiana-Lafayette","6","3","1","0.65000","153","98","55"
"1927","Louisiana-Lafayette","2","7","1","0.25000","30","195","-165"
"1928","Louisiana-Lafayette","4","5","0","0.44444","113","174","-61"
"1929","Louisiana-Lafayette","2","7","0","0.22222","52","203","-151"
"1930","Louisiana-Lafayette","2","8","0","0.20000","52","257","-205"
"1931","Louisiana-Lafayette","1","6","1","0.18750","22","210","-188"
"1932","Louisiana-Lafayette","3","4","0","0.42857","46","53","-7"
"1933","Louisiana-Lafayette","6","3","0","0.66667","128","35","93"
"1934","Louisiana-Lafayette","5","4","0","0.55556","121","70","51"
"1935","Louisiana-Lafayette","2","8","0","0.20000","48","172","-124"
"1936","Louisiana-Lafayette","2","7","1","0.25000","54","225","-171"
"1937","Louisiana-Lafayette","4","3","1","0.56250","59","51","8"
"1938","Louisiana-Lafayette","8","2","1","0.77273","141","68","73"
"1939","Louisiana-Lafayette","3","5","1","0.38889","82","60","22"
"1940","Louisiana-Lafayette","6","3","1","0.65000","77","74","3"
"1941","Louisiana-Lafayette","6","2","1","0.72222","124","73","51"
"1946","Louisiana-Lafayette","6","4","0","0.60000","188","130","58"
"1942","Louisiana-Lafayette","3","4","0","0.42857","115","98","17"
"1943","Louisiana-Lafayette","5","0","1","0.91667","172","40","132"
"1944","Louisiana-Lafayette","5","4","0","0.55556","124","70","54"
"1945","Louisiana-Lafayette","1","6","1","0.18750","32","183","-151"
"1947","Louisiana-Lafayette","6","2","0","0.75000","165","58","107"
"1948","Louisiana-Lafayette","6","3","1","0.65000","179","134","45"
"1949","Louisiana-Lafayette","6","3","0","0.66667","174","145","29"
"1931","Southeastern Louisiana","2","2","2","0.50000","32","98","-66"
"1932","Southeastern Louisiana","3","5","0","0.37500","114","53","61"
"1933","Southeastern Louisiana","7","3","0","0.70000","252","109","143"
"1934","Southeastern Louisiana","7","3","0","0.70000","191","70","121"
"1935","Southeastern Louisiana","7","2","0","0.77778","110","51","59"
"1936","Southeastern Louisiana","7","0","1","0.93750","182","19","163"
"1937","Southeastern Louisiana","8","2","1","0.77273","241","59","182"
"1950","Louisiana-Lafayette","5","4","0","0.55556","159","100","59"
"1951","Louisiana-Lafayette","6","4","0","0.60000","227","198","29"
"1952","Louisiana-Lafayette","5","2","2","0.66667","203","131","72"
"1953","Louisiana-Lafayette","4","7","0","0.36364","168","247","-79"
"1954","Louisiana-Lafayette","5","4","0","0.55556","222","159","63"
"1955","Louisiana-Lafayette","5","4","0","0.55556","170","139","31"
"1956","Louisiana-Lafayette","4","6","0","0.40000","239","299","-60"
"1957","Louisiana-Lafayette","4","5","1","0.45000","99","143","-44"
"1966","East Tennessee St.","3","6","0","0.33333","112","119","-7"
"1967","East Tennessee St.","3","6","1","0.35000","133","145","-12"
"1968","East Tennessee St.","5","5","0","0.50000","151","170","-19"
"1969","East Tennessee St.","10","0","1","0.95455","219","114","105"
"1970","East Tennessee St.","7","1","2","0.80000","161","81","80"
"1971","East Tennessee St.","0","9","1","0.05000","108","242","-134"
"1972","East Tennessee St.","3","7","0","0.30000","203","221","-18"
"1958","Louisiana-Lafayette","1","8","0","0.11111","67","176","-109"
"1959","Louisiana-Lafayette","4","5","0","0.44444","158","157","1"
"1960","Louisiana-Lafayette","6","4","0","0.60000","137","107","30"
"1961","Louisiana-Lafayette","2","8","0","0.20000","99","194","-95"
"1962","Louisiana-Lafayette","4","5","1","0.45000","116","143","-27"
"1963","Louisiana-Lafayette","4","5","0","0.44444","74","150","-76"
"1964","Louisiana-Lafayette","5","4","0","0.55556","140","115","25"
"1965","Louisiana-Lafayette","7","3","0","0.70000","173","85","88"
"1966","Louisiana-Lafayette","6","4","0","0.60000","139","103","36"
"1967","Louisiana-Lafayette","6","4","0","0.60000","142","126","16"
"1968","Louisiana-Lafayette","8","2","0","0.80000","227","153","74"
"1969","Louisiana-Lafayette","5","5","0","0.50000","179","237","-58"
"1970","Louisiana-Lafayette","9","3","0","0.75000","276","176","100"
"1971","Louisiana-Lafayette","5","4","1","0.55000","171","152","19"
"1972","Louisiana-Lafayette","5","6","0","0.45455","160","124","36"
"1973","Louisiana-Lafayette","0","10","0","0.00000","75","275","-200"
"1974","Louisiana-Lafayette","2","9","0","0.18182","149","287","-138"
"1975","Louisiana-Lafayette","6","5","0","0.54545","259","233","26"
"1976","Louisiana-Lafayette","7","4","0","0.63636","261","148","113"
"1977","Louisiana-Lafayette","6","4","2","0.58333","239","181","58"
"1978","Louisiana-Lafayette","3","8","0","0.27273","127","229","-102"
"1979","Louisiana-Lafayette","4","7","0","0.36364","147","168","-21"
"1980","Louisiana-Lafayette","7","4","0","0.63636","194","144","50"
"1981","Louisiana-Lafayette","1","9","1","0.13636","135","229","-94"
"1982","Louisiana-Lafayette","7","3","1","0.68182","248","196","52"
"1983","Louisiana-Lafayette","4","6","0","0.40000","194","212","-18"
"1984","Louisiana-Lafayette","6","5","0","0.54545","207","198","9"
"1985","Louisiana-Lafayette","4","7","0","0.36364","162","306","-144"
"1986","Louisiana-Lafayette","6","5","0","0.54545","242","204","38"
"1987","Louisiana-Lafayette","6","5","0","0.54545","191","252","-61"
"1988","Louisiana-Lafayette","6","5","0","0.54545","296","224","72"
"1989","Louisiana-Lafayette","7","4","0","0.63636","241","232","9"
"1990","Louisiana-Lafayette","5","6","0","0.45455","197","242","-45"
"1991","Louisiana-Lafayette","2","8","1","0.22727","148","269","-121"
"1992","Louisiana-Lafayette","2","9","0","0.18182","143","306","-163"
"1993","Louisiana-Lafayette","8","3","0","0.72727","249","227","22"
"1994","Louisiana-Lafayette","6","5","0","0.54545","221","264","-43"
"1995","Louisiana-Lafayette","6","5","0","0.54545","351","275","76"
"1996","Louisiana-Lafayette","5","6","0","0.45455","304","404","-100"
"1997","Louisiana-Lafayette","1","10","0","0.09091","176","553","-377"
"1998","Louisiana-Lafayette","2","9","0","0.18182","199","453","-254"
"1999","Louisiana-Lafayette","2","9","0","0.18182","203","415","-212"
"2000","Louisiana-Lafayette","1","10","0","0.09091","171","355","-184"
"2001","Louisiana-Lafayette","3","8","0","0.27273","234","365","-131"
"2002","Louisiana-Lafayette","3","9","0","0.25000","203","352","-149"
"2003","Louisiana-Lafayette","4","8","0","0.33333","266","415","-149"
"2004","Louisiana-Lafayette","4","7","0","0.36364","242","272","-30"
"2005","Louisiana-Lafayette","6","5","0","0.54545","286","304","-18"
"2006","Louisiana-Lafayette","6","6","0","0.50000","248","296","-48"
"2007","Louisiana-Lafayette","3","9","0","0.25000","285","430","-145"
"2008","Louisiana-Lafayette","6","6","0","0.50000","397","404","-7"
"2009","Louisiana-Lafayette","6","6","0","0.50000","266","364","-98"
"2010","Louisiana-Lafayette","3","9","0","0.25000","268","444","-176"
"2002","North Alabama","4","7","0","0.36364","338","346","-8"
"2003","North Alabama","13","1","0","0.92857","543","198","345"
"2004","North Alabama","5","5","0","0.50000","312","213","99"
"2005","North Alabama","11","3","0","0.78571","509","250","259"
"2006","North Alabama","11","1","0","0.91667","402","165","237"
"2007","North Alabama","10","2","0","0.83333","450","238","212"
"2008","North Alabama","12","2","0","0.85714","578","243","335"
"2011","Louisiana-Lafayette","9","4","0","0.69231","420","388","32"
"2012","Louisiana-Lafayette","9","4","0","0.69231","461","365","96"
"2013","Louisiana-Lafayette","9","4","0","0.69231","439","344","95"
"1951","Louisiana-Monroe","6","2","0","0.75000","253","128","125"
"1952","Louisiana-Monroe","5","4","0","0.55556","243","210","33"
"1953","Louisiana-Monroe","1","9","0","0.10000","113","284","-171"
"1954","Louisiana-Monroe","1","8","1","0.15000","119","337","-218"
"1955","Louisiana-Monroe","4","6","0","0.40000","100","206","-106"
"1956","Louisiana-Monroe","8","2","0","0.80000","220","155","65"
"1957","Louisiana-Monroe","2","6","0","0.25000","105","128","-23"
"1958","Louisiana-Monroe","6","3","0","0.66667","189","163","26"
"1959","Louisiana-Monroe","2","8","0","0.20000","116","216","-100"
"1960","Louisiana-Monroe","3","7","0","0.30000","91","136","-45"
"1961","Louisiana-Monroe","3","7","0","0.30000","145","171","-26"
"1962","Louisiana-Monroe","2","6","0","0.25000","74","106","-32"
"1963","Louisiana-Monroe","4","6","0","0.40000","113","141","-28"
"1964","Louisiana-Monroe","0","8","0","0.00000","58","148","-90"
"1965","Louisiana-Monroe","1","8","0","0.11111","58","194","-136"
"1966","Louisiana-Monroe","7","3","0","0.70000","181","101","80"
"1967","Louisiana-Monroe","7","3","0","0.70000","196","111","85"
"1968","Louisiana-Monroe","6","4","0","0.60000","170","101","69"
"1969","Louisiana-Monroe","1","9","0","0.10000","132","216","-84"
"1970","Louisiana-Monroe","5","4","0","0.55556","151","146","5"
"1971","Louisiana-Monroe","4","6","1","0.40909","122","208","-86"
"1972","Louisiana-Monroe","3","7","0","0.30000","125","188","-63"
"1973","Louisiana-Monroe","3","5","2","0.40000","133","222","-89"
"1974","Louisiana-Monroe","4","6","0","0.40000","162","189","-27"
"1975","Louisiana-Monroe","4","6","1","0.40909","252","273","-21"
"1976","Louisiana-Monroe","2","9","0","0.18182","206","321","-115"
"1977","Louisiana-Monroe","2","9","0","0.18182","122","297","-175"
"1978","Louisiana-Monroe","6","4","1","0.59091","190","142","48"
"1979","Louisiana-Monroe","3","8","0","0.27273","158","211","-53"
"1980","Louisiana-Monroe","7","4","0","0.63636","296","267","29"
"1981","Louisiana-Monroe","5","6","0","0.45455","309","251","58"
"1982","Louisiana-Monroe","8","3","0","0.72727","312","216","96"
"1983","Louisiana-Monroe","8","3","0","0.72727","251","119","132"
"1984","Louisiana-Monroe","7","4","0","0.63636","198","159","39"
"1985","Louisiana-Monroe","6","5","0","0.54545","227","201","26"
"1986","Louisiana-Monroe","5","6","0","0.45455","231","205","26"
"1987","Louisiana-Monroe","13","2","0","0.86667","484","343","141"
"1988","Louisiana-Monroe","5","6","0","0.45455","160","214","-54"
"1984","Western Kentucky","2","9","0","0.18182","193","345","-152"
"1985","Western Kentucky","4","7","0","0.36364","232","313","-81"
"1986","Western Kentucky","4","6","1","0.40909","228","258","-30"
"1987","Western Kentucky","7","4","0","0.63636","263","217","46"
"1988","Western Kentucky","9","4","0","0.69231","311","220","91"
"1989","Louisiana-Monroe","5","5","1","0.50000","201","257","-56"
"1990","Louisiana-Monroe","7","5","0","0.58333","208","218","-10"
"1991","Louisiana-Monroe","7","3","1","0.68182","237","175","62"
"1992","Louisiana-Monroe","10","3","0","0.76923","490","295","195"
"1993","Louisiana-Monroe","9","3","0","0.75000","462","275","187"
"1997","Baylor (TX)","2","9","0","0.18182","200","375","-175"
"1998","Baylor (TX)","2","9","0","0.18182","195","323","-128"
"1994","Louisiana-Monroe","3","8","0","0.27273","242","384","-142"
"1995","Louisiana-Monroe","2","9","0","0.18182","233","413","-180"
"1996","Louisiana-Monroe","5","6","0","0.45455","192","353","-161"
"1997","Louisiana-Monroe","5","7","0","0.41667","226","319","-93"
"1998","Louisiana-Monroe","5","6","0","0.45455","227","322","-95"
"1990","McNeese St. (LA)","5","6","0","0.45455","183","265","-82"
"1991","McNeese St. (LA)","6","4","2","0.58333","192","156","36"
"1992","McNeese St. (LA)","9","4","0","0.69231","301","260","41"
"1993","McNeese St. (LA)","10","3","0","0.76923","366","233","133"
"1994","McNeese St. (LA)","10","3","0","0.76923","341","226","115"
"1995","McNeese St. (LA)","13","1","0","0.92857","444","144","300"
"1996","McNeese St. (LA)","3","8","0","0.27273","236","225","11"
"1997","McNeese St. (LA)","13","2","0","0.86667","395","173","222"
"1998","McNeese St. (LA)","9","3","0","0.75000","388","157","231"
"1999","Louisiana-Monroe","5","6","0","0.45455","186","322","-136"
"2000","Louisiana-Monroe","1","10","0","0.09091","96","415","-319"
"2001","Louisiana-Monroe","2","9","0","0.18182","148","351","-203"
"2002","Louisiana-Monroe","0","3","0","0.00000","22","123","-101"
"2002","Louisiana-Monroe","3","6","0","0.33333","214","328","-114"
"1992","Utah St.","5","6","0","0.45455","300","328","-28"
"1993","Utah St.","7","5","0","0.58333","363","354","9"
"1994","Utah St.","3","8","0","0.27273","209","313","-104"
"1995","Navy (MD)","5","6","0","0.45455","223","189","34"
"1996","Navy (MD)","9","3","0","0.75000","392","309","83"
"1997","Navy (MD)","7","4","0","0.63636","398","209","189"
"1998","Navy (MD)","3","8","0","0.27273","255","376","-121"
"1999","Navy (MD)","5","7","0","0.41667","326","306","20"
"2000","Navy (MD)","1","10","0","0.09091","182","391","-209"
"2001","Navy (MD)","0","7","0","0.00000","122","242","-120"
"2003","Louisiana-Monroe","1","11","0","0.08333","239","467","-228"
"2004","Louisiana-Monroe","5","6","0","0.45455","211","303","-92"
"2005","Louisiana-Monroe","5","6","0","0.45455","239","339","-100"
"2006","Louisiana-Monroe","4","8","0","0.33333","262","267","-5"
"2007","Louisiana-Monroe","6","6","0","0.50000","282","332","-50"
"2008","Louisiana-Monroe","4","8","0","0.33333","284","374","-90"
"2009","Louisiana-Monroe","6","6","0","0.50000","307","328","-21"
"1996","Illinois St.","3","8","0","0.27273","226","306","-80"
"1997","Illinois St.","2","9","0","0.18182","220","333","-113"
"1998","Illinois St.","8","4","0","0.66667","425","341","84"
"1999","Illinois St.","11","3","0","0.78571","487","356","131"
"2000","Army (NY)","1","10","0","0.09091","224","372","-148"
"2001","Army (NY)","3","8","0","0.27273","229","365","-136"
"2002","Army (NY)","1","11","0","0.08333","226","491","-265"
"2003","Army (NY)","0","6","0","0.00000","85","223","-138"
"2010","Louisiana-Monroe","5","7","0","0.41667","250","389","-139"
"2011","Louisiana-Monroe","4","8","0","0.33333","295","305","-10"
"2012","Louisiana-Monroe","8","5","0","0.61538","440","379","61"
"2013","Louisiana-Monroe","6","6","0","0.50000","267","362","-95"
"1912","Louisville (KY)","4","1","0","0.80000","165","47","118"
"1913","Louisville (KY)","5","1","0","0.83333","251","20","231"
"1914","Louisville (KY)","1","4","0","0.20000","26","135","-109"
"1915","Louisville (KY)","1","5","1","0.21429","35","119","-84"
"1916","Louisville (KY)","2","3","1","0.41667","37","77","-40"
"1921","Louisville (KY)","2","2","1","0.50000","49","29","20"
"1922","Louisville (KY)","2","7","0","0.22222","79","248","-169"
"1923","Louisville (KY)","5","3","0","0.62500","84","73","11"
"1924","Louisville (KY)","3","5","1","0.38889","43","95","-52"
"1931","Arizona","3","5","1","0.38889","72","149","-77"
"1925","Louisville (KY)","8","0","0","1.00000","133","2","131"
"1926","Louisville (KY)","6","2","0","0.75000","226","54","172"
"1927","Louisville (KY)","4","4","0","0.50000","114","163","-49"
"1928","Louisville (KY)","1","7","0","0.12500","72","186","-114"
"1929","Louisville (KY)","3","5","0","0.37500","37","101","-64"
"1930","Louisville (KY)","5","3","0","0.62500","134","73","61"
"1931","Louisville (KY)","0","8","0","0.00000","50","251","-201"
"1927","Hanover (IN)","1","6","1","0.18750","30","166","-136"
"1928","Hanover (IN)","3","4","0","0.42857","61","50","11"
"1929","Hanover (IN)","2","3","1","0.41667","45","51","-6"
"1930","Hanover (IN)","1","4","2","0.28571","69","86","-17"
"1931","Hanover (IN)","1","7","1","0.16667","26","182","-156"
"1932","Louisville (KY)","0","9","0","0.00000","18","392","-374"
"1940","Ferris St. (MI)","1","7","0","0.12500","21","235","-214"
"1941","Ferris St. (MI)","1","4","1","0.25000","46","73","-27"
"1933","Louisville (KY)","1","7","0","0.12500","26","214","-188"
"1934","Louisville (KY)","2","5","0","0.28571","40","104","-64"
"1935","Louisville (KY)","1","6","1","0.18750","47","133","-86"
"1936","Louisville (KY)","4","4","0","0.50000","88","134","-46"
"1937","Louisville (KY)","2","5","1","0.31250","60","114","-54"
"1938","Louisville (KY)","2","6","0","0.25000","40","80","-40"
"1939","Louisville (KY)","5","2","1","0.68750","92","30","62"
"1940","Louisville (KY)","3","5","1","0.38889","91","134","-43"
"1941","Louisville (KY)","4","4","0","0.50000","142","134","8"
"1942","Louisville (KY)","2","3","0","0.40000","58","95","-37"
"1946","Louisville (KY)","6","2","0","0.75000","136","62","74"
"1947","Louisville (KY)","7","0","1","0.93750","193","63","130"
"1948","Louisville (KY)","5","5","0","0.50000","186","194","-8"
"1949","Louisville (KY)","8","3","0","0.72727","344","143","201"
"1950","Louisville (KY)","3","6","1","0.35000","239","238","1"
"1951","Louisville (KY)","5","4","0","0.55556","151","208","-57"
"1952","Louisville (KY)","3","5","0","0.37500","172","224","-52"
"1953","Louisville (KY)","1","8","0","0.11111","77","291","-214"
"1954","Louisville (KY)","3","6","0","0.33333","116","177","-61"
"1955","Louisville (KY)","7","2","0","0.77778","289","134","155"
"1956","Louisville (KY)","6","3","0","0.66667","153","111","42"
"1957","Louisville (KY)","9","1","0","0.90000","350","106","244"
"1958","Louisville (KY)","4","4","0","0.50000","144","97","47"
"1959","Louisville (KY)","6","4","0","0.60000","218","132","86"
"1960","Louisville (KY)","7","2","0","0.77778","196","77","119"
"1961","Louisville (KY)","6","3","0","0.66667","180","91","89"
"1962","Louisville (KY)","6","4","0","0.60000","174","173","1"
"1963","Louisville (KY)","3","7","0","0.30000","118","213","-95"
"1964","Louisville (KY)","1","9","0","0.10000","70","217","-147"
"1965","Louisville (KY)","6","4","0","0.60000","218","164","54"
"1966","Louisville (KY)","6","4","0","0.60000","231","159","72"
"1967","Louisville (KY)","5","5","0","0.50000","260","162","98"
"1968","Louisville (KY)","5","5","0","0.50000","192","233","-41"
"1969","Louisville (KY)","5","4","1","0.55000","206","273","-67"
"1970","Louisville (KY)","8","3","1","0.70833","252","208","44"
"1971","Louisville (KY)","6","3","1","0.65000","190","111","79"
"1972","Louisville (KY)","9","1","0","0.90000","309","91","218"
"1973","Indiana","2","9","0","0.18182","151","271","-120"
"1974","Indiana","1","10","0","0.09091","166","292","-126"
"1975","Indiana","2","8","1","0.22727","104","254","-150"
"1976","Indiana","5","6","0","0.45455","130","254","-124"
"1977","Indiana","5","5","1","0.50000","205","228","-23"
"1978","Indiana","4","7","0","0.36364","228","290","-62"
"1979","Indiana","8","4","0","0.66667","314","252","62"
"1980","Indiana","6","5","0","0.54545","255","235","20"
"1981","Indiana","3","8","0","0.27273","144","293","-149"
"1982","Indiana","5","6","0","0.45455","203","250","-47"
"1984","Northern Illinois","4","6","1","0.40909","153","188","-35"
"1973","Louisville (KY)","5","6","0","0.45455","172","148","24"
"1974","Louisville (KY)","4","7","0","0.36364","136","254","-118"
"1967","Kansas St.","1","9","0","0.10000","90","263","-173"
"1968","Kansas St.","4","6","0","0.40000","194","247","-53"
"1969","Kansas St.","5","5","0","0.50000","316","233","83"
"1970","Kansas St.","6","5","0","0.54545","190","218","-28"
"1971","Kansas St.","5","6","0","0.45455","219","296","-77"
"1972","Kansas St.","3","8","0","0.27273","169","407","-238"
"1973","Kansas St.","5","6","0","0.45455","176","260","-84"
"1974","Kansas St.","4","7","0","0.36364","193","283","-90"
"1975","Louisville (KY)","2","9","0","0.18182","148","316","-168"
"1976","Louisville (KY)","5","6","0","0.45455","177","234","-57"
"1977","Louisville (KY)","7","4","1","0.62500","291","194","97"
"1978","Louisville (KY)","7","4","0","0.63636","319","202","117"
"1979","Louisville (KY)","4","6","1","0.40909","167","202","-35"
"1980","Tulane (LA)","7","5","0","0.58333","279","243","36"
"1981","Tulane (LA)","6","5","0","0.54545","213","144","69"
"1982","Tulane (LA)","4","7","0","0.36364","201","271","-70"
"1969","Arizona","3","7","0","0.30000","210","276","-66"
"1970","Arizona","4","6","0","0.40000","168","213","-45"
"1971","Arizona","5","6","0","0.45455","191","232","-41"
"1972","Arizona","4","7","0","0.36364","226","271","-45"
"1980","Louisville (KY)","5","6","0","0.45455","162","203","-41"
"1981","Louisville (KY)","5","6","0","0.45455","180","212","-32"
"1982","Louisville (KY)","5","6","0","0.45455","220","355","-135"
"1983","Louisville (KY)","3","8","0","0.27273","157","351","-194"
"1984","Louisville (KY)","2","9","0","0.18182","237","360","-123"
"1979","Miami (FL)","5","6","0","0.45455","191","236","-45"
"1980","Miami (FL)","9","3","0","0.75000","278","171","107"
"1981","Miami (FL)","9","2","0","0.81818","245","145","100"
"1982","Miami (FL)","7","4","0","0.63636","241","153","88"
"1983","Miami (FL)","11","1","0","0.91667","313","136","177"
"1985","Louisville (KY)","2","9","0","0.18182","199","429","-230"
"1986","Louisville (KY)","3","8","0","0.27273","179","303","-124"
"1987","Louisville (KY)","3","7","1","0.31818","215","348","-133"
"1988","Louisville (KY)","8","3","0","0.72727","261","245","16"
"1989","Louisville (KY)","6","5","0","0.54545","312","222","90"
"1990","Louisville (KY)","10","1","1","0.87500","345","149","196"
"1991","Louisville (KY)","2","9","0","0.18182","135","335","-200"
"1992","Louisville (KY)","5","6","0","0.45455","214","243","-29"
"1993","Louisville (KY)","9","3","0","0.75000","350","243","107"
"1994","Louisville (KY)","6","5","0","0.54545","255","253","2"
"1995","Oklahoma","5","5","1","0.50000","233","275","-42"
"2001","Florida Atlantic","4","6","0","0.40000","177","245","-68"
"2002","Florida Atlantic","2","9","0","0.18182","176","339","-163"
"2003","Florida Atlantic","11","3","0","0.78571","404","306","98"
"2004","Florida Atlantic","9","3","0","0.75000","299","207","92"
"2005","Florida Atlantic","2","9","0","0.18182","148","339","-191"
"2006","Florida Atlantic","5","7","0","0.41667","181","299","-118"
"2007","Florida Atlantic","8","5","0","0.61538","405","432","-27"
"2008","Florida Atlantic","7","6","0","0.53846","326","373","-47"
"2009","Florida Atlantic","5","7","0","0.41667","329","405","-76"
"2010","Florida Atlantic","4","8","0","0.33333","202","351","-149"
"2011","Florida Atlantic","1","11","0","0.08333","155","416","-261"
"1993","Eastern Michigan","4","7","0","0.36364","163","220","-57"
"1994","Eastern Michigan","5","6","0","0.45455","247","285","-38"
"1995","Louisville (KY)","7","4","0","0.63636","283","165","118"
"1996","Louisville (KY)","5","6","0","0.45455","182","205","-23"
"1997","Louisville (KY)","1","10","0","0.09091","245","407","-162"
"1998","Alabama A&M","5","6","0","0.45455","220","248","-28"
"1999","Alabama A&M","6","5","0","0.54545","287","230","57"
"2000","Alabama A&M","7","5","0","0.58333","312","227","85"
"2001","Alabama A&M","5","6","0","0.45455","215","246","-31"
"1989","Idaho","9","3","0","0.75000","407","314","93"
"1990","Idaho","9","4","0","0.69231","477","342","135"
"1991","Idaho","6","5","0","0.54545","375","313","62"
"1992","Idaho","9","3","0","0.75000","466","247","219"
"1993","Idaho","11","3","0","0.78571","593","353","240"
"1994","Idaho","9","3","0","0.75000","493","289","204"
"1995","Utah St.","4","7","0","0.36364","293","287","6"
"1996","Utah St.","6","5","0","0.54545","330","339","-9"
"1997","Utah St.","6","6","0","0.50000","389","296","93"
"1998","Louisville (KY)","7","5","0","0.58333","473","435","38"
"1999","Louisville (KY)","7","5","0","0.58333","443","365","78"
"2000","Louisville (KY)","9","3","0","0.75000","405","268","137"
"2001","Louisville (KY)","11","2","0","0.84615","394","223","171"
"2002","Louisville (KY)","7","6","0","0.53846","374","319","55"
"2003","Michigan St.","8","5","0","0.61538","363","293","70"
"2004","Michigan St.","5","7","0","0.41667","353","326","27"
"2005","Michigan St.","5","6","0","0.45455","372","316","56"
"2006","Michigan St.","4","8","0","0.33333","302","341","-39"
"2012","Arkansas","4","8","0","0.33333","282","365","-83"
"2013","Fort Lewis (CO)","4","7","0","0.36364","161","334","-173"
"2003","Louisville (KY)","9","4","0","0.69231","450","361","89"
"2004","Louisville (KY)","11","1","0","0.91667","597","236","361"
"2005","Louisville (KY)","9","3","0","0.75000","521","285","236"
"2006","Louisville (KY)","12","1","0","0.92308","491","212","279"
"2008","Arkansas","5","7","0","0.41667","263","374","-111"
"2009","Arkansas","8","5","0","0.61538","468","326","142"
"2010","Arkansas","10","3","0","0.76923","474","304","170"
"2011","Arkansas","11","2","0","0.84615","478","289","189"
"2013","Western Kentucky","8","4","0","0.66667","370","295","75"
"2003","Tulsa (OK)","8","5","0","0.61538","400","361","39"
"2004","Tulsa (OK)","4","8","0","0.33333","348","398","-50"
"2005","Tulsa (OK)","9","4","0","0.69231","430","305","125"
"2006","Tulsa (OK)","8","5","0","0.61538","360","262","98"
"2007","Louisville (KY)","6","6","0","0.50000","422","377","45"
"2008","Louisville (KY)","5","7","0","0.41667","296","358","-62"
"2009","Louisville (KY)","4","8","0","0.33333","217","315","-98"
"2004","Florida","0","1","0","0.00000","10","27","-17"
"2010","Louisville (KY)","7","6","0","0.53846","343","252","91"
"2011","Louisville (KY)","7","6","0","0.53846","285","261","24"
"2012","Louisville (KY)","11","2","0","0.84615","405","309","96"
"2013","Louisville (KY)","12","1","0","0.92308","457","158","299"
"1869","Rutgers (NJ)","2","2","0","0.50000","18","18","0"
"1870","Rutgers (NJ)","2","2","0","0.50000","17","17","0"
"1872","Columbia (NY)","5","4","0","0.55556","22","16","6"
"1873","Rutgers (NJ)","7","4","1","0.62500","31","26","5"
"1874","Harvard (MA)","9","7","0","0.56250","54","41","13"
"1875","Harvard (MA)","12","6","2","0.65000","52","29","23"
"1876","Harvard (MA)","13","8","1","0.61364","45","29","16"
"1877","Harvard (MA)","9","7","3","0.55263","31","21","10"
"1878","Pennsylvania","14","9","5","0.58929","42","24","18"
"1879","Harvard (MA)","13","9","12","0.55882","46","27","19"
"1880","Harvard (MA)","18","11","4","0.60606","75","53","22"
"1881","Rutgers (NJ)","22","18","8","0.54167","70","47","23"
"1882","Rutgers (NJ)","41","28","2","0.59155","176","111","65"
"1883","Rutgers (NJ)","38","32","1","0.54225","1288","965","323"
"1884","Pennsylvania","47","29","5","0.61111","1728","1184","544"
"1885","Michigan","34","17","4","0.65455","1437","612","825"
"1886","Lehigh (PA)","48","21","4","0.68493","1850","637","1213"
"1887","California","67","35","3","0.65238","2660","935","1725"
"1888","Princeton (NJ)","70","56","6","0.55303","2468","1899","569"
"1889","Brown (RI)","82","51","11","0.60764","2879","1796","1083"
"1890","Brown (RI)","77","76","9","0.50309","3002","2455","547"
"1891","Southern California","94","76","13","0.54918","2813","2189","624"
"1892","Minnesota","93","80","9","0.53571","2972","2394","578"
"1893","Duke (NC)","79","94","9","0.45879","2176","2912","-736"
"1894","Colorado St.","50","62","4","0.44828","1161","1518","-357"
"1895","Boston (MA)","31","44","11","0.42442","692","1031","-339"
"1896","Rhode Island","54","62","12","0.46875","1126","1201","-75"
"1897","Boston (MA)","32","40","6","0.44872","792","785","7"
"1898","Miami (OH)","47","23","4","0.66216","921","644","277"
"1899","New Hampshire","33","32","6","0.50704","571","522","49"
"1900","New Hampshire","22","35","11","0.40441","442","686","-244"
"1901","Marshall (WV)","18","34","3","0.35455","302","917","-615"
"1902","Saint John's (MN)","9","22","4","0.31429","148","460","-312"
"1903","Wichita St. (KS)","14","25","2","0.36585","376","546","-170"
"1904","Oklahoma St.","11","14","1","0.44231","194","394","-200"
"1905","Miami (OH)","7","25","5","0.25676","245","494","-249"
"1906","Rensselaer Tech (NY)","3","7","4","0.35714","92","107","-15"
"1907","Marshall (WV)","5","10","2","0.35294","71","238","-167"
"1908","Fort Hays St. (KS)","5","6","1","0.45833","56","91","-35"
"1909","Fort Hays St. (KS)","1","3","1","0.30000","12","68","-56"
"1910","Texas St.","0","1","0","0.00000","0","19","-19"
"1912","Fort Hays St. (KS)","1","2","0","0.33333","20","132","-112"
"1913","Eureka (IL)","1","6","0","0.14286","39","203","-164"
"1914","Eureka (IL)","3","4","0","0.42857","57","201","-144"
"1915","Texas St.","1","1","1","0.50000","13","20","-7"
"1916","Texas St.","0","2","1","0.16667","0","106","-106"
"1917","Boston (MA)","4","4","0","0.50000","73","136","-63"
"1918","Monmouth (IL)","1","7","0","0.12500","26","137","-111"
"1930","Troy (AL)","1","2","0","0.33333","7","73","-66"
"2013","Grambling St. (LA)","0","1","0","0.00000","0","0","0"
"1902","Marshall (WV)","3","2","2","0.57143","45","23","22"
"1903","Marshall (WV)","3","2","1","0.58333","37","50","-13"
"1904","Marshall (WV)","1","3","3","0.35714","16","26","-10"
"1905","Marshall (WV)","6","2","0","0.75000","40","98","-58"
"1906","Marshall (WV)","4","0","1","0.90000","56","5","51"
"1908","Marshall (WV)","2","6","0","0.25000","36","113","-77"
"1909","Marshall (WV)","3","2","1","0.58333","107","95","12"
"1910","Marshall (WV)","5","1","1","0.78571","91","14","77"
"1911","Marshall (WV)","4","1","1","0.75000","122","22","100"
"1912","Marshall (WV)","3","4","0","0.42857","197","94","103"
"1913","Marshall (WV)","4","4","0","0.50000","85","101","-16"
"1914","Marshall (WV)","5","5","0","0.50000","231","168","63"
"1915","Marshall (WV)","1","8","0","0.11111","86","257","-171"
"1916","Marshall (WV)","7","2","1","0.75000","267","102","165"
"1918","Cincinnati (OH)","3","0","2","0.80000","45","13","32"
"1919","Cincinnati (OH)","3","4","1","0.43750","73","102","-29"
"1920","Cincinnati (OH)","4","5","0","0.44444","125","96","29"
"1921","Cincinnati (OH)","3","6","0","0.33333","181","114","67"
"1917","Marshall (WV)","1","7","1","0.16667","8","345","-337"
"1919","Marshall (WV)","8","0","0","1.00000","302","13","289"
"1920","Marshall (WV)","0","8","0","0.00000","0","247","-247"
"1910","Charleston (WV)","0","2","1","0.16667","6","20","-14"
"1911","Charleston (WV)","4","3","0","0.57143","75","36","39"
"1912","Charleston (WV)","2","2","0","0.50000","55","105","-50"
"1913","Charleston (WV)","2","2","2","0.50000","38","34","4"
"1921","Marshall (WV)","6","2","1","0.72222","86","41","45"
"1922","Marshall (WV)","4","4","0","0.50000","155","94","61"
"1923","Marshall (WV)","2","7","0","0.22222","99","283","-184"
"1924","Marshall (WV)","4","3","1","0.56250","48","110","-62"
"1925","Marshall (WV)","4","1","4","0.66667","138","29","109"
"1926","Marshall (WV)","5","4","1","0.55000","150","99","51"
"1927","Marshall (WV)","5","3","1","0.61111","194","75","119"
"1928","Marshall (WV)","8","1","1","0.85000","175","33","142"
"1934","West Virginia","6","4","0","0.60000","117","113","4"
"1935","West Virginia","3","4","2","0.44444","129","96","33"
"1936","West Virginia","6","4","0","0.60000","151","122","29"
"1921","Oklahoma St.","5","4","1","0.55000","135","125","10"
"1922","Oklahoma St.","5","4","1","0.55000","130","86","44"
"1923","Oklahoma St.","2","9","0","0.18182","40","97","-57"
"1924","Oklahoma St.","6","1","2","0.77778","117","50","67"
"1925","Oklahoma St.","2","5","1","0.31250","41","115","-74"
"1926","Oklahoma St.","3","4","1","0.43750","79","114","-35"
"1927","Oklahoma St.","4","4","0","0.50000","110","138","-28"
"1928","Oklahoma St.","1","7","0","0.12500","25","200","-175"
"1929","Marshall (WV)","5","3","1","0.61111","184","79","105"
"1930","Marshall (WV)","3","5","1","0.38889","111","130","-19"
"1922","Arkansas St.","0","8","0","0.00000","0","466","-466"
"1923","Arkansas St.","0","6","1","0.07143","0","164","-164"
"1931","Marshall (WV)","6","3","0","0.66667","214","84","130"
"1932","Marshall (WV)","6","2","1","0.72222","161","58","103"
"1933","Marshall (WV)","3","5","1","0.38889","109","103","6"
"1934","Marshall (WV)","3","6","0","0.33333","93","111","-18"
"1923","Davis & Elkins (WV)","8","0","0","1.00000","294","22","272"
"1924","Davis & Elkins (WV)","7","2","1","0.75000","223","52","171"
"1925","Davis & Elkins (WV)","7","3","0","0.70000","244","32","212"
"1926","Davis & Elkins (WV)","4","4","0","0.50000","185","70","115"
"1927","Davis & Elkins (WV)","5","5","0","0.50000","116","142","-26"
"1928","Davis & Elkins (WV)","7","2","1","0.75000","261","41","220"
"1929","Davis & Elkins (WV)","10","1","1","0.87500","251","64","187"
"1930","Davis & Elkins (WV)","6","4","1","0.59091","214","97","117"
"1931","Davis & Elkins (WV)","10","1","0","0.90909","344","20","324"
"1932","Davis & Elkins (WV)","6","5","0","0.54545","132","120","12"
"1933","Davis & Elkins (WV)","9","1","1","0.86364","392","69","323"
"1934","Davis & Elkins (WV)","4","5","1","0.45000","160","77","83"
"1935","Marshall (WV)","4","6","0","0.40000","139","117","22"
"1936","Marshall (WV)","6","3","1","0.65000","304","78","226"
"1937","Marshall (WV)","9","0","1","0.95000","297","19","278"
"1938","Marshall (WV)","5","4","0","0.55556","274","67","207"
"1939","Marshall (WV)","9","2","0","0.81818","277","91","186"
"1940","Marshall (WV)","8","2","0","0.80000","334","75","259"
"1941","Marshall (WV)","7","1","0","0.87500","237","47","190"
"1942","Marshall (WV)","1","7","1","0.16667","52","118","-66"
"1946","Marshall (WV)","2","7","1","0.25000","145","190","-45"
"1947","Marshall (WV)","9","3","0","0.75000","342","125","217"
"1948","Marshall (WV)","2","7","1","0.25000","71","243","-172"
"1949","Marshall (WV)","6","4","0","0.60000","168","147","21"
"1950","Marshall (WV)","2","8","0","0.20000","107","249","-142"
"1951","Marshall (WV)","5","5","1","0.50000","218","194","24"
"1952","Marshall (WV)","2","7","2","0.27273","192","233","-41"
"1949","West Virginia Tech","8","0","1","0.94444","243","84","159"
"1950","West Virginia Tech","6","3","1","0.65000","222","172","50"
"1953","Marshall (WV)","2","5","2","0.33333","109","180","-71"
"1954","Marshall (WV)","4","5","0","0.44444","203","214","-11"
"1955","Marshall (WV)","3","6","0","0.33333","159","192","-33"
"1956","Marshall (WV)","3","6","0","0.33333","122","185","-63"
"1957","Marshall (WV)","6","3","0","0.66667","120","112","8"
"1958","Marshall (WV)","3","6","0","0.33333","111","165","-54"
"1959","Marshall (WV)","1","8","0","0.11111","72","343","-271"
"1960","Marshall (WV)","2","7","1","0.25000","58","160","-102"
"1961","Marshall (WV)","2","7","1","0.25000","61","183","-122"
"1962","Marshall (WV)","4","6","0","0.40000","137","237","-100"
"1963","Marshall (WV)","5","4","1","0.55000","139","139","0"
"1964","Marshall (WV)","7","3","0","0.70000","120","93","27"
"1965","Marshall (WV)","5","5","0","0.50000","150","168","-18"
"1966","Marshall (WV)","2","8","0","0.20000","113","210","-97"
"1967","Marshall (WV)","0","10","0","0.00000","72","311","-239"
"1959","Florida St.","4","6","0","0.40000","149","132","17"
"1968","Marshall (WV)","0","9","1","0.05000","129","358","-229"
"1969","Marshall (WV)","3","7","0","0.30000","207","281","-74"
"1970","Marshall (WV)","3","6","0","0.33333","138","202","-64"
"1971","Marshall (WV)","2","8","0","0.20000","57","299","-242"
"1972","Marshall (WV)","2","8","0","0.20000","93","254","-161"
"1973","Marshall (WV)","4","7","0","0.36364","212","288","-76"
"1974","Marshall (WV)","1","10","0","0.09091","111","291","-180"
"1975","Marshall (WV)","2","9","0","0.18182","148","296","-148"
"1976","Marshall (WV)","5","6","0","0.45455","151","243","-92"
"1977","Marshall (WV)","2","9","0","0.18182","234","389","-155"
"1978","Marshall (WV)","1","10","0","0.09091","113","292","-179"
"1996","Georgia Southern","4","7","0","0.36364","255","295","-40"
"1971","East Carolina (NC)","4","6","0","0.40000","181","300","-119"
"1972","East Carolina (NC)","9","2","0","0.81818","269","176","93"
"1973","East Carolina (NC)","9","2","0","0.81818","352","151","201"
"1974","Virginia","4","7","0","0.36364","207","239","-32"
"1975","Virginia","1","10","0","0.09091","175","428","-253"
"1979","Marshall (WV)","1","10","0","0.09091","95","309","-214"
"1980","Marshall (WV)","2","8","1","0.22727","137","245","-108"
"1981","Marshall (WV)","2","9","0","0.18182","104","284","-180"
"1982","Marshall (WV)","3","8","0","0.27273","117","279","-162"
"1983","Marshall (WV)","4","7","0","0.36364","209","214","-5"
"1978","Wabash (IN)","8","1","0","0.88889","171","59","112"
"1979","Wabash (IN)","8","1","0","0.88889","288","76","212"
"1980","Wabash (IN)","8","0","1","0.94444","293","57","236"
"1981","Wabash (IN)","8","1","0","0.88889","272","73","199"
"1982","Wabash (IN)","10","0","0","1.00000","293","117","176"
"1984","Marshall (WV)","6","5","0","0.54545","238","226","12"
"1985","Marshall (WV)","7","3","1","0.68182","193","197","-4"
"1986","Kansas St.","2","9","0","0.18182","134","343","-209"
"1987","Kansas St.","0","10","1","0.04545","135","421","-286"
"1988","Kansas St.","0","11","0","0.00000","171","448","-277"
"2008","Ball St. (IN)","0","1","0","0.00000","13","45","-32"
"2009","Ball St. (IN)","2","10","0","0.16667","230","338","-108"
"2010","Ball St. (IN)","4","8","0","0.33333","264","365","-101"
"2013","Eastern Michigan","1","2","0","0.33333","52","132","-80"
"1982","Indiana (PA)","4","6","0","0.40000","147","175","-28"
"1983","Indiana (PA)","5","5","0","0.50000","267","194","73"
"1984","Indiana (PA)","7","3","0","0.70000","302","163","139"
"1985","Indiana (PA)","8","2","1","0.77273","328","168","160"
"1986","Marshall (WV)","6","4","1","0.59091","287","199","88"
"1987","Marshall (WV)","10","5","0","0.66667","498","307","191"
"1988","Marshall (WV)","11","2","0","0.84615","370","234","136"
"1989","Marshall (WV)","6","5","0","0.54545","298","254","44"
"1990","Navy (MD)","5","6","0","0.45455","209","294","-85"
"1991","Navy (MD)","1","10","0","0.09091","160","321","-161"
"1992","Navy (MD)","1","10","0","0.09091","131","338","-207"
"1993","Navy (MD)","4","7","0","0.36364","203","307","-104"
"1994","Navy (MD)","3","8","0","0.27273","188","399","-211"
"1990","Marshall (WV)","6","5","0","0.54545","310","162","148"
"1991","Marshall (WV)","11","4","0","0.73333","506","257","249"
"1992","Marshall (WV)","12","3","0","0.80000","604","292","312"
"1993","Marshall (WV)","11","4","0","0.73333","414","206","208"
"1994","Marshall (WV)","12","2","0","0.85714","560","212","348"
"1995","Marshall (WV)","12","3","0","0.80000","492","240","252"
"1996","Georgia","5","6","0","0.45455","230","257","-27"
"1997","Georgia","10","2","0","0.83333","380","195","185"
"1998","Georgia","9","3","0","0.75000","292","222","70"
"1999","Georgia","8","4","0","0.66667","336","310","26"
"2000","Georgia","8","4","0","0.66667","331","212","119"
"1996","Marshall (WV)","15","0","0","1.00000","658","210","448"
"1997","Marshall (WV)","10","3","0","0.76923","484","259","225"
"1998","Marshall (WV)","12","1","0","0.92308","405","236","169"
"1999","Marshall (WV)","13","0","0","1.00000","463","137","326"
"2000","Marshall (WV)","8","5","0","0.61538","367","297","70"
"2001","Marshall (WV)","11","2","0","0.84615","512","369","143"
"2002","Marshall (WV)","11","2","0","0.84615","457","315","142"
"2003","Marshall (WV)","8","4","0","0.66667","350","278","72"
"2004","Marshall (WV)","6","6","0","0.50000","291","266","25"
"2005","Marshall (WV)","4","7","0","0.36364","204","285","-81"
"2006","Marshall (WV)","5","7","0","0.41667","311","351","-40"
"2007","Marshall (WV)","3","9","0","0.25000","298","411","-113"
"2008","Marshall (WV)","4","8","0","0.33333","246","332","-86"
"2009","Marshall (WV)","6","6","0","0.50000","262","299","-37"
"1994","Cincinnati (OH)","2","8","1","0.22727","159","301","-142"
"1995","Cincinnati (OH)","6","5","0","0.54545","252","197","55"
"1996","Cincinnati (OH)","6","5","0","0.54545","228","212","16"
"1997","Cincinnati (OH)","8","4","0","0.66667","321","252","69"
"1998","Cincinnati (OH)","2","9","0","0.18182","259","456","-197"
"1999","Cincinnati (OH)","3","8","0","0.27273","275","289","-14"
"2000","Cincinnati (OH)","7","5","0","0.58333","289","285","4"
"2001","Cincinnati (OH)","7","5","0","0.58333","336","290","46"
"2002","Cincinnati (OH)","7","7","0","0.50000","409","329","80"
"2003","Cincinnati (OH)","5","7","0","0.41667","303","319","-16"
"2009","Marshall (WV)","1","0","0","1.00000","21","17","4"
"2010","Marshall (WV)","5","7","0","0.41667","250","345","-95"
"2011","Marshall (WV)","7","6","0","0.53846","284","372","-88"
"2012","Marshall (WV)","5","7","0","0.41667","491","517","-26"
"2013","Marshall (WV)","10","4","0","0.71429","590","321","269"
"1892","Maryland","0","3","0","0.00000","0","128","-128"
"1900","Arizona","3","1","0","0.75000","131","6","125"
"1901","Arizona","4","1","0","0.80000","115","19","96"
"1893","Maryland","6","0","0","1.00000","104","16","88"
"1894","Maryland","4","3","0","0.57143","106","76","30"
"1896","Maryland","8","1","2","0.81818","132","34","98"
"1897","Maryland","2","4","0","0.33333","44","68","-24"
"1898","Maryland","2","6","1","0.27778","80","153","-73"
"1899","Maryland","1","4","0","0.20000","26","157","-131"
"1900","Maryland","3","4","1","0.43750","68","67","1"
"1901","Maryland","1","7","0","0.12500","49","129","-80"
"1902","Maryland","3","5","2","0.40000","28","90","-62"
"1903","Maryland","7","4","0","0.63636","104","64","40"
"1904","Maryland","2","4","2","0.37500","33","62","-29"
"1905","Maryland","6","4","0","0.60000","131","66","65"
"1906","Maryland","5","3","0","0.62500","98","73","25"
"1907","George Washington (DC)","2","5","1","0.31250","33","104","-71"
"1908","George Washington (DC)","9","1","1","0.86364","327","28","299"
"1910","Georgetown (DC)","7","1","1","0.83333","181","26","155"
"1911","Georgetown (DC)","7","1","1","0.83333","257","31","226"
"1907","Maryland","3","5","0","0.37500","45","61","-16"
"1908","Maryland","3","8","0","0.27273","27","204","-177"
"1909","Maryland","2","5","0","0.28571","19","101","-82"
"1910","Maryland","4","3","1","0.56250","73","42","31"
"1911","Maryland","2","4","2","0.37500","25","70","-45"
"1911","Maryland","2","0","0","1.00000","12","2","10"
"1912","Maryland","6","1","1","0.81250","191","60","131"
"1913","Maryland","6","3","0","0.66667","184","139","45"
"1914","Maryland","5","3","0","0.62500","72","49","23"
"1915","Maryland","6","3","0","0.66667","161","69","92"
"1916","Maryland","6","2","0","0.75000","142","52","90"
"1917","Maryland","4","3","1","0.56250","89","159","-70"
"1918","Maryland","4","1","1","0.75000","57","35","22"
"1919","Maryland","5","4","0","0.55556","93","74","19"
"1920","Maryland","7","2","0","0.77778","149","55","94"
"1921","Maryland","3","5","1","0.38889","45","127","-82"
"1922","Maryland","4","5","1","0.45000","77","137","-60"
"1923","Maryland","7","2","1","0.75000","214","56","158"
"1924","Maryland","3","3","3","0.50000","74","78","-4"
"1925","Maryland","2","5","1","0.31250","53","82","-29"
"1926","Maryland","5","4","1","0.55000","161","93","68"
"1927","Maryland","4","7","0","0.36364","186","144","42"
"1928","Maryland","6","3","1","0.65000","132","70","62"
"1929","Maryland","4","4","2","0.50000","148","133","15"
"1930","Maryland","7","5","0","0.58333","231","142","89"
"1931","Maryland","8","1","1","0.85000","194","98","96"
"1932","Maryland","5","6","0","0.45455","148","158","-10"
"1933","Maryland","3","7","0","0.30000","107","149","-42"
"1934","Maryland","7","3","0","0.70000","143","49","94"
"1935","Maryland","7","2","2","0.72727","127","78","49"
"1940","Maryland","2","6","1","0.27778","39","171","-132"
"1941","Maryland","3","5","1","0.38889","49","196","-147"
"1910","Clemson (SC)","4","3","1","0.56250","106","54","52"
"1911","Clemson (SC)","3","5","0","0.37500","70","109","-39"
"1912","Clemson (SC)","4","4","0","0.50000","177","126","51"
"1913","Richmond (VA)","5","3","1","0.61111","102","138","-36"
"1914","Richmond (VA)","5","4","0","0.55556","114","152","-38"
"1915","Richmond (VA)","4","4","1","0.50000","109","122","-13"
"1916","Richmond (VA)","5","4","2","0.54545","130","91","39"
"1917","Richmond (VA)","4","2","1","0.64286","161","55","106"
"1918","South Carolina","2","1","1","0.62500","33","51","-18"
"1919","Richmond (VA)","5","2","2","0.66667","94","35","59"
"1920","Richmond (VA)","6","2","0","0.75000","160","49","111"
"1921","Richmond (VA)","4","3","1","0.56250","140","76","64"
"1922","Richmond (VA)","6","2","1","0.72222","160","64","96"
"1923","Richmond (VA)","3","5","0","0.37500","39","149","-110"
"1924","Richmond (VA)","2","6","1","0.27778","40","123","-83"
"1925","Richmond (VA)","3","6","0","0.33333","41","81","-40"
"1926","Richmond (VA)","2","7","0","0.22222","54","100","-46"
"1927","Richmond (VA)","4","4","1","0.50000","50","168","-118"
"1928","Richmond (VA)","3","4","2","0.44444","146","76","70"
"1929","Richmond (VA)","3","5","1","0.38889","63","142","-79"
"1930","Richmond (VA)","2","4","2","0.37500","45","57","-12"
"1931","Richmond (VA)","4","5","0","0.44444","48","99","-51"
"1932","Richmond (VA)","4","2","2","0.62500","44","49","-5"
"1933","Richmond (VA)","5","4","0","0.55556","100","55","45"
"1936","Maryland","6","5","0","0.54545","117","59","58"
"1937","Maryland","8","2","0","0.80000","127","65","62"
"1938","Maryland","2","7","0","0.22222","86","235","-149"
"1939","Maryland","2","7","0","0.22222","64","106","-42"
"1915","Tulane (LA)","4","4","0","0.50000","118","78","40"
"1916","Tulane (LA)","4","3","1","0.56250","126","149","-23"
"1917","Tulane (LA)","5","3","0","0.62500","159","105","54"
"1918","Tulane (LA)","4","1","1","0.75000","133","16","117"
"1919","Tulane (LA)","6","2","1","0.72222","224","55","169"
"1920","Tulane (LA)","6","2","1","0.72222","181","28","153"
"1922","Tulane (LA)","4","4","0","0.50000","136","100","36"
"1923","Tulane (LA)","6","3","1","0.65000","117","89","28"
"1924","Tulane (LA)","8","1","0","0.88889","201","59","142"
"1925","Tulane (LA)","9","0","1","0.95000","246","23","223"
"1926","Tulane (LA)","3","5","1","0.38889","71","60","11"
"1927","Loyola (LA)","6","2","2","0.70000","130","41","89"
"1928","Loyola (LA)","7","3","0","0.70000","220","85","135"
"1929","Loyola (LA)","4","5","2","0.45455","150","129","21"
"1930","Loyola (LA)","9","1","0","0.90000","217","52","165"
"1931","Loyola (LA)","5","4","0","0.55556","154","91","63"
"1932","Loyola (LA)","6","4","1","0.59091","134","77","57"
"1933","Chicago (IL)","3","3","2","0.50000","118","56","62"
"1934","Chicago (IL)","4","4","0","0.50000","113","106","7"
"1935","Chicago (IL)","4","4","0","0.50000","102","110","-8"
"1936","Chicago (IL)","2","5","1","0.31250","68","166","-98"
"1937","Chicago (IL)","1","6","0","0.14286","45","143","-98"
"1938","Chicago (IL)","1","6","1","0.18750","75","241","-166"
"1939","Chicago (IL)","2","6","0","0.25000","37","308","-271"
"1940","Stanford (CA)","10","0","0","1.00000","196","85","111"
"1941","Stanford (CA)","6","3","0","0.66667","160","95","65"
"1942","Maryland","7","2","0","0.77778","198","124","74"
"1943","Pittsburgh (PA)","3","5","0","0.37500","114","180","-66"
"1944","Pittsburgh (PA)","4","5","0","0.44444","147","293","-146"
"1945","Pittsburgh (PA)","3","7","0","0.30000","87","141","-54"
"1946","Maryland","3","6","0","0.33333","136","193","-57"
"1965","Hawaii","1","8","1","0.15000","85","227","-142"
"1917","Dartmouth (NH)","5","3","0","0.62500","83","68","15"
"1918","Dartmouth (NH)","3","3","0","0.50000","78","83","-5"
"1919","Dartmouth (NH)","6","1","1","0.81250","141","53","88"
"1920","Dartmouth (NH)","7","2","0","0.77778","199","68","131"
"1921","West Virginia","5","4","1","0.55000","161","82","79"
"1922","West Virginia","10","0","1","0.95455","267","34","233"
"1923","West Virginia","7","1","1","0.83333","297","41","256"
"1924","West Virginia","8","1","0","0.88889","282","47","235"
"1925","Minnesota","5","2","1","0.68750","176","91","85"
"1926","Minnesota","5","3","0","0.62500","269","57","212"
"1927","Minnesota","6","0","2","0.87500","209","51","158"
"1928","Minnesota","6","2","0","0.75000","182","36","146"
"1929","Minnesota","6","2","0","0.75000","179","55","124"
"1930","Oregon","7","2","0","0.77778","131","35","96"
"1931","Oregon","6","2","2","0.70000","90","87","3"
"1932","Wisconsin","6","1","1","0.81250","151","48","103"
"1933","Wisconsin","2","5","1","0.31250","54","79","-25"
"1934","Wisconsin","4","4","0","0.50000","48","84","-36"
"1935","Wisconsin","1","7","0","0.12500","53","171","-118"
"1936","Toledo (OH)","2","6","0","0.25000","94","58","36"
"1937","Toledo (OH)","6","3","0","0.66667","128","96","32"
"1938","Toledo (OH)","6","3","1","0.65000","156","83","73"
"1939","Toledo (OH)","7","3","0","0.70000","180","59","121"
"1940","Toledo (OH)","6","3","0","0.66667","146","78","68"
"1941","Toledo (OH)","7","4","0","0.63636","195","122","73"
"1942","Toledo (OH)","4","4","1","0.50000","91","114","-23"
"1943","Maryland","4","5","0","0.44444","105","194","-89"
"1944","Maryland","1","7","1","0.16667","46","170","-124"
"1945","Maryland","6","2","1","0.72222","219","105","114"
"1946","Kentucky","7","3","0","0.70000","233","97","136"
"1947","Kentucky","8","3","0","0.72727","175","73","102"
"1948","Kentucky","5","3","2","0.60000","199","128","71"
"1949","Kentucky","9","3","0","0.75000","317","74","243"
"1950","Kentucky","11","1","0","0.91667","393","69","324"
"1951","Kentucky","8","4","0","0.66667","314","121","193"
"1952","Kentucky","5","4","2","0.54545","161","173","-12"
"1953","Kentucky","7","2","1","0.75000","201","116","85"
"1954","Texas A&M","1","9","0","0.10000","97","177","-80"
"1955","Texas A&M","7","2","1","0.75000","160","89","71"
"1956","Texas A&M","9","0","1","0.95000","223","81","142"
"1957","Texas A&M","8","3","0","0.72727","158","50","108"
"1958","Alabama","5","4","1","0.55000","106","75","31"
"1959","Alabama","7","2","2","0.72727","95","59","36"
"1960","Alabama","8","1","2","0.81818","183","56","127"
"1961","Alabama","11","0","0","1.00000","297","25","272"
"1962","Alabama","10","1","0","0.90909","289","39","250"
"1963","Alabama","9","2","0","0.81818","227","95","132"
"1964","Alabama","10","1","0","0.90909","250","88","162"
"1965","Alabama","9","1","1","0.86364","256","107","149"
"1966","Alabama","11","0","0","1.00000","301","44","257"
"1967","Alabama","8","2","1","0.77273","204","131","73"
"1968","Alabama","8","3","0","0.72727","184","139","45"
"1969","Alabama","6","5","0","0.54545","314","268","46"
"1970","Alabama","6","5","1","0.54167","334","264","70"
"1971","Alabama","11","1","0","0.91667","368","122","246"
"1972","Alabama","10","2","0","0.83333","406","150","256"
"1973","Alabama","11","1","0","0.91667","477","113","364"
"1974","Alabama","11","1","0","0.91667","329","96","233"
"1975","Alabama","11","1","0","0.91667","374","72","302"
"1976","Alabama","9","3","0","0.75000","327","140","187"
"1977","Alabama","11","1","0","0.91667","380","139","241"
"1978","Alabama","11","1","0","0.91667","345","168","177"
"1979","Alabama","12","0","0","1.00000","383","67","316"
"1980","Alabama","10","2","0","0.83333","352","98","254"
"1981","Alabama","9","2","1","0.79167","296","151","145"
"1982","Alabama","8","4","0","0.66667","338","216","122"
"1942","North Carolina","5","2","2","0.66667","149","102","47"
"1946","Oklahoma","8","3","0","0.72727","309","120","189"
"1947","Maryland","7","2","2","0.72727","207","121","86"
"1948","Maryland","6","4","0","0.60000","207","132","75"
"1949","Maryland","9","1","0","0.90000","266","82","184"
"1950","Maryland","7","2","1","0.75000","274","120","154"
"1951","Maryland","10","0","0","1.00000","381","75","306"
"1952","Maryland","7","2","0","0.77778","218","85","133"
"1953","Maryland","10","1","0","0.90909","298","38","260"
"1954","Maryland","7","2","1","0.75000","280","67","213"
"1955","Maryland","10","1","0","0.90909","217","77","140"
"1956","North Carolina","0","9","1","0.05000","99","183","-84"
"1957","North Carolina","6","4","0","0.60000","142","129","13"
"1958","North Carolina","6","4","0","0.60000","195","109","86"
"1956","Maryland","3","6","1","0.35000","68","168","-100"
"1957","Maryland","5","5","0","0.50000","119","144","-25"
"1958","Maryland","4","6","0","0.40000","132","175","-43"
"1959","DePauw (IN)","1","7","1","0.16667","77","160","-83"
"1960","DePauw (IN)","3","5","1","0.38889","98","115","-17"
"1961","DePauw (IN)","5","4","0","0.55556","127","99","28"
"1962","DePauw (IN)","5","4","0","0.55556","108","103","5"
"1963","DePauw (IN)","5","4","0","0.55556","146","78","68"
"1964","DePauw (IN)","2","7","0","0.22222","117","173","-56"
"1965","DePauw (IN)","2","6","1","0.27778","159","190","-31"
"1966","DePauw (IN)","3","6","0","0.33333","127","142","-15"
"1967","DePauw (IN)","6","2","1","0.72222","143","99","44"
"1968","DePauw (IN)","6","3","0","0.66667","149","122","27"
"1969","DePauw (IN)","2","7","0","0.22222","132","233","-101"
"1970","DePauw (IN)","4","5","0","0.44444","94","123","-29"
"1971","DePauw (IN)","1","8","0","0.11111","91","207","-116"
"1972","DePauw (IN)","2","7","0","0.22222","76","163","-87"
"1973","DePauw (IN)","6","3","0","0.66667","168","149","19"
"1974","DePauw (IN)","7","3","0","0.70000","159","138","21"
"1975","DePauw (IN)","5","5","0","0.50000","194","211","-17"
"1976","DePauw (IN)","2","8","0","0.20000","144","198","-54"
"1949","Virginia Military Institute","3","5","1","0.38889","157","207","-50"
"1950","Virginia Military Institute","6","4","0","0.60000","189","166","23"
"1951","Virginia Military Institute","7","3","0","0.70000","227","161","66"
"1952","Virginia Military Institute","3","6","1","0.35000","165","279","-114"
"1953","Florida St.","5","5","0","0.50000","183","146","37"
"1954","Florida St.","8","4","0","0.66667","277","190","87"
"1955","Florida St.","5","5","0","0.50000","147","186","-39"
"1956","Florida St.","5","4","1","0.55000","178","116","62"
"1957","Florida St.","4","6","0","0.40000","136","165","-29"
"1958","Florida St.","7","4","0","0.63636","218","124","94"
"1959","Maryland","5","5","0","0.50000","184","188","-4"
"1960","Maryland","6","4","0","0.60000","171","164","7"
"1961","Maryland","7","3","0","0.70000","156","141","15"
"1962","Maryland","6","4","0","0.60000","170","128","42"
"1963","Maryland","3","7","0","0.30000","148","201","-53"
"1964","Maryland","5","5","0","0.50000","164","126","38"
"1965","Maryland","4","6","0","0.40000","132","164","-32"
"1955","Northwestern (IL)","0","8","1","0.05556","66","241","-175"
"1957","Western Illinois","5","4","0","0.55556","154","150","4"
"1958","Western Illinois","6","1","1","0.81250","222","109","113"
"1959","Western Illinois","9","0","0","1.00000","303","104","199"
"1966","Maryland","4","6","0","0.40000","180","204","-24"
"1977","Miami (FL)","3","8","0","0.27273","125","245","-120"
"1978","Miami (FL)","6","5","0","0.54545","194","193","1"
"1979","Army (NY)","2","8","1","0.22727","96","308","-212"
"1983","Central Florida","5","6","0","0.45455","283","306","-23"
"1984","Central Florida","1","6","0","0.14286","154","270","-116"
"2001","Chowan (NC)","3","7","0","0.30000","241","281","-40"
"2002","Chowan (NC)","0","10","0","0.00000","69","274","-205"
"1967","Maryland","0","9","0","0.00000","46","231","-185"
"1968","Maryland","2","8","0","0.20000","171","299","-128"
"1969","Maryland","3","7","0","0.30000","100","249","-149"
"1970","Maryland","2","9","0","0.18182","112","241","-129"
"1971","Maryland","2","9","0","0.18182","224","283","-59"
"1961","Virginia Tech","4","5","0","0.44444","93","112","-19"
"1962","Virginia Tech","5","5","0","0.50000","137","137","0"
"1963","Virginia Tech","8","2","0","0.80000","216","126","90"
"1964","Virginia Tech","6","4","0","0.60000","224","178","46"
"1965","Virginia Tech","7","3","0","0.70000","188","134","54"
"1966","Virginia Tech","8","2","1","0.77273","245","104","141"
"1967","Virginia Tech","7","3","0","0.70000","183","112","71"
"1968","Virginia Tech","7","4","0","0.63636","240","165","75"
"1969","Virginia Tech","4","5","1","0.45000","234","110","124"
"1970","Virginia Tech","5","6","0","0.45455","199","228","-29"
"1972","Maryland","5","5","1","0.50000","243","217","26"
"1973","Maryland","8","4","0","0.66667","335","141","194"
"1974","Maryland","8","4","0","0.66667","316","104","212"
"1975","Maryland","9","2","1","0.79167","312","150","162"
"1976","Maryland","11","1","0","0.91667","294","115","179"
"1977","Maryland","8","4","0","0.66667","254","179","75"
"1978","Maryland","9","3","0","0.75000","261","167","94"
"1979","Maryland","7","4","0","0.63636","198","135","63"
"1980","Maryland","8","4","0","0.66667","211","165","46"
"1981","Maryland","4","6","1","0.40909","232","194","38"
"1982","Kentucky","0","10","1","0.04545","96","287","-191"
"1983","Kentucky","6","5","1","0.54167","228","237","-9"
"1984","Kentucky","9","3","0","0.75000","293","221","72"
"1985","Kentucky","5","6","0","0.45455","194","211","-17"
"1986","Kentucky","5","5","1","0.50000","228","207","21"
"1987","Kentucky","5","6","0","0.45455","258","187","71"
"1988","Kentucky","5","6","0","0.45455","217","208","9"
"1989","Kentucky","6","5","0","0.54545","212","220","-8"
"1973","Citadel (SC)","3","8","0","0.27273","137","250","-113"
"1974","Citadel (SC)","4","7","0","0.36364","216","248","-32"
"1975","Citadel (SC)","6","5","0","0.54545","144","97","47"
"1976","Citadel (SC)","6","5","0","0.54545","171","176","-5"
"1977","Citadel (SC)","5","6","0","0.45455","133","162","-29"
"1982","Maryland","8","4","0","0.66667","373","220","153"
"1983","Maryland","8","4","0","0.66667","316","253","63"
"1984","Maryland","9","3","0","0.75000","380","280","100"
"1985","Maryland","9","3","0","0.75000","326","192","134"
"1986","Maryland","5","5","1","0.50000","262","211","51"
"1987","Georgia Tech","2","9","0","0.18182","199","275","-76"
"1988","Georgia Tech","3","8","0","0.27273","200","194","6"
"1989","Georgia Tech","7","4","0","0.63636","265","213","52"
"1990","Georgia Tech","11","0","1","0.95833","379","186","193"
"1991","Georgia Tech","8","5","0","0.61538","283","214","69"
"2004","Army (NY)","2","9","0","0.18182","260","388","-128"
"2005","Army (NY)","4","7","0","0.36364","220","294","-74"
"2006","Army (NY)","3","9","0","0.25000","232","335","-103"
"1987","Maryland","4","7","0","0.36364","194","301","-107"
"1988","Maryland","5","6","0","0.45455","260","304","-44"
"1989","Maryland","3","7","1","0.31818","215","238","-23"
"1990","Maryland","6","5","1","0.54167","237","284","-47"
"1991","Maryland","2","9","0","0.18182","138","302","-164"
"1986","Holy Cross (MA)","10","1","0","0.90909","314","148","166"
"1987","Holy Cross (MA)","11","0","0","1.00000","511","110","401"
"1988","Holy Cross (MA)","9","2","0","0.81818","334","182","152"
"1989","Holy Cross (MA)","10","1","0","0.90909","396","161","235"
"1990","Holy Cross (MA)","9","1","1","0.86364","339","106","233"
"1991","Holy Cross (MA)","11","0","0","1.00000","372","174","198"
"1992","Maryland","3","8","0","0.27273","292","365","-73"
"1993","Maryland","2","9","0","0.18182","243","479","-236"
"1994","Maryland","4","7","0","0.36364","270","326","-56"
"1995","Maryland","6","5","0","0.54545","210","251","-41"
"1996","Maryland","5","6","0","0.45455","187","239","-52"
"1997","Maryland","2","9","0","0.18182","161","355","-194"
"1998","Maryland","3","8","0","0.27273","202","290","-88"
"1999","Maryland","5","6","0","0.45455","292","260","32"
"2000","Maryland","5","6","0","0.45455","247","284","-37"
"2001","Maryland","10","2","0","0.83333","413","266","147"
"2002","Maryland","11","3","0","0.78571","451","228","223"
"2003","Maryland","10","3","0","0.76923","406","206","200"
"2004","Maryland","5","6","0","0.45455","195","220","-25"
"2005","Maryland","5","6","0","0.45455","270","275","-5"
"2006","Maryland","9","4","0","0.69231","284","284","0"
"2007","Maryland","6","7","0","0.46154","313","280","33"
"2008","Maryland","8","5","0","0.61538","283","292","-9"
"2009","Maryland","2","10","0","0.16667","256","375","-119"
"2010","Maryland","9","4","0","0.69231","419","288","131"
"1999","Connecticut","4","7","0","0.36364","255","383","-128"
"2000","Connecticut","3","8","0","0.27273","220","368","-148"
"2001","Connecticut","2","9","0","0.18182","192","370","-178"
"2002","Connecticut","6","6","0","0.50000","373","270","103"
"2003","Connecticut","9","3","0","0.75000","408","300","108"
"2004","Connecticut","8","4","0","0.66667","363","260","103"
"2005","Connecticut","5","6","0","0.45455","272","211","61"
"2006","Connecticut","4","8","0","0.33333","257","324","-67"
"2007","Connecticut","9","4","0","0.69231","344","247","97"
"2008","Connecticut","8","5","0","0.61538","324","257","67"
"2009","Connecticut","8","5","0","0.61538","405","307","98"
"2010","Connecticut","8","5","0","0.61538","343","286","57"
"2011","Maryland","2","10","0","0.16667","277","411","-134"
"2012","Maryland","4","8","0","0.33333","241","326","-85"
"2013","Maryland","7","6","0","0.53846","340","329","11"
"1869","Rutgers (NJ)","2","2","0","0.50000","18","18","0"
"1870","Rutgers (NJ)","2","2","0","0.50000","17","17","0"
"1872","Columbia (NY)","5","4","0","0.55556","22","16","6"
"1873","Rutgers (NJ)","7","4","1","0.62500","31","26","5"
"1874","Harvard (MA)","9","7","0","0.56250","54","41","13"
"1875","Harvard (MA)","12","6","2","0.65000","52","29","23"
"1876","Harvard (MA)","13","8","1","0.61364","45","29","16"
"1877","Harvard (MA)","9","7","3","0.55263","31","21","10"
"1878","Pennsylvania","14","9","5","0.58929","42","24","18"
"1879","Harvard (MA)","13","9","12","0.55882","46","27","19"
"1880","Harvard (MA)","18","11","4","0.60606","75","53","22"
"1881","Rutgers (NJ)","22","18","8","0.54167","70","47","23"
"1882","Rutgers (NJ)","41","28","2","0.59155","176","111","65"
"1883","Rutgers (NJ)","38","32","1","0.54225","1288","965","323"
"1884","Pennsylvania","47","29","5","0.61111","1728","1184","544"
"1885","Michigan","34","17","4","0.65455","1437","612","825"
"1886","Lehigh (PA)","48","21","4","0.68493","1850","637","1213"
"1887","California","67","35","3","0.65238","2660","935","1725"
"1888","Princeton (NJ)","70","56","6","0.55303","2468","1899","569"
"1889","Brown (RI)","82","51","11","0.60764","2879","1796","1083"
"1890","Brown (RI)","77","76","9","0.50309","3002","2455","547"
"1891","Southern California","94","76","13","0.54918","2813","2189","624"
"1892","Minnesota","93","80","9","0.53571","2972","2394","578"
"1893","Duke (NC)","79","94","9","0.45879","2176","2912","-736"
"1894","Colorado St.","50","62","4","0.44828","1161","1518","-357"
"1895","Boston (MA)","31","44","11","0.42442","692","1031","-339"
"1896","Rhode Island","54","62","12","0.46875","1126","1201","-75"
"1897","Boston (MA)","32","40","6","0.44872","792","785","7"
"1898","Miami (OH)","47","23","4","0.66216","921","644","277"
"1899","New Hampshire","33","32","6","0.50704","571","522","49"
"1900","New Hampshire","22","35","11","0.40441","442","686","-244"
"1901","Marshall (WV)","18","34","3","0.35455","302","917","-615"
"1902","Saint John's (MN)","9","22","4","0.31429","148","460","-312"
"1903","Wichita St. (KS)","14","25","2","0.36585","376","546","-170"
"1904","Oklahoma St.","11","14","1","0.44231","194","394","-200"
"1905","Miami (OH)","7","25","5","0.25676","245","494","-249"
"1906","Rensselaer Tech (NY)","3","7","4","0.35714","92","107","-15"
"1907","Marshall (WV)","5","10","2","0.35294","71","238","-167"
"1908","Fort Hays St. (KS)","5","6","1","0.45833","56","91","-35"
"1909","Fort Hays St. (KS)","1","3","1","0.30000","12","68","-56"
"1910","Texas St.","0","1","0","0.00000","0","19","-19"
"1912","Fort Hays St. (KS)","1","2","0","0.33333","20","132","-112"
"1913","Eureka (IL)","1","6","0","0.14286","39","203","-164"
"1914","Eureka (IL)","3","4","0","0.42857","57","201","-144"
"1915","Texas St.","1","1","1","0.50000","13","20","-7"
"1916","Texas St.","0","2","1","0.16667","0","106","-106"
"1917","Boston (MA)","4","4","0","0.50000","73","136","-63"
"1918","Monmouth (IL)","1","7","0","0.12500","26","137","-111"
"1930","Troy (AL)","1","2","0","0.33333","7","73","-66"
"2013","Grambling St. (LA)","0","1","0","0.00000","0","0","0"
"1898","Massachusetts","1","4","1","0.25000","40","46","-6"
"1899","Massachusetts","7","3","0","0.70000","136","66","70"
"1900","Massachusetts","5","5","0","0.50000","107","80","27"
"1901","Massachusetts","9","1","0","0.90000","90","29","61"
"1902","Massachusetts","2","3","2","0.42857","40","27","13"
"1903","Massachusetts","5","4","0","0.55556","103","46","57"
"1904","Delaware Valley (PA)","3","0","1","0.87500","57","6","51"
"1905","Delaware Valley (PA)","1","2","0","0.33333","11","16","-5"
"1904","Massachusetts","5","2","1","0.68750","97","50","47"
"1907","Massachusetts","5","3","1","0.61111","78","31","47"
"1908","Massachusetts","3","3","3","0.50000","43","143","-100"
"1909","Morehouse (GA)","5","1","0","0.83333","127","17","110"
"1910","Morehouse (GA)","4","1","0","0.80000","97","15","82"
"1911","Morehouse (GA)","4","1","0","0.80000","76","6","70"
"1924","Alabama A&M","0","2","0","0.00000","0","42","-42"
"1925","Alabama A&M","0","1","0","0.00000","0","7","-7"
"1926","Alabama A&M","0","1","0","0.00000","0","14","-14"
"1905","Massachusetts","3","7","0","0.30000","47","125","-78"
"1906","Massachusetts","1","7","1","0.16667","33","119","-86"
"1908","William & Mary (VA)","4","6","1","0.40909","49","110","-61"
"1909","William & Mary (VA)","6","4","0","0.60000","65","81","-16"
"1909","Massachusetts","1","6","2","0.22222","27","110","-83"
"1909","New Hampshire","3","4","0","0.42857","39","67","-28"
"1910","Massachusetts","1","6","2","0.22222","28","126","-98"
"1907","Amherst (MA)","3","4","1","0.43750","49","73","-24"
"1909","Amherst (MA)","1","6","1","0.18750","11","87","-76"
"1911","Massachusetts","2","7","0","0.22222","29","112","-83"
"1909","North Carolina","5","2","0","0.71429","54","18","36"
"1910","North Carolina","3","6","0","0.33333","70","67","3"
"1912","Massachusetts","2","5","2","0.33333","76","126","-50"
"1913","Massachusetts","4","3","0","0.57143","96","41","55"
"1914","Massachusetts","2","5","0","0.28571","36","84","-48"
"1915","Massachusetts","4","2","2","0.62500","113","54","59"
"1916","Massachusetts","2","4","2","0.37500","25","180","-155"
"1919","Massachusetts","5","2","1","0.68750","114","54","60"
"1920","Massachusetts","5","2","1","0.68750","126","64","62"
"1921","Massachusetts","3","4","1","0.43750","78","90","-12"
"1922","Massachusetts","5","3","0","0.62500","77","82","-5"
"1923","Massachusetts","2","5","0","0.28571","61","65","-4"
"1924","Massachusetts","6","1","1","0.81250","185","61","124"
"1925","Massachusetts","6","2","0","0.75000","165","75","90"
"1926","Massachusetts","1","6","0","0.14286","33","110","-77"
"1927","Massachusetts","0","7","1","0.06250","13","135","-122"
"1928","Massachusetts","2","5","1","0.31250","25","90","-65"
"1929","Massachusetts","3","4","1","0.43750","56","82","-26"
"1930","Massachusetts","1","8","0","0.11111","32","248","-216"
"1931","Massachusetts","7","1","1","0.83333","250","58","192"
"1932","Massachusetts","7","2","0","0.77778","194","64","130"
"1933","Massachusetts","5","3","0","0.62500","108","65","43"
"1934","Massachusetts","5","3","1","0.61111","119","40","79"
"1935","Massachusetts","5","4","0","0.55556","117","105","12"
"1936","Massachusetts","2","6","0","0.25000","92","94","-2"
"1937","Massachusetts","1","7","1","0.16667","44","135","-91"
"1938","Massachusetts","3","6","0","0.33333","62","125","-63"
"1939","Massachusetts","2","5","2","0.33333","67","103","-36"
"1940","Massachusetts","1","8","0","0.11111","33","142","-109"
"1941","Massachusetts","3","4","1","0.43750","93","120","-27"
"1942","Massachusetts","2","5","0","0.28571","43","125","-82"
"1946","Massachusetts","6","2","0","0.75000","184","48","136"
"1945","Massachusetts","2","1","1","0.62500","33","32","1"
"1947","Massachusetts","3","4","1","0.43750","118","81","37"
"1948","Massachusetts","3","4","1","0.43750","124","123","1"
"1949","Massachusetts","3","5","0","0.37500","150","122","28"
"1950","Massachusetts","3","5","0","0.37500","167","153","14"
"1951","Massachusetts","3","4","1","0.43750","114","110","4"
"1952","Massachusetts","4","3","1","0.56250","189","137","52"
"1953","Massachusetts","1","7","0","0.12500","101","239","-138"
"1954","Massachusetts","4","4","0","0.50000","127","210","-83"
"1955","Massachusetts","4","4","0","0.50000","172","183","-11"
"1956","Massachusetts","2","5","1","0.31250","90","223","-133"
"1957","Massachusetts","1","5","1","0.21429","60","198","-138"
"1958","Massachusetts","2","6","0","0.25000","117","177","-60"
"1959","Massachusetts","3","5","1","0.38889","111","182","-71"
"1960","Massachusetts","7","2","0","0.77778","173","121","52"
"1961","Cincinnati (OH)","3","7","0","0.30000","97","142","-45"
"1962","Cincinnati (OH)","2","8","0","0.20000","142","202","-60"
"1963","Cincinnati (OH)","6","4","0","0.60000","238","138","100"
"1964","Cincinnati (OH)","8","2","0","0.80000","211","99","112"
"1965","Cincinnati (OH)","5","5","0","0.50000","163","172","-9"
"1966","Cincinnati (OH)","3","7","0","0.30000","141","201","-60"
"1961","Massachusetts","5","4","0","0.55556","146","147","-1"
"1962","Massachusetts","6","3","0","0.66667","165","116","49"
"1963","Massachusetts","8","0","1","0.94444","265","12","253"
"1964","Massachusetts","8","2","0","0.80000","222","76","146"
"1965","Massachusetts","7","2","0","0.77778","253","59","194"
"1966","Massachusetts","6","3","0","0.66667","117","104","13"
"1967","Massachusetts","7","2","0","0.77778","192","120","72"
"1968","Massachusetts","2","8","0","0.20000","155","200","-45"
"1969","Massachusetts","6","3","0","0.66667","265","130","135"
"1970","Massachusetts","4","5","1","0.45000","190","145","45"
"1971","Massachusetts","4","4","1","0.50000","147","209","-62"
"1972","Massachusetts","9","2","0","0.81818","369","155","214"
"1973","Massachusetts","6","5","0","0.54545","231","244","-13"
"1974","Massachusetts","5","6","0","0.45455","219","232","-13"
"1975","Massachusetts","8","2","0","0.80000","210","102","108"
"1976","Massachusetts","5","5","0","0.50000","146","178","-32"
"1977","Massachusetts","8","3","0","0.72727","274","145","129"
"1981","Syracuse (NY)","4","6","1","0.40909","248","265","-17"
"1982","Syracuse (NY)","2","9","0","0.18182","159","244","-85"
"1983","Syracuse (NY)","6","5","0","0.54545","178","200","-22"
"1984","Syracuse (NY)","6","5","0","0.54545","151","151","0"
"1985","Syracuse (NY)","7","5","0","0.58333","284","195","89"
"1986","Syracuse (NY)","5","6","0","0.45455","241","266","-25"
"1987","Syracuse (NY)","11","0","1","0.95833","379","169","210"
"1988","Syracuse (NY)","10","2","0","0.83333","341","189","152"
"1989","Syracuse (NY)","8","4","0","0.66667","286","242","44"
"1990","Syracuse (NY)","7","4","2","0.61538","341","213","128"
"1978","Massachusetts","9","4","0","0.69231","343","173","170"
"1979","Massachusetts","6","4","0","0.60000","207","154","53"
"1980","Massachusetts","7","3","0","0.70000","212","105","107"
"1981","Massachusetts","6","3","0","0.66667","173","184","-11"
"1982","Massachusetts","5","6","0","0.45455","220","227","-7"
"1983","Massachusetts","3","8","0","0.27273","141","229","-88"
"1984","Massachusetts","3","8","0","0.27273","148","219","-71"
"1985","Massachusetts","7","4","0","0.63636","198","127","71"
"1986","Texas-El Paso","4","8","0","0.33333","309","391","-82"
"1987","Texas-El Paso","7","4","0","0.63636","309","234","75"
"1988","Texas-El Paso","10","3","0","0.76923","445","275","170"
"1989","Missouri","2","9","0","0.18182","171","363","-192"
"1990","Missouri","4","7","0","0.36364","278","360","-82"
"1991","Missouri","3","7","1","0.31818","223","403","-180"
"1992","Missouri","3","8","0","0.27273","214","269","-55"
"1993","Missouri","3","7","1","0.31818","192","344","-152"
"1986","Massachusetts","8","3","0","0.72727","251","258","-7"
"1987","Massachusetts","3","8","0","0.27273","257","298","-41"
"1988","Massachusetts","8","4","0","0.66667","343","291","52"
"1989","Massachusetts","5","5","1","0.50000","298","296","2"
"1990","Massachusetts","8","2","1","0.77273","224","175","49"
"1991","Massachusetts","4","7","0","0.36364","205","208","-3"
"1995","Richmond (VA)","7","3","1","0.68182","187","186","1"
"1996","Richmond (VA)","2","9","0","0.18182","157","197","-40"
"1997","Richmond (VA)","6","5","0","0.54545","237","183","54"
"1998","Richmond (VA)","9","3","0","0.75000","321","175","146"
"1999","Richmond (VA)","5","6","0","0.45455","279","295","-16"
"2000","Richmond (VA)","10","3","0","0.76923","255","217","38"
"2001","Richmond (VA)","3","8","0","0.27273","201","189","12"
"2002","Richmond (VA)","4","7","0","0.36364","199","202","-3"
"2003","Richmond (VA)","2","9","0","0.18182","189","370","-181"
"2006","Virginia Military Institute","1","10","0","0.09091","199","433","-234"
"2007","Virginia Military Institute","2","9","0","0.18182","267","461","-194"
"1992","Massachusetts","7","3","0","0.70000","180","151","29"
"1993","Massachusetts","9","2","0","0.81818","284","221","63"
"1994","Massachusetts","5","6","0","0.45455","208","221","-13"
"1995","Massachusetts","6","5","0","0.54545","261","227","34"
"1996","Massachusetts","6","5","0","0.54545","257","294","-37"
"1997","Massachusetts","2","9","0","0.18182","149","367","-218"
"1988","New Haven (CT)","7","3","0","0.70000","275","214","61"
"1989","New Haven (CT)","8","2","0","0.80000","285","171","114"
"1990","New Haven (CT)","7","3","0","0.70000","381","311","70"
"1991","New Haven (CT)","3","7","0","0.30000","320","378","-58"
"1992","New Haven (CT)","12","1","0","0.92308","613","289","324"
"1993","New Haven (CT)","11","1","0","0.91667","630","233","397"
"1994","Brown (RI)","7","3","0","0.70000","229","197","32"
"1995","Brown (RI)","5","5","0","0.50000","282","239","43"
"1996","Brown (RI)","5","5","0","0.50000","238","246","-8"
"1997","Brown (RI)","7","3","0","0.70000","274","194","80"
"1998","Massachusetts","12","3","0","0.80000","524","423","101"
"1999","Massachusetts","9","4","0","0.69231","415","244","171"
"2000","Massachusetts","7","4","0","0.63636","312","246","66"
"2001","Massachusetts","3","8","0","0.27273","178","342","-164"
"2002","Massachusetts","8","4","0","0.66667","327","250","77"
"2003","Massachusetts","10","3","0","0.76923","368","295","73"
"2000","Northeastern (MA)","4","7","0","0.36364","279","305","-26"
"2001","Northeastern (MA)","5","6","0","0.45455","225","224","1"
"2002","Northeastern (MA)","10","3","0","0.76923","403","208","195"
"2003","Northeastern (MA)","8","4","0","0.66667","414","219","195"
"2004","Massachusetts","6","5","0","0.54545","279","256","23"
"2005","Massachusetts","7","4","0","0.63636","259","146","113"
"2006","Massachusetts","13","2","0","0.86667","413","200","213"
"2007","Massachusetts","10","3","0","0.76923","403","249","154"
"2008","Massachusetts","7","5","0","0.58333","345","321","24"
"1993","Worcester Tech (MA)","5","4","0","0.55556","204","227","-23"
"1994","Worcester Tech (MA)","5","4","0","0.55556","239","191","48"
"1995","Worcester Tech (MA)","4","5","0","0.44444","120","172","-52"
"1996","Worcester Tech (MA)","2","8","0","0.20000","118","287","-169"
"1997","Worcester Tech (MA)","4","6","0","0.40000","190","257","-67"
"1998","Worcester Tech (MA)","4","5","0","0.44444","198","229","-31"
"2009","Massachusetts","5","6","0","0.45455","295","244","51"
"2010","Massachusetts","6","5","0","0.54545","292","277","15"
"2011","Massachusetts","5","6","0","0.45455","277","307","-30"
"2012","Massachusetts","1","11","0","0.08333","152","482","-330"
"2013","Massachusetts","1","11","0","0.08333","140","396","-256"
"1910","Eastern Kentucky","1","4","0","0.20000","21","63","-42"
"1911","Eastern Kentucky","1","3","1","0.30000","26","23","3"
"1912","Memphis (TN)","1","2","1","0.37500","13","15","-2"
"1913","Memphis (TN)","1","3","0","0.25000","26","107","-81"
"1914","Memphis (TN)","3","5","0","0.37500","65","102","-37"
"1915","Memphis (TN)","4","3","0","0.57143","186","138","48"
"1916","Memphis (TN)","2","3","1","0.41667","152","90","62"
"1917","Memphis (TN)","3","2","0","0.60000","47","68","-21"
"1919","Memphis (TN)","3","4","0","0.42857","91","66","25"
"1918","Memphis (TN)","2","4","0","0.33333","68","96","-28"
"1920","Memphis (TN)","0","7","0","0.00000","36","183","-147"
"1921","Memphis (TN)","4","5","1","0.45000","86","205","-119"
"1922","Memphis (TN)","5","2","3","0.65000","174","26","148"
"1923","Memphis (TN)","6","3","0","0.66667","77","55","22"
"1924","Central Michigan","7","1","0","0.87500","158","19","139"
"1925","Central Michigan","4","1","3","0.68750","93","20","73"
"1924","Memphis (TN)","1","7","1","0.16667","40","239","-199"
"1925","Memphis (TN)","0","7","1","0.06250","37","251","-214"
"1926","Memphis (TN)","1","9","0","0.10000","39","200","-161"
"1927","Memphis (TN)","5","3","1","0.61111","156","116","40"
"1928","Memphis (TN)","5","3","2","0.60000","157","120","37"
"1929","Memphis (TN)","8","0","2","0.90000","146","27","119"
"1930","Memphis (TN)","6","3","1","0.65000","161","92","69"
"1931","Memphis (TN)","2","5","2","0.33333","33","102","-69"
"1932","Memphis (TN)","4","5","0","0.44444","61","54","7"
"1933","Memphis (TN)","7","1","1","0.83333","147","44","103"
"1934","Memphis (TN)","3","3","2","0.50000","75","63","12"
"1935","Memphis (TN)","1","6","1","0.18750","30","209","-179"
"1936","Memphis (TN)","0","9","0","0.00000","14","282","-268"
"1937","Memphis (TN)","3","6","0","0.33333","117","99","18"
"1938","Memphis (TN)","10","0","0","1.00000","281","41","240"
"1939","Mississippi St.","8","2","0","0.80000","216","32","184"
"1940","Mississippi St.","10","0","1","0.95455","245","58","187"
"1941","Mississippi St.","8","1","1","0.85000","191","55","136"
"1942","Mississippi St.","8","2","0","0.80000","200","77","123"
"1944","Mississippi St.","6","2","0","0.75000","219","79","140"
"1945","Mississippi St.","6","3","0","0.66667","221","108","113"
"1946","Mississippi St.","8","2","0","0.80000","271","71","200"
"1947","Mississippi St.","7","3","0","0.70000","169","89","80"
"1948","Mississippi St.","4","4","1","0.50000","103","87","16"
"1939","Memphis (TN)","3","8","0","0.27273","85","159","-74"
"1940","Memphis (TN)","5","5","0","0.50000","150","172","-22"
"1941","Memphis (TN)","6","3","0","0.66667","172","76","96"
"1942","Memphis (TN)","2","7","0","0.22222","87","255","-168"
"1948","Davidson (NC)","3","5","1","0.38889","85","127","-42"
"1949","Davidson (NC)","2","8","0","0.20000","109","303","-194"
"1947","Memphis (TN)","6","2","1","0.72222","238","60","178"
"1948","Memphis (TN)","6","5","0","0.54545","218","129","89"
"1949","Memphis (TN)","9","1","0","0.90000","385","73","312"
"1950","Memphis (TN)","9","2","0","0.81818","374","108","266"
"1951","Memphis (TN)","5","3","0","0.62500","206","93","113"
"1952","Memphis (TN)","2","7","0","0.22222","141","263","-122"
"1953","Memphis (TN)","6","4","0","0.60000","135","140","-5"
"1954","Memphis (TN)","3","4","3","0.45000","166","209","-43"
"1955","Memphis (TN)","2","7","0","0.22222","94","218","-124"
"1956","Memphis (TN)","5","4","1","0.55000","209","152","57"
"1957","Memphis (TN)","6","4","0","0.60000","195","111","84"
"1958","Memphis (TN)","4","5","0","0.44444","142","144","-2"
"1959","Memphis (TN)","6","4","0","0.60000","142","132","10"
"1960","Memphis (TN)","8","2","0","0.80000","303","85","218"
"1961","Memphis (TN)","8","2","0","0.80000","332","75","257"
"1962","Memphis (TN)","8","1","0","0.88889","261","67","194"
"1963","Memphis (TN)","9","0","1","0.95000","199","52","147"
"1964","Memphis (TN)","5","4","0","0.55556","173","103","70"
"1965","Memphis (TN)","5","5","0","0.50000","215","153","62"
"1966","Memphis (TN)","7","2","0","0.77778","121","96","25"
"1967","Memphis (TN)","6","3","0","0.66667","206","150","56"
"1968","Memphis (TN)","6","4","0","0.60000","258","170","88"
"1969","Memphis (TN)","8","2","0","0.80000","328","191","137"
"1970","Memphis (TN)","6","4","0","0.60000","227","184","43"
"1971","Memphis (TN)","5","6","0","0.45455","255","202","53"
"1972","Memphis (TN)","5","5","1","0.50000","265","254","11"
"1973","Memphis (TN)","8","3","0","0.72727","264","167","97"
"1974","Memphis (TN)","7","4","0","0.63636","225","148","77"
"1975","Vanderbilt (TN)","7","4","0","0.63636","119","200","-81"
"1976","Vanderbilt (TN)","2","9","0","0.18182","131","282","-151"
"1977","Vanderbilt (TN)","2","9","0","0.18182","141","276","-135"
"1978","Vanderbilt (TN)","2","9","0","0.18182","164","418","-254"
"1975","Memphis (TN)","7","4","0","0.63636","180","168","12"
"1976","Memphis (TN)","8","3","0","0.72727","241","182","59"
"1977","Memphis (TN)","6","5","0","0.54545","228","194","34"
"1978","Memphis (TN)","4","7","0","0.36364","200","297","-97"
"1979","Memphis (TN)","5","6","0","0.45455","166","223","-57"
"1980","Memphis (TN)","2","9","0","0.18182","115","255","-140"
"1978","Texas Tech","7","4","0","0.63636","246","268","-22"
"1979","Texas Tech","3","6","2","0.36364","141","182","-41"
"1980","Texas Tech","5","6","0","0.45455","178","188","-10"
"1981","Memphis (TN)","1","10","0","0.09091","82","209","-127"
"1982","Memphis (TN)","1","10","0","0.09091","129","284","-155"
"1983","Memphis (TN)","6","4","1","0.59091","274","205","69"
"1973","Youngstown St. (OH)","4","6","0","0.40000","129","200","-71"
"1974","Youngstown St. (OH)","8","2","0","0.80000","258","118","140"
"1976","Southern Illinois","7","4","0","0.63636","234","223","11"
"1977","Southern Illinois","3","8","0","0.27273","96","232","-136"
"1978","Southern Illinois","7","4","0","0.63636","219","203","16"
"1979","Southern Illinois","8","3","0","0.72727","232","188","44"
"1980","Southern Illinois","3","8","0","0.27273","211","267","-56"
"1981","Southern Illinois","7","4","0","0.63636","234","175","59"
"1982","Southern Illinois","6","5","0","0.54545","202","209","-7"
"1983","Southern Illinois","13","1","0","0.92857","443","178","265"
"1984","Memphis (TN)","5","5","1","0.50000","201","178","23"
"1985","Memphis (TN)","2","7","2","0.27273","180","243","-63"
"1986","Memphis (TN)","1","10","0","0.09091","104","292","-188"
"1987","Memphis (TN)","5","5","1","0.50000","220","210","10"
"1988","Memphis (TN)","6","5","0","0.54545","226","205","21"
"1993","Texas-El Paso","0","5","0","0.00000","65","195","-130"
"1994","Texas-El Paso","3","7","1","0.31818","217","359","-142"
"1995","Texas-El Paso","2","10","0","0.16667","263","486","-223"
"1996","Texas-El Paso","2","9","0","0.18182","183","314","-131"
"1997","Texas-El Paso","4","7","0","0.36364","162","311","-149"
"1998","Texas-El Paso","3","8","0","0.27273","226","305","-79"
"1999","Texas-El Paso","5","7","0","0.41667","306","389","-83"
"1977","Toledo (OH)","2","9","0","0.18182","112","287","-175"
"1978","Toledo (OH)","2","9","0","0.18182","144","256","-112"
"1979","Toledo (OH)","8","2","1","0.77273","213","190","23"
"1980","Toledo (OH)","4","7","0","0.36364","187","190","-3"
"1981","Toledo (OH)","9","3","0","0.75000","270","170","100"
"1982","Utah","5","6","0","0.45455","247","188","59"
"1983","Utah","5","6","0","0.45455","296","289","7"
"1984","Utah","6","5","1","0.54167","347","253","94"
"1989","Memphis (TN)","2","9","0","0.18182","174","338","-164"
"1990","Memphis (TN)","4","6","1","0.40909","212","233","-21"
"1991","Memphis (TN)","5","6","0","0.45455","228","229","-1"
"1992","Memphis (TN)","6","5","0","0.54545","312","181","131"
"1993","Memphis (TN)","6","5","0","0.54545","268","215","53"
"1994","Memphis (TN)","6","5","0","0.54545","163","159","4"
"1991","James Madison (VA)","9","4","0","0.69231","414","343","71"
"1992","James Madison (VA)","4","7","0","0.36364","333","355","-22"
"1993","James Madison (VA)","6","5","0","0.54545","375","253","122"
"1994","James Madison (VA)","10","3","0","0.76923","388","224","164"
"1995","Memphis (TN)","3","8","0","0.27273","150","240","-90"
"1996","Memphis (TN)","4","7","0","0.36364","141","219","-78"
"1997","Memphis (TN)","4","7","0","0.36364","218","243","-25"
"1998","Memphis (TN)","2","9","0","0.18182","226","340","-114"
"1999","Memphis (TN)","5","6","0","0.45455","232","182","50"
"2000","Memphis (TN)","4","7","0","0.36364","176","199","-23"
"1993","Clemson (SC)","5","7","0","0.41667","264","389","-125"
"1994","Clemson (SC)","5","6","0","0.45455","164","188","-24"
"1995","Clemson (SC)","8","4","0","0.66667","303","219","84"
"1996","Clemson (SC)","7","5","0","0.58333","245","241","4"
"1997","Clemson (SC)","7","5","0","0.58333","292","219","73"
"1998","Clemson (SC)","3","8","0","0.27273","218","272","-54"
"2001","Memphis (TN)","5","6","0","0.45455","294","281","13"
"2002","Memphis (TN)","3","9","0","0.25000","303","327","-24"
"2003","Memphis (TN)","9","4","0","0.69231","393","250","143"
"2004","Memphis (TN)","8","4","0","0.66667","430","375","55"
"2005","Memphis (TN)","7","5","0","0.58333","326","276","50"
"2006","Memphis (TN)","2","10","0","0.16667","281","365","-84"
"2007","Memphis (TN)","7","6","0","0.53846","380","419","-39"
"2008","Memphis (TN)","6","7","0","0.46154","353","353","0"
"2009","Memphis (TN)","2","10","0","0.16667","262","418","-156"
"2010","Memphis (TN)","1","11","0","0.08333","173","478","-305"
"2011","Memphis (TN)","2","10","0","0.16667","195","421","-226"
"2012","Memphis (TN)","4","8","0","0.33333","293","363","-70"
"2013","Memphis (TN)","3","9","0","0.25000","234","295","-61"
"1923","Lawrence (WI)","4","3","1","0.56250","124","46","78"
"1927","Miami (FL)","3","6","1","0.35000","106","187","-81"
"1928","Miami (FL)","4","4","1","0.50000","163","75","88"
"1914","Southwestern (TX)","4","4","0","0.50000","55","174","-119"
"1915","Southwestern (TX)","4","3","0","0.57143","46","82","-36"
"1916","Southwestern (TX)","3","5","1","0.38889","82","133","-51"
"1917","Southern Methodist (TX)","3","2","3","0.56250","74","49","25"
"1918","Southern Methodist (TX)","4","3","0","0.57143","40","46","-6"
"1919","Southern Methodist (TX)","5","4","1","0.55000","162","86","76"
"1920","Southern Methodist (TX)","3","5","2","0.40000","125","90","35"
"1929","Miami (FL)","3","2","0","0.60000","45","26","19"
"1930","Miami (FL)","3","4","1","0.43750","26","102","-76"
"1931","Miami (FL)","4","8","0","0.33333","90","170","-80"
"1932","Miami (FL)","4","3","1","0.56250","57","39","18"
"1933","Miami (FL)","5","1","2","0.75000","197","46","151"
"1934","Miami (FL)","5","3","1","0.61111","150","92","58"
"1935","Miami (FL)","5","3","0","0.62500","91","52","39"
"1936","Miami (FL)","6","2","2","0.70000","129","39","90"
"1937","Iowa","1","7","0","0.12500","36","120","-84"
"1938","Iowa","1","6","1","0.18750","46","135","-89"
"1943","Miami (FL)","5","1","0","0.83333","124","52","72"
"1944","Miami (FL)","1","7","1","0.16667","73","274","-201"
"1937","Miami (FL)","4","4","1","0.50000","118","67","51"
"1938","Miami (FL)","8","2","0","0.80000","219","52","167"
"1939","Miami (FL)","5","5","0","0.50000","131","106","25"
"1940","Miami (FL)","3","7","0","0.30000","131","197","-66"
"1941","Miami (FL)","8","2","0","0.80000","162","54","108"
"1942","Miami (FL)","7","2","0","0.77778","195","60","135"
"1945","Miami (FL)","9","1","1","0.86364","211","99","112"
"1946","Miami (FL)","8","2","0","0.80000","200","147","53"
"1947","Miami (FL)","2","7","1","0.25000","80","140","-60"
"1926","Virginia Tech","5","3","1","0.61111","134","80","54"
"1927","Virginia Tech","5","4","0","0.55556","125","48","77"
"1928","Virginia Tech","7","2","0","0.77778","198","92","106"
"1929","Virginia Tech","5","4","0","0.55556","170","128","42"
"1948","Miami (FL)","4","6","0","0.40000","154","179","-25"
"1949","Miami (FL)","6","3","0","0.66667","165","96","69"
"1950","Miami (FL)","9","1","1","0.86364","251","97","154"
"1951","Miami (FL)","8","3","0","0.72727","196","126","70"
"1952","Miami (FL)","4","7","0","0.36364","181","192","-11"
"1953","Miami (FL)","4","5","0","0.44444","155","137","18"
"1954","Miami (FL)","8","1","0","0.88889","257","94","163"
"1955","Miami (FL)","6","3","0","0.66667","181","81","100"
"1956","Miami (FL)","8","1","1","0.85000","161","53","108"
"1957","Miami (FL)","5","4","1","0.55000","161","103","58"
"1958","Miami (FL)","2","8","0","0.20000","88","195","-107"
"1959","Miami (FL)","6","4","0","0.60000","140","140","0"
"1960","Miami (FL)","6","4","0","0.60000","163","143","20"
"1961","Miami (FL)","7","4","0","0.63636","146","85","61"
"1962","Miami (FL)","7","4","0","0.63636","189","217","-28"
"1963","Miami (FL)","3","7","0","0.30000","116","174","-58"
"1964","Miami (FL)","4","5","1","0.45000","147","133","14"
"1965","Miami (FL)","5","4","1","0.55000","199","138","61"
"1966","Miami (FL)","8","2","1","0.77273","210","103","107"
"1967","Miami (FL)","7","4","0","0.63636","257","140","117"
"1968","Miami (FL)","5","5","0","0.50000","161","131","30"
"1969","Miami (FL)","4","6","0","0.40000","201","216","-15"
"1970","Miami (FL)","1","1","0","0.50000","57","45","12"
"1970","Miami (FL)","2","7","0","0.22222","109","265","-156"
"1971","Miami (FL)","4","7","0","0.36364","174","221","-47"
"1972","Miami (FL)","5","6","0","0.45455","214","170","44"
"1973","Kentucky","5","6","0","0.45455","226","196","30"
"1974","Kentucky","6","5","0","0.54545","248","194","54"
"1975","Kentucky","2","8","1","0.22727","132","183","-51"
"1976","Kentucky","9","3","0","0.75000","209","151","58"
"1977","Kentucky","10","1","0","0.90909","252","111","141"
"1978","Kentucky","4","6","1","0.40909","193","189","4"
"1979","Kentucky","5","6","0","0.45455","180","143","37"
"1980","Kentucky","3","8","0","0.27273","167","280","-113"
"1981","Kentucky","3","8","0","0.27273","134","222","-88"
"1956","Nebraska","4","6","0","0.40000","125","206","-81"
"1957","California","1","9","0","0.10000","109","176","-67"
"1958","California","7","4","0","0.63636","207","200","7"
"1959","California","2","8","0","0.20000","115","223","-108"
"1960","Illinois","5","4","0","0.55556","140","117","23"
"1961","Illinois","0","9","0","0.00000","53","289","-236"
"1962","Illinois","2","7","0","0.22222","75","234","-159"
"1963","Illinois","8","1","1","0.85000","170","96","74"
"1964","Illinois","6","3","0","0.66667","142","100","42"
"1965","Illinois","6","4","0","0.60000","235","118","117"
"1966","Illinois","4","6","0","0.40000","173","193","-20"
"1973","Miami (FL)","5","6","0","0.45455","163","240","-77"
"1974","Miami (FL)","6","5","0","0.54545","167","190","-23"
"1975","Miami (FL)","2","8","0","0.20000","157","239","-82"
"1976","Miami (FL)","3","8","0","0.27273","207","213","-6"
"1955","Northwestern (IL)","0","8","1","0.05556","66","241","-175"
"1957","Western Illinois","5","4","0","0.55556","154","150","4"
"1958","Western Illinois","6","1","1","0.81250","222","109","113"
"1959","Western Illinois","9","0","0","1.00000","303","104","199"
"1966","Maryland","4","6","0","0.40000","180","204","-24"
"1977","Miami (FL)","3","8","0","0.27273","125","245","-120"
"1978","Miami (FL)","6","5","0","0.54545","194","193","1"
"1979","Army (NY)","2","8","1","0.22727","96","308","-212"
"1983","Central Florida","5","6","0","0.45455","283","306","-23"
"1984","Central Florida","1","6","0","0.14286","154","270","-116"
"2001","Chowan (NC)","3","7","0","0.30000","241","281","-40"
"2002","Chowan (NC)","0","10","0","0.00000","69","274","-205"
"1979","Miami (FL)","5","6","0","0.45455","191","236","-45"
"1980","Miami (FL)","9","3","0","0.75000","278","171","107"
"1981","Miami (FL)","9","2","0","0.81818","245","145","100"
"1982","Miami (FL)","7","4","0","0.63636","241","153","88"
"1983","Miami (FL)","11","1","0","0.91667","313","136","177"
"1985","Louisville (KY)","2","9","0","0.18182","199","429","-230"
"1986","Louisville (KY)","3","8","0","0.27273","179","303","-124"
"1987","Louisville (KY)","3","7","1","0.31818","215","348","-133"
"1988","Louisville (KY)","8","3","0","0.72727","261","245","16"
"1989","Louisville (KY)","6","5","0","0.54545","312","222","90"
"1990","Louisville (KY)","10","1","1","0.87500","345","149","196"
"1991","Louisville (KY)","2","9","0","0.18182","135","335","-200"
"1992","Louisville (KY)","5","6","0","0.45455","214","243","-29"
"1993","Louisville (KY)","9","3","0","0.75000","350","243","107"
"1994","Louisville (KY)","6","5","0","0.54545","255","253","2"
"1995","Oklahoma","5","5","1","0.50000","233","275","-42"
"2001","Florida Atlantic","4","6","0","0.40000","177","245","-68"
"2002","Florida Atlantic","2","9","0","0.18182","176","339","-163"
"2003","Florida Atlantic","11","3","0","0.78571","404","306","98"
"2004","Florida Atlantic","9","3","0","0.75000","299","207","92"
"2005","Florida Atlantic","2","9","0","0.18182","148","339","-191"
"2006","Florida Atlantic","5","7","0","0.41667","181","299","-118"
"2007","Florida Atlantic","8","5","0","0.61538","405","432","-27"
"2008","Florida Atlantic","7","6","0","0.53846","326","373","-47"
"2009","Florida Atlantic","5","7","0","0.41667","329","405","-76"
"2010","Florida Atlantic","4","8","0","0.33333","202","351","-149"
"2011","Florida Atlantic","1","11","0","0.08333","155","416","-261"
"1979","Oklahoma St.","7","4","0","0.63636","191","212","-21"
"1980","Oklahoma St.","3","7","1","0.31818","187","268","-81"
"1981","Oklahoma St.","7","5","0","0.58333","197","216","-19"
"1982","Oklahoma St.","4","5","2","0.45455","241","267","-26"
"1983","Oklahoma St.","8","4","0","0.66667","271","162","109"
"1984","Miami (FL)","8","5","0","0.61538","402","314","88"
"1985","Miami (FL)","10","2","0","0.83333","406","195","211"
"1986","Miami (FL)","11","1","0","0.91667","430","150","280"
"1987","Miami (FL)","12","0","0","1.00000","412","125","287"
"1988","Miami (FL)","11","1","0","0.91667","418","116","302"
"1982","Idaho","9","4","0","0.69231","397","299","98"
"1983","Idaho","8","3","0","0.72727","347","257","90"
"1984","Idaho","6","5","0","0.54545","363","283","80"
"1985","Idaho","9","3","0","0.75000","441","247","194"
"1986","Wyoming","6","6","0","0.50000","299","272","27"
"1987","Washington St.","3","7","1","0.31818","238","356","-118"
"1988","Washington St.","9","3","0","0.75000","415","303","112"
"1989","Miami (FL)","11","1","0","0.91667","426","127","299"
"1990","Miami (FL)","10","2","0","0.83333","447","184","263"
"1991","Miami (FL)","12","0","0","1.00000","386","100","286"
"1992","Miami (FL)","11","1","0","0.91667","369","161","208"
"1993","Miami (FL)","9","3","0","0.75000","331","167","164"
"1994","Miami (FL)","10","2","0","0.83333","365","143","222"
"1999","Oregon St.","7","5","0","0.58333","347","277","70"
"2000","Oregon St.","11","1","0","0.91667","400","212","188"
"2001","Oregon St.","5","6","0","0.45455","287","259","28"
"2002","Oregon St.","8","5","0","0.61538","414","267","147"
"2006","Idaho","4","8","0","0.33333","203","417","-214"
"2007","Arizona St.","10","3","0","0.76923","420","292","128"
"2008","Arizona St.","5","7","0","0.41667","274","272","2"
"2009","Arizona St.","4","8","0","0.33333","268","253","15"
"2010","Arizona St.","6","6","0","0.50000","387","300","87"
"2011","Arizona St.","6","7","0","0.46154","431","372","59"
"1995","Miami (FL)","8","3","0","0.72727","294","201","93"
"1996","Miami (FL)","9","3","0","0.75000","368","210","158"
"1997","Miami (FL)","5","6","0","0.45455","314","285","29"
"1998","Miami (FL)","9","3","0","0.75000","448","298","150"
"1999","Miami (FL)","9","4","0","0.69231","432","220","212"
"2000","Miami (FL)","11","1","0","0.91667","506","190","316"
"2007","North Carolina","4","8","0","0.33333","254","294","-40"
"2008","North Carolina","0","5","0","0.00000","360","275","85"
"2009","North Carolina","0","5","0","0.00000","309","222","87"
"2010","North Carolina","8","5","0","0.61538","329","302","27"
"2001","Miami (FL)","12","0","0","1.00000","512","117","395"
"2002","Miami (FL)","12","1","0","0.92308","527","248","279"
"2003","Miami (FL)","11","2","0","0.84615","361","196","165"
"2004","Miami (FL)","9","3","0","0.75000","380","204","176"
"2005","Miami (FL)","9","3","0","0.75000","325","171","154"
"2006","Miami (FL)","7","6","0","0.53846","255","201","54"
"2011","Texas-San Antonio","4","6","0","0.40000","266","214","52"
"2012","Texas-San Antonio","8","4","0","0.66667","374","345","29"
"2013","Texas-San Antonio","7","5","0","0.58333","307","316","-9"
"2007","Miami (FL)","5","7","0","0.41667","247","312","-65"
"2008","Miami (FL)","7","6","0","0.53846","352","314","38"
"2009","Miami (FL)","9","4","0","0.69231","394","288","106"
"2010","Miami (FL)","7","5","0","0.58333","325","236","89"
"2010","Miami (FL)","0","1","0","0.00000","17","33","-16"
"2006","Temple (PA)","1","11","0","0.08333","131","496","-365"
"2007","Temple (PA)","4","8","0","0.33333","197","315","-118"
"2008","Temple (PA)","5","7","0","0.41667","281","277","4"
"2009","Temple (PA)","9","4","0","0.69231","384","290","94"
"2010","Temple (PA)","8","4","0","0.66667","300","229","71"
"2011","Miami (FL)","6","6","0","0.50000","318","241","77"
"2012","Miami (FL)","7","5","0","0.58333","377","366","11"
"2013","Miami (FL)","9","4","0","0.69231","440","348","92"
"1895","Miami (OH)","3","1","0","0.75000","30","10","20"
"1896","Miami (OH)","4","2","0","0.66667","58","30","28"
"1897","Miami (OH)","2","4","1","0.35714","32","56","-24"
"1899","Nebraska","2","7","1","0.25000","49","164","-115"
"1900","Miami (OH)","0","4","0","0.00000","12","77","-65"
"1901","Miami (OH)","1","3","1","0.30000","23","29","-6"
"1902","Miami (OH)","5","3","1","0.61111","91","44","47"
"1903","Miami (OH)","1","4","0","0.20000","27","110","-83"
"1904","Miami (OH)","1","5","0","0.16667","12","283","-271"
"1869","Rutgers (NJ)","2","2","0","0.50000","18","18","0"
"1870","Rutgers (NJ)","2","2","0","0.50000","17","17","0"
"1872","Columbia (NY)","5","4","0","0.55556","22","16","6"
"1873","Rutgers (NJ)","7","4","1","0.62500","31","26","5"
"1874","Harvard (MA)","9","7","0","0.56250","54","41","13"
"1875","Harvard (MA)","12","6","2","0.65000","52","29","23"
"1876","Harvard (MA)","13","8","1","0.61364","45","29","16"
"1877","Harvard (MA)","9","7","3","0.55263","31","21","10"
"1878","Pennsylvania","14","9","5","0.58929","42","24","18"
"1879","Harvard (MA)","13","9","12","0.55882","46","27","19"
"1880","Harvard (MA)","18","11","4","0.60606","75","53","22"
"1881","Rutgers (NJ)","22","18","8","0.54167","70","47","23"
"1882","Rutgers (NJ)","41","28","2","0.59155","176","111","65"
"1883","Rutgers (NJ)","38","32","1","0.54225","1288","965","323"
"1884","Pennsylvania","47","29","5","0.61111","1728","1184","544"
"1885","Michigan","34","17","4","0.65455","1437","612","825"
"1886","Lehigh (PA)","48","21","4","0.68493","1850","637","1213"
"1887","California","67","35","3","0.65238","2660","935","1725"
"1888","Princeton (NJ)","70","56","6","0.55303","2468","1899","569"
"1889","Brown (RI)","82","51","11","0.60764","2879","1796","1083"
"1890","Brown (RI)","77","76","9","0.50309","3002","2455","547"
"1891","Southern California","94","76","13","0.54918","2813","2189","624"
"1892","Minnesota","93","80","9","0.53571","2972","2394","578"
"1893","Duke (NC)","79","94","9","0.45879","2176","2912","-736"
"1894","Colorado St.","50","62","4","0.44828","1161","1518","-357"
"1895","Boston (MA)","31","44","11","0.42442","692","1031","-339"
"1896","Rhode Island","54","62","12","0.46875","1126","1201","-75"
"1897","Boston (MA)","32","40","6","0.44872","792","785","7"
"1898","Miami (OH)","47","23","4","0.66216","921","644","277"
"1899","New Hampshire","33","32","6","0.50704","571","522","49"
"1900","New Hampshire","22","35","11","0.40441","442","686","-244"
"1901","Marshall (WV)","18","34","3","0.35455","302","917","-615"
"1902","Saint John's (MN)","9","22","4","0.31429","148","460","-312"
"1903","Wichita St. (KS)","14","25","2","0.36585","376","546","-170"
"1904","Oklahoma St.","11","14","1","0.44231","194","394","-200"
"1905","Miami (OH)","7","25","5","0.25676","245","494","-249"
"1906","Rensselaer Tech (NY)","3","7","4","0.35714","92","107","-15"
"1907","Marshall (WV)","5","10","2","0.35294","71","238","-167"
"1908","Fort Hays St. (KS)","5","6","1","0.45833","56","91","-35"
"1909","Fort Hays St. (KS)","1","3","1","0.30000","12","68","-56"
"1910","Texas St.","0","1","0","0.00000","0","19","-19"
"1912","Fort Hays St. (KS)","1","2","0","0.33333","20","132","-112"
"1913","Eureka (IL)","1","6","0","0.14286","39","203","-164"
"1914","Eureka (IL)","3","4","0","0.42857","57","201","-144"
"1915","Texas St.","1","1","1","0.50000","13","20","-7"
"1916","Texas St.","0","2","1","0.16667","0","106","-106"
"1917","Boston (MA)","4","4","0","0.50000","73","136","-63"
"1918","Monmouth (IL)","1","7","0","0.12500","26","137","-111"
"1930","Troy (AL)","1","2","0","0.33333","7","73","-66"
"2013","Grambling St. (LA)","0","1","0","0.00000","0","0","0"
"1906","Miami (OH)","1","5","1","0.21429","16","55","-39"
"1904","Cincinnati (OH)","7","1","0","0.87500","182","10","172"
"1905","Cincinnati (OH)","5","3","0","0.62500","92","91","1"
"1906","Nebraska","6","4","0","0.60000","164","73","91"
"1907","Miami (OH)","6","1","0","0.85714","120","37","83"
"1908","Miami (OH)","7","0","0","1.00000","113","10","103"
"1909","Miami (OH)","3","4","0","0.42857","96","83","13"
"1910","Miami (OH)","2","4","1","0.35714","26","44","-18"
"1899","Hamilton (NY)","8","2","1","0.77273","282","67","215"
"1900","Syracuse (NY)","7","2","1","0.75000","208","60","148"
"1901","Syracuse (NY)","7","1","0","0.87500","185","27","158"
"1902","Syracuse (NY)","6","2","1","0.72222","172","93","79"
"1903","Hamilton (NY)","6","3","0","0.66667","136","91","45"
"1904","Ohio St.","6","5","0","0.54545","219","123","96"
"1905","Ohio St.","8","2","2","0.75000","197","63","134"
"1908","Colgate (NY)","4","3","0","0.57143","78","25","53"
"1909","Kentucky","9","1","0","0.90000","261","29","232"
"1910","Kentucky","7","2","0","0.77778","140","29","111"
"1911","Miami (OH)","2","4","2","0.37500","57","45","12"
"1912","Kentucky","7","2","0","0.77778","250","41","209"
"1913","West Virginia","3","4","2","0.44444","109","137","-28"
"1914","Tulane (LA)","3","3","1","0.50000","145","147","-2"
"1909","Worcester Tech (MA)","3","4","1","0.43750","25","43","-18"
"1910","Samford (AL)","1","8","0","0.11111","10","304","-294"
"1911","Worcester Tech (MA)","1","7","0","0.12500","14","95","-81"
"1912","Miami (OH)","3","3","2","0.50000","88","106","-18"
"1913","Miami (OH)","6","2","0","0.75000","154","68","86"
"1914","Miami (OH)","5","3","0","0.62500","131","124","7"
"1915","Worcester Tech (MA)","3","5","1","0.38889","25","124","-99"
"1915","Miami (OH)","6","2","0","0.75000","137","87","50"
"1915","Hanover (IN)","2","4","0","0.33333","122","147","-25"
"1916","Hanover (IN)","1","5","0","0.16667","24","290","-266"
"1917","Miami (OH)","6","0","2","0.87500","202","0","202"
"1918","Miami (OH)","5","0","1","0.91667","195","13","182"
"1914","Cincinnati (OH)","6","3","0","0.66667","164","44","120"
"1915","Cincinnati (OH)","4","5","0","0.44444","110","158","-48"
"1916","Miami (OH)","7","0","1","0.93750","238","12","226"
"1919","Miami (OH)","7","1","0","0.87500","147","32","115"
"1920","Miami (OH)","5","2","1","0.68750","114","38","76"
"1921","Miami (OH)","8","0","0","1.00000","238","13","225"
"1924","Michigan","6","2","0","0.75000","155","54","101"
"1925","Wisconsin","6","1","1","0.81250","131","50","81"
"1926","Wisconsin","5","2","1","0.68750","122","72","50"
"1911","Morningside (IA)","6","3","0","0.66667","114","51","63"
"1912","South Dakota St.","2","3","1","0.41667","45","136","-91"
"1913","South Dakota St.","5","3","0","0.62500","147","82","65"
"1914","South Dakota St.","5","2","0","0.71429","93","60","33"
"1915","South Dakota St.","5","1","1","0.78571","163","7","156"
"1916","South Dakota St.","4","2","0","0.66667","94","76","18"
"1917","South Dakota St.","5","1","0","0.83333","137","87","50"
"1922","Miami (OH)","4","3","1","0.56250","61","45","16"
"1923","Miami (OH)","3","4","1","0.43750","82","81","1"
"1924","Miami (OH)","2","6","0","0.25000","62","147","-85"
"1925","Miami (OH)","5","3","0","0.62500","123","55","68"
"1926","Miami (OH)","5","2","1","0.68750","112","58","54"
"1927","Miami (OH)","8","1","0","0.88889","255","56","199"
"1928","Miami (OH)","6","2","0","0.75000","140","46","94"
"1929","Miami (OH)","7","2","0","0.77778","179","40","139"
"1930","Miami (OH)","4","4","1","0.50000","131","82","49"
"1931","Miami (OH)","4","5","0","0.44444","161","122","39"
"1932","Miami (OH)","7","1","0","0.87500","182","56","126"
"1933","Miami (OH)","7","2","0","0.77778","223","36","187"
"1934","Miami (OH)","5","4","0","0.55556","118","70","48"
"1935","Miami (OH)","5","3","1","0.61111","174","80","94"
"1936","Miami (OH)","7","1","1","0.83333","84","40","44"
"1937","Miami (OH)","4","4","1","0.50000","175","85","90"
"1938","Miami (OH)","6","3","0","0.66667","228","100","128"
"1939","Miami (OH)","1","7","1","0.16667","21","104","-83"
"1940","Miami (OH)","0","7","1","0.06250","32","200","-168"
"1941","Miami (OH)","2","7","0","0.22222","98","176","-78"
"1942","Miami (OH)","3","6","0","0.33333","154","195","-41"
"1943","Miami (OH)","7","2","1","0.75000","293","91","202"
"1947","Purdue (IN)","5","4","0","0.55556","205","130","75"
"1948","Purdue (IN)","3","6","0","0.33333","126","175","-49"
"1949","Purdue (IN)","4","5","0","0.44444","119","135","-16"
"1950","Purdue (IN)","2","7","0","0.22222","143","200","-57"
"1951","Purdue (IN)","5","4","0","0.55556","153","152","1"
"1952","Purdue (IN)","4","3","2","0.55556","188","151","37"
"1953","Purdue (IN)","2","7","0","0.22222","89","167","-78"
"1954","Purdue (IN)","5","3","1","0.61111","165","134","31"
"1955","Purdue (IN)","5","3","1","0.61111","113","103","10"
"1944","Miami (OH)","8","1","0","0.88889","185","74","111"
"1945","Miami (OH)","7","2","0","0.77778","207","75","132"
"1946","Miami (OH)","7","3","0","0.70000","220","72","148"
"1947","Miami (OH)","9","0","1","0.95000","240","97","143"
"1949","Cincinnati (OH)","7","4","0","0.63636","237","181","56"
"1950","Cincinnati (OH)","8","4","0","0.66667","258","169","89"
"1951","Cincinnati (OH)","10","1","0","0.90909","345","112","233"
"1952","Cincinnati (OH)","8","1","1","0.85000","275","72","203"
"1953","Cincinnati (OH)","9","1","0","0.90000","354","58","296"
"1954","Cincinnati (OH)","8","2","0","0.80000","249","107","142"
"1948","Miami (OH)","7","1","1","0.83333","249","90","159"
"1955","Cincinnati (OH)","1","6","2","0.22222","97","199","-102"
"1956","Cincinnati (OH)","4","5","0","0.44444","156","140","16"
"1957","Cincinnati (OH)","5","4","1","0.55000","130","101","29"
"1958","Cincinnati (OH)","6","2","2","0.70000","139","104","35"
"1959","Cincinnati (OH)","5","4","1","0.55000","193","148","45"
"1960","Cincinnati (OH)","4","6","0","0.40000","113","150","-37"
"1965","Virginia","4","6","0","0.40000","170","189","-19"
"1966","Virginia","4","6","0","0.40000","214","235","-21"
"1967","Virginia","5","5","0","0.50000","172","169","3"
"1968","Virginia","7","3","0","0.70000","328","222","106"
"1969","Virginia","3","7","0","0.30000","115","170","-55"
"1970","Virginia","5","6","0","0.45455","240","187","53"
"1949","Miami (OH)","5","4","0","0.55556","251","163","88"
"1950","Miami (OH)","9","1","0","0.90000","356","100","256"
"1951","Ohio St.","4","3","2","0.55556","109","104","5"
"1952","Ohio St.","6","3","0","0.66667","197","119","78"
"1953","Ohio St.","6","3","0","0.66667","182","164","18"
"1954","Ohio St.","10","0","0","1.00000","249","75","174"
"1955","Ohio St.","7","2","0","0.77778","201","97","104"
"1956","Ohio St.","6","3","0","0.66667","160","81","79"
"1957","Ohio St.","9","1","0","0.90000","267","92","175"
"1958","Ohio St.","6","1","2","0.77778","182","132","50"
"1959","Ohio St.","3","5","1","0.38889","83","114","-31"
"1960","Ohio St.","7","2","0","0.77778","209","90","119"
"1961","Ohio St.","8","0","1","0.94444","221","83","138"
"1962","Ohio St.","6","3","0","0.66667","205","98","107"
"1963","Ohio St.","5","3","1","0.61111","110","102","8"
"1964","Ohio St.","7","2","0","0.77778","146","76","70"
"1965","Ohio St.","7","2","0","0.77778","156","118","38"
"1966","Ohio St.","4","5","0","0.44444","108","123","-15"
"1967","Ohio St.","6","3","0","0.66667","145","120","25"
"1968","Ohio St.","10","0","0","1.00000","323","150","173"
"1969","Ohio St.","8","1","0","0.88889","383","93","290"
"1970","Ohio St.","9","1","0","0.90000","290","120","170"
"1971","Ohio St.","6","4","0","0.60000","224","120","104"
"1972","Ohio St.","9","2","0","0.81818","280","171","109"
"1973","Ohio St.","10","0","1","0.95455","413","64","349"
"1974","Ohio St.","10","2","0","0.83333","437","129","308"
"1975","Ohio St.","11","1","0","0.91667","384","102","282"
"1976","Ohio St.","9","2","1","0.79167","305","149","156"
"1977","Ohio St.","9","3","0","0.75000","343","120","223"
"1978","Ohio St.","7","4","1","0.62500","339","216","123"
"1951","Miami (OH)","7","3","0","0.70000","225","159","66"
"1952","Miami (OH)","8","1","0","0.88889","284","108","176"
"1953","Miami (OH)","7","1","1","0.83333","327","52","275"
"1954","Miami (OH)","8","1","0","0.88889","294","82","212"
"1955","Miami (OH)","9","0","0","1.00000","226","47","179"
"1956","Northwestern (IL)","4","4","1","0.50000","107","112","-5"
"1957","Northwestern (IL)","0","9","0","0.00000","57","271","-214"
"1958","Northwestern (IL)","5","4","0","0.55556","199","148","51"
"1959","Northwestern (IL)","6","3","0","0.66667","174","134","40"
"1960","Northwestern (IL)","5","4","0","0.55556","107","103","4"
"1961","Northwestern (IL)","4","5","0","0.44444","131","105","26"
"1962","Northwestern (IL)","7","2","0","0.77778","237","158","79"
"1963","Northwestern (IL)","5","4","0","0.55556","162","124","38"
"1964","Notre Dame (IN)","9","1","0","0.90000","287","77","210"
"1965","Notre Dame (IN)","7","2","1","0.75000","270","73","197"
"1966","Notre Dame (IN)","9","0","1","0.95000","362","38","324"
"1967","Notre Dame (IN)","8","2","0","0.80000","337","124","213"
"1968","Notre Dame (IN)","7","2","1","0.75000","376","170","206"
"1969","Notre Dame (IN)","8","2","1","0.77273","351","134","217"
"1970","Notre Dame (IN)","10","1","0","0.90909","354","108","246"
"1971","Notre Dame (IN)","8","2","0","0.80000","225","86","139"
"1972","Notre Dame (IN)","8","3","0","0.72727","289","192","97"
"1973","Notre Dame (IN)","11","0","0","1.00000","382","89","293"
"1974","Notre Dame (IN)","10","2","0","0.83333","318","147","171"
"1956","Miami (OH)","7","1","1","0.83333","159","83","76"
"1957","Miami (OH)","6","3","0","0.66667","163","137","26"
"1958","Miami (OH)","6","3","0","0.66667","193","96","97"
"1959","Miami (OH)","5","4","0","0.55556","158","94","64"
"1960","Miami (OH)","5","5","0","0.50000","139","159","-20"
"1961","Miami (OH)","6","4","0","0.60000","153","115","38"
"1962","Miami (OH)","8","2","1","0.77273","241","175","66"
"1963","Yale (CT)","6","3","0","0.66667","135","78","57"
"1964","Yale (CT)","6","2","1","0.72222","195","120","75"
"1965","Indiana","2","8","0","0.20000","134","225","-91"
"1966","Indiana","1","8","1","0.15000","104","229","-125"
"1967","Indiana","9","2","0","0.81818","197","159","38"
"1968","Indiana","6","4","0","0.60000","250","262","-12"
"1969","Indiana","4","6","0","0.40000","252","242","10"
"1970","Indiana","1","9","0","0.10000","102","300","-198"
"1971","Indiana","3","8","0","0.27273","152","260","-108"
"1972","Indiana","5","6","0","0.45455","204","272","-68"
"1973","Northwestern (IL)","4","7","0","0.36364","188","299","-111"
"1974","Northwestern (IL)","3","8","0","0.27273","140","385","-245"
"1975","Northwestern (IL)","3","8","0","0.27273","149","318","-169"
"1976","Northwestern (IL)","1","10","0","0.09091","134","311","-177"
"1977","Northwestern (IL)","1","10","0","0.09091","102","337","-235"
"1990","Mount Saint Joseph (OH)","1","9","0","0.10000","160","330","-170"
"1991","Mount Saint Joseph (OH)","4","6","0","0.40000","204","249","-45"
"1992","Mount Saint Joseph (OH)","4","5","0","0.44444","135","269","-134"
"1963","Miami (OH)","5","3","2","0.60000","208","178","30"
"1964","Miami (OH)","6","3","1","0.65000","209","142","67"
"1965","Miami (OH)","7","3","0","0.70000","247","137","110"
"1966","Miami (OH)","9","1","0","0.90000","229","76","153"
"1967","Miami (OH)","6","4","0","0.60000","181","114","67"
"1968","Miami (OH)","7","3","0","0.70000","240","99","141"
"1969","Michigan","8","3","0","0.72727","352","148","204"
"1970","Michigan","9","1","0","0.90000","288","90","198"
"1971","Michigan","11","1","0","0.91667","421","83","338"
"1972","Michigan","10","1","0","0.90909","264","57","207"
"1973","Michigan","10","0","1","0.95455","330","68","262"
"1974","Michigan","10","1","0","0.90909","324","75","249"
"1975","Michigan","8","2","2","0.75000","324","130","194"
"1976","Michigan","10","2","0","0.83333","432","95","337"
"1977","Michigan","10","2","0","0.83333","353","124","229"
"1978","Michigan","10","2","0","0.83333","372","105","267"
"1979","Michigan","8","4","0","0.66667","312","151","161"
"1980","Michigan","10","2","0","0.83333","322","129","193"
"1981","Michigan","9","3","0","0.75000","355","162","193"
"1982","Michigan","8","4","0","0.66667","345","204","141"
"1983","Michigan","9","3","0","0.75000","355","160","195"
"1984","Michigan","6","6","0","0.50000","214","200","14"
"1985","Michigan","10","1","1","0.87500","342","98","244"
"1986","Michigan","11","2","0","0.84615","379","203","176"
"1987","Michigan","8","4","0","0.66667","331","172","159"
"1988","Michigan","9","2","1","0.79167","361","167","194"
"1989","Michigan","10","2","0","0.83333","335","184","151"
"1969","Miami (OH)","7","3","0","0.70000","231","139","92"
"1970","Miami (OH)","7","3","0","0.70000","187","112","75"
"1971","Miami (OH)","7","3","0","0.70000","207","117","90"
"1972","Miami (OH)","7","3","0","0.70000","232","116","116"
"1973","Miami (OH)","11","0","0","1.00000","223","76","147"
"1974","Colorado","5","6","0","0.45455","226","307","-81"
"1975","Colorado","9","3","0","0.75000","331","251","80"
"1976","Colorado","8","4","0","0.66667","305","225","80"
"1977","Colorado","7","3","1","0.68182","266","174","92"
"1978","Colorado","6","5","0","0.54545","230","206","24"
"1980","Northern Illinois","7","4","0","0.63636","216","175","41"
"1981","Northern Illinois","3","8","0","0.27273","160","217","-57"
"1982","Northern Illinois","5","5","0","0.50000","137","136","1"
"1983","Northern Illinois","10","2","0","0.83333","314","203","111"
"1984","Indiana","0","11","0","0.00000","185","338","-153"
"1985","Indiana","4","7","0","0.36364","251","340","-89"
"1986","Indiana","6","6","0","0.50000","273","227","46"
"1987","Indiana","8","4","0","0.66667","283","238","45"
"1988","Indiana","8","3","1","0.70833","396","235","161"
"1989","Indiana","5","6","0","0.45455","289","262","27"
"1990","Indiana","6","5","1","0.54167","329","238","91"
"1991","Indiana","7","4","1","0.62500","305","224","81"
"1992","Indiana","5","6","0","0.45455","177","197","-20"
"1993","Indiana","8","4","0","0.66667","259","197","62"
"1994","Indiana","7","4","0","0.63636","294","285","9"
"1995","Indiana","2","9","0","0.18182","159","326","-167"
"1996","Indiana","3","8","0","0.27273","242","291","-49"
"1974","Miami (OH)","10","0","1","0.95455","303","86","217"
"1975","Miami (OH)","11","1","0","0.91667","306","141","165"
"1976","Miami (OH)","3","8","0","0.27273","160","208","-48"
"1977","Miami (OH)","10","1","0","0.90909","262","173","89"
"1978","North Carolina","5","6","0","0.45455","199","218","-19"
"1979","North Carolina","8","3","1","0.70833","290","167","123"
"1980","North Carolina","11","1","0","0.91667","297","130","167"
"1981","North Carolina","10","2","0","0.83333","375","150","225"
"1982","North Carolina","8","4","0","0.66667","348","149","199"
"1983","North Carolina","8","4","0","0.66667","337","216","121"
"1984","North Carolina","5","5","1","0.50000","234","274","-40"
"1985","North Carolina","5","6","0","0.45455","224","223","1"
"1986","North Carolina","7","4","1","0.62500","305","279","26"
"1987","North Carolina","5","6","0","0.45455","214","207","7"
"1988","Kent St. (OH)","5","6","0","0.45455","256","250","6"
"1989","Kent St. (OH)","0","11","0","0.00000","179","377","-198"
"1990","Kent St. (OH)","2","9","0","0.18182","177","328","-151"
"1978","Miami (OH)","8","2","1","0.77273","228","161","67"
"1979","Miami (OH)","6","5","0","0.54545","223","142","81"
"1980","Miami (OH)","5","6","0","0.45455","241","192","49"
"1981","Miami (OH)","8","2","1","0.77273","199","154","45"
"1982","Miami (OH)","7","4","0","0.63636","195","121","74"
"1983","North Carolina St.","3","8","0","0.27273","236","246","-10"
"1984","North Carolina St.","3","8","0","0.27273","263","311","-48"
"1985","North Carolina St.","3","8","0","0.27273","186","305","-119"
"1983","Miami (OH)","4","7","0","0.36364","152","189","-37"
"1984","Miami (OH)","4","7","0","0.36364","175","221","-46"
"1985","Miami (OH)","8","2","1","0.77273","266","211","55"
"1986","Miami (OH)","8","4","0","0.66667","346","228","118"
"1987","Miami (OH)","5","6","0","0.45455","180","235","-55"
"1988","Miami (OH)","0","10","1","0.04545","167","361","-194"
"1989","Miami (OH)","2","8","1","0.22727","122","262","-140"
"1990","Miami (OH)","5","5","1","0.50000","200","225","-25"
"1991","Miami (OH)","6","4","1","0.59091","214","140","74"
"1992","Miami (OH)","6","4","1","0.59091","210","204","6"
"1993","Miami (OH)","4","7","0","0.36364","186","248","-62"
"1994","Miami (OH)","6","4","1","0.59091","262","260","2"
"1995","Miami (OH)","8","2","1","0.77273","326","165","161"
"1996","Miami (OH)","6","5","0","0.54545","273","168","105"
"1997","Miami (OH)","8","3","0","0.72727","412","226","186"
"1998","Miami (OH)","10","1","0","0.90909","317","142","175"
"1999","Northwestern (IL)","3","8","0","0.27273","141","301","-160"
"2000","Northwestern (IL)","8","4","0","0.66667","441","400","41"
"2001","Northwestern (IL)","4","7","0","0.36364","320","378","-58"
"2002","Northwestern (IL)","3","9","0","0.25000","272","493","-221"
"2003","Northwestern (IL)","6","7","0","0.46154","263","326","-63"
"2004","Northwestern (IL)","6","6","0","0.50000","295","342","-47"
"2005","Northwestern (IL)","7","5","0","0.58333","388","407","-19"
"1999","Miami (OH)","7","4","0","0.63636","335","264","71"
"2000","Miami (OH)","6","5","0","0.54545","272","286","-14"
"2001","Miami (OH)","7","5","0","0.58333","319","309","10"
"2002","Miami (OH)","7","5","0","0.58333","384","325","59"
"2003","Miami (OH)","13","1","0","0.92857","602","272","330"
"2004","Miami (OH)","8","5","0","0.61538","407","298","109"
"2005","Indiana","4","7","0","0.36364","248","361","-113"
"2006","Indiana","5","7","0","0.41667","277","394","-117"
"2005","Miami (OH)","7","4","0","0.63636","371","258","113"
"2006","Miami (OH)","2","10","0","0.16667","222","304","-82"
"2007","Miami (OH)","6","7","0","0.46154","250","333","-83"
"2008","Miami (OH)","2","10","0","0.16667","221","392","-171"
"2009","Miami (OH)","1","11","0","0.08333","187","410","-223"
"2010","Miami (OH)","9","4","0","0.69231","267","304","-37"
"2010","Miami (OH)","1","0","0","1.00000","35","21","14"
"2012","Western Kentucky","0","1","0","0.00000","21","24","-3"
"2011","Miami (OH)","4","8","0","0.33333","256","275","-19"
"2012","Miami (OH)","4","8","0","0.33333","280","419","-139"
"2013","Miami (OH)","0","5","0","0.00000","44","178","-134"
"2013","Miami (OH)","0","7","0","0.00000","73","250","-177"
"1869","Rutgers (NJ)","2","2","0","0.50000","18","18","0"
"1870","Rutgers (NJ)","2","2","0","0.50000","17","17","0"
"1872","Columbia (NY)","5","4","0","0.55556","22","16","6"
"1873","Rutgers (NJ)","7","4","1","0.62500","31","26","5"
"1874","Harvard (MA)","9","7","0","0.56250","54","41","13"
"1875","Harvard (MA)","12","6","2","0.65000","52","29","23"
"1876","Harvard (MA)","13","8","1","0.61364","45","29","16"
"1877","Harvard (MA)","9","7","3","0.55263","31","21","10"
"1878","Pennsylvania","14","9","5","0.58929","42","24","18"
"1879","Harvard (MA)","13","9","12","0.55882","46","27","19"
"1880","Harvard (MA)","18","11","4","0.60606","75","53","22"
"1881","Rutgers (NJ)","22","18","8","0.54167","70","47","23"
"1882","Rutgers (NJ)","41","28","2","0.59155","176","111","65"
"1883","Rutgers (NJ)","38","32","1","0.54225","1288","965","323"
"1884","Pennsylvania","47","29","5","0.61111","1728","1184","544"
"1885","Michigan","34","17","4","0.65455","1437","612","825"
"1886","Lehigh (PA)","48","21","4","0.68493","1850","637","1213"
"1887","California","67","35","3","0.65238","2660","935","1725"
"1888","Princeton (NJ)","70","56","6","0.55303","2468","1899","569"
"1889","Brown (RI)","82","51","11","0.60764","2879","1796","1083"
"1890","Brown (RI)","77","76","9","0.50309","3002","2455","547"
"1891","Southern California","94","76","13","0.54918","2813","2189","624"
"1892","Minnesota","93","80","9","0.53571","2972","2394","578"
"1893","Duke (NC)","79","94","9","0.45879","2176","2912","-736"
"1894","Colorado St.","50","62","4","0.44828","1161","1518","-357"
"1895","Boston (MA)","31","44","11","0.42442","692","1031","-339"
"1896","Rhode Island","54","62","12","0.46875","1126","1201","-75"
"1897","Boston (MA)","32","40","6","0.44872","792","785","7"
"1898","Miami (OH)","47","23","4","0.66216","921","644","277"
"1899","New Hampshire","33","32","6","0.50704","571","522","49"
"1900","New Hampshire","22","35","11","0.40441","442","686","-244"
"1901","Marshall (WV)","18","34","3","0.35455","302","917","-615"
"1902","Saint John's (MN)","9","22","4","0.31429","148","460","-312"
"1903","Wichita St. (KS)","14","25","2","0.36585","376","546","-170"
"1904","Oklahoma St.","11","14","1","0.44231","194","394","-200"
"1905","Miami (OH)","7","25","5","0.25676","245","494","-249"
"1906","Rensselaer Tech (NY)","3","7","4","0.35714","92","107","-15"
"1907","Marshall (WV)","5","10","2","0.35294","71","238","-167"
"1908","Fort Hays St. (KS)","5","6","1","0.45833","56","91","-35"
"1909","Fort Hays St. (KS)","1","3","1","0.30000","12","68","-56"
"1910","Texas St.","0","1","0","0.00000","0","19","-19"
"1912","Fort Hays St. (KS)","1","2","0","0.33333","20","132","-112"
"1913","Eureka (IL)","1","6","0","0.14286","39","203","-164"
"1914","Eureka (IL)","3","4","0","0.42857","57","201","-144"
"1915","Texas St.","1","1","1","0.50000","13","20","-7"
"1916","Texas St.","0","2","1","0.16667","0","106","-106"
"1917","Boston (MA)","4","4","0","0.50000","73","136","-63"
"1918","Monmouth (IL)","1","7","0","0.12500","26","137","-111"
"1930","Troy (AL)","1","2","0","0.33333","7","73","-66"
"2013","Grambling St. (LA)","0","1","0","0.00000","0","0","0"
"1891","Michigan","4","5","0","0.44444","168","124","44"
"1892","Michigan","7","5","0","0.58333","298","176","122"
"1893","Michigan","7","3","0","0.70000","278","102","176"
"1894","Michigan","9","1","1","0.86364","240","84","156"
"1895","Michigan","8","1","0","0.88889","266","14","252"
"1896","Michigan","9","1","0","0.90000","262","11","251"
"1897","Michigan","6","2","1","0.72222","166","46","120"
"1898","Michigan","11","0","0","1.00000","216","28","188"
"1899","Michigan","8","2","1","0.77273","176","34","142"
"1900","Michigan","7","2","1","0.75000","117","55","62"
"1901","Princeton (NJ)","9","1","1","0.86364","247","24","223"
"1898","Nebraska","8","3","0","0.72727","270","78","192"
"1899","Kansas","10","0","0","1.00000","280","37","243"
"1900","Stanford (CA)","7","2","1","0.75000","154","20","134"
"1901","Michigan","11","0","0","1.00000","550","0","550"
"1902","Michigan","11","0","0","1.00000","644","12","632"
"1903","Michigan","11","0","1","0.95833","565","6","559"
"1904","Michigan","10","0","0","1.00000","567","22","545"
"1905","Michigan","12","1","0","0.92308","495","2","493"
"1906","Michigan","4","1","1","0.75000","72","30","42"
"1907","Michigan","5","1","0","0.83333","107","6","101"
"1908","Michigan","5","2","1","0.68750","128","81","47"
"1909","Michigan","6","1","0","0.85714","115","34","81"
"1910","Michigan","3","0","3","0.75000","29","9","20"
"1911","Michigan","5","1","2","0.75000","90","38","52"
"1912","Michigan","5","2","0","0.71429","158","65","93"
"1913","Michigan","6","1","0","0.85714","175","21","154"
"1914","Michigan","6","3","0","0.66667","233","68","165"
"1915","Michigan","4","3","1","0.56250","130","81","49"
"1916","Michigan","7","2","0","0.77778","253","56","197"
"1917","Michigan","8","2","0","0.80000","304","53","251"
"1918","Michigan","5","0","0","1.00000","96","6","90"
"1919","Michigan","3","4","0","0.42857","93","102","-9"
"1920","Michigan","5","2","0","0.71429","121","21","100"
"1921","Michigan","5","1","1","0.78571","187","21","166"
"1922","Michigan","6","0","1","0.92857","183","13","170"
"1923","Michigan","8","0","0","1.00000","150","12","138"
"1925","Michigan","7","1","0","0.87500","227","3","224"
"1926","Michigan","7","1","0","0.87500","191","38","153"
"1914","Cincinnati (OH)","6","3","0","0.66667","164","44","120"
"1915","Cincinnati (OH)","4","5","0","0.44444","110","158","-48"
"1916","Miami (OH)","7","0","1","0.93750","238","12","226"
"1919","Miami (OH)","7","1","0","0.87500","147","32","115"
"1920","Miami (OH)","5","2","1","0.68750","114","38","76"
"1921","Miami (OH)","8","0","0","1.00000","238","13","225"
"1924","Michigan","6","2","0","0.75000","155","54","101"
"1925","Wisconsin","6","1","1","0.81250","131","50","81"
"1926","Wisconsin","5","2","1","0.68750","122","72","50"
"1927","Michigan","6","2","0","0.75000","137","39","98"
"1928","Michigan","3","4","1","0.43750","36","62","-26"
"1938","Princeton (NJ)","3","4","1","0.43750","117","107","10"
"1939","Princeton (NJ)","7","1","0","0.87500","132","65","67"
"1940","Princeton (NJ)","5","2","1","0.68750","119","112","7"
"1941","Princeton (NJ)","2","6","0","0.25000","64","152","-88"
"1942","Princeton (NJ)","3","5","1","0.38889","109","135","-26"
"1928","Michigan St.","3","4","1","0.43750","153","66","87"
"1929","Michigan","5","3","1","0.61111","109","75","34"
"1930","Michigan","8","0","1","0.94444","111","23","88"
"1931","Michigan","8","1","1","0.85000","181","27","154"
"1932","Michigan","8","0","0","1.00000","123","13","110"
"1933","Michigan","7","0","1","0.93750","131","18","113"
"1934","Michigan","1","7","0","0.12500","21","143","-122"
"1935","Michigan","4","4","0","0.50000","68","131","-63"
"1936","Michigan","1","7","0","0.12500","36","127","-91"
"1937","Michigan","4","4","0","0.50000","54","110","-56"
"1930","Minnesota","3","4","1","0.43750","126","81","45"
"1931","Minnesota","7","3","0","0.70000","191","72","119"
"1932","Princeton (NJ)","2","2","3","0.50000","96","41","55"
"1933","Princeton (NJ)","9","0","0","1.00000","217","8","209"
"1934","Princeton (NJ)","7","1","0","0.87500","280","38","242"
"1935","Princeton (NJ)","9","0","0","1.00000","256","32","224"
"1936","Princeton (NJ)","4","2","2","0.62500","145","80","65"
"1937","Princeton (NJ)","4","4","0","0.50000","96","126","-30"
"1938","Michigan","6","1","1","0.81250","131","40","91"
"1939","Michigan","6","2","0","0.75000","219","94","125"
"1940","Michigan","7","1","0","0.87500","196","34","162"
"1941","Michigan","6","1","1","0.81250","147","41","106"
"1942","Michigan","7","3","0","0.70000","221","134","87"
"1943","Michigan","8","1","0","0.88889","302","73","229"
"1944","Michigan","8","2","0","0.80000","204","91","113"
"1945","Michigan","7","3","0","0.70000","187","99","88"
"1946","Michigan","6","2","1","0.72222","233","73","160"
"1947","Michigan","10","0","0","1.00000","394","53","341"
"1948","Michigan","9","0","0","1.00000","252","44","208"
"1949","Michigan","6","2","1","0.72222","135","85","50"
"1950","Michigan","6","3","1","0.65000","150","114","36"
"1951","Michigan","4","5","0","0.44444","135","122","13"
"1952","Michigan","5","4","0","0.55556","207","134","73"
"1953","Michigan","6","3","0","0.66667","163","101","62"
"1954","Michigan","6","3","0","0.66667","139","87","52"
"1955","Michigan","7","2","0","0.77778","179","94","85"
"1956","Michigan","7","2","0","0.77778","233","123","110"
"1957","Michigan","5","3","1","0.61111","187","147","40"
"1958","Michigan","2","6","1","0.27778","132","211","-79"
"1959","Michigan","4","5","0","0.44444","122","161","-39"
"1960","Michigan","5","4","0","0.55556","133","84","49"
"1961","Michigan","6","3","0","0.66667","212","163","49"
"1962","Michigan","2","7","0","0.22222","70","214","-144"
"1963","Michigan","3","4","2","0.44444","131","127","4"
"1964","Michigan","9","1","0","0.90000","235","83","152"
"1965","Michigan","4","6","0","0.40000","185","161","24"
"1966","Michigan","6","4","0","0.60000","236","138","98"
"1967","Michigan","4","6","0","0.40000","144","179","-35"
"1968","Michigan","8","2","0","0.80000","277","155","122"
"1963","Miami (OH)","5","3","2","0.60000","208","178","30"
"1964","Miami (OH)","6","3","1","0.65000","209","142","67"
"1965","Miami (OH)","7","3","0","0.70000","247","137","110"
"1966","Miami (OH)","9","1","0","0.90000","229","76","153"
"1967","Miami (OH)","6","4","0","0.60000","181","114","67"
"1968","Miami (OH)","7","3","0","0.70000","240","99","141"
"1969","Michigan","8","3","0","0.72727","352","148","204"
"1970","Michigan","9","1","0","0.90000","288","90","198"
"1971","Michigan","11","1","0","0.91667","421","83","338"
"1972","Michigan","10","1","0","0.90909","264","57","207"
"1973","Michigan","10","0","1","0.95455","330","68","262"
"1974","Michigan","10","1","0","0.90909","324","75","249"
"1975","Michigan","8","2","2","0.75000","324","130","194"
"1976","Michigan","10","2","0","0.83333","432","95","337"
"1977","Michigan","10","2","0","0.83333","353","124","229"
"1978","Michigan","10","2","0","0.83333","372","105","267"
"1979","Michigan","8","4","0","0.66667","312","151","161"
"1980","Michigan","10","2","0","0.83333","322","129","193"
"1981","Michigan","9","3","0","0.75000","355","162","193"
"1982","Michigan","8","4","0","0.66667","345","204","141"
"1983","Michigan","9","3","0","0.75000","355","160","195"
"1984","Michigan","6","6","0","0.50000","214","200","14"
"1985","Michigan","10","1","1","0.87500","342","98","244"
"1986","Michigan","11","2","0","0.84615","379","203","176"
"1987","Michigan","8","4","0","0.66667","331","172","159"
"1988","Michigan","9","2","1","0.79167","361","167","194"
"1989","Michigan","10","2","0","0.83333","335","184","151"
"1977","Illinois","3","8","0","0.27273","141","292","-151"
"1978","Illinois","1","8","2","0.18182","103","317","-214"
"1979","Illinois","2","8","1","0.22727","156","266","-110"
"1990","Michigan","9","3","0","0.75000","389","198","191"
"1991","Michigan","10","2","0","0.83333","420","203","217"
"1992","Michigan","9","0","3","0.87500","431","171","260"
"1993","Michigan","8","4","0","0.66667","342","160","182"
"1994","Michigan","8","4","0","0.66667","330","268","62"
"1995","Michigan","9","4","0","0.69231","338","223","115"
"1996","Michigan","8","4","0","0.66667","277","184","93"
"1997","Michigan","12","0","0","1.00000","322","114","208"
"1998","Michigan","10","3","0","0.76923","359","235","124"
"1999","Michigan","10","2","0","0.83333","361","247","114"
"2000","Michigan","9","3","0","0.75000","404","229","175"
"2001","Michigan","8","4","0","0.66667","320","237","83"
"2002","Michigan","10","3","0","0.76923","361","265","96"
"2003","Michigan","10","3","0","0.76923","460","219","241"
"2004","Michigan","9","3","0","0.75000","370","279","91"
"2005","Michigan","7","5","0","0.58333","345","244","101"
"2006","Michigan","11","2","0","0.84615","380","207","173"
"2007","Michigan","9","4","0","0.69231","354","278","76"
"1990","Glenville St. (WV)","1","7","1","0.16667","147","310","-163"
"1991","Glenville St. (WV)","4","5","1","0.45000","253","231","22"
"1992","Glenville St. (WV)","6","4","0","0.60000","334","199","135"
"1993","Glenville St. (WV)","10","3","0","0.76923","426","177","249"
"1994","Glenville St. (WV)","8","3","0","0.72727","416","291","125"
"1995","Glenville St. (WV)","8","2","0","0.80000","345","123","222"
"1996","Glenville St. (WV)","6","4","0","0.60000","348","309","39"
"2001","West Virginia","3","8","0","0.27273","235","268","-33"
"2002","West Virginia","9","4","0","0.69231","396","302","94"
"2003","West Virginia","8","5","0","0.61538","376","297","79"
"2004","West Virginia","8","4","0","0.66667","361","246","115"
"2005","West Virginia","11","1","0","0.91667","385","214","171"
"2006","West Virginia","11","2","0","0.84615","505","282","223"
"2007","West Virginia","10","2","0","0.83333","467","207","260"
"2008","Michigan","3","9","0","0.25000","243","347","-104"
"2009","Michigan","5","7","0","0.41667","354","330","24"
"2010","Michigan","7","6","0","0.53846","426","458","-32"
"2012","Arizona","8","5","0","0.61538","496","459","37"
"2013","Arizona","8","5","0","0.61538","435","315","120"
"2003","Ball St. (IN)","4","8","0","0.33333","261","386","-125"
"2004","Ball St. (IN)","2","9","0","0.18182","225","405","-180"
"2005","Ball St. (IN)","4","7","0","0.36364","233","416","-183"
"2006","Ball St. (IN)","5","7","0","0.41667","326","309","17"
"2007","Ball St. (IN)","7","6","0","0.53846","409","368","41"
"2008","Ball St. (IN)","12","1","0","0.92308","476","242","234"
"2009","San Diego St. (CA)","4","8","0","0.33333","280","366","-86"
"2010","San Diego St. (CA)","9","4","0","0.69231","455","287","168"
"2011","Michigan","11","2","0","0.84615","433","226","207"
"2012","Michigan","8","5","0","0.61538","388","258","130"
"2013","Michigan","7","6","0","0.53846","419","349","70"
"1872","Stevens Tech (NJ)","0","1","0","0.00000","0","6","-6"
"1873","New York (NY)","3","3","0","0.50000","15","13","2"
"1874","Stevens Tech (NJ)","2","3","0","0.40000","10","20","-10"
"1875","Stevens Tech (NJ)","4","4","0","0.50000","21","20","1"
"1876","New York (NY)","2","3","1","0.41667","16","19","-3"
"1877","Stevens Tech (NJ)","3","1","2","0.66667","9","14","-5"
"1878","Stevens Tech (NJ)","3","3","3","0.50000","3","9","-6"
"1879","Stevens Tech (NJ)","2","3","5","0.45000","8","14","-6"
"1880","Stevens Tech (NJ)","1","5","0","0.16667","3","16","-13"
"1881","Stevens Tech (NJ)","3","8","3","0.32143","16","29","-13"
"1882","Lawrence (WI)","7","8","1","0.46875","17","25","-8"
"1883","Stevens Tech (NJ)","7","6","1","0.53571","187","128","59"
"1884","Fordham (NY)","9","10","0","0.47368","221","261","-40"
"1885","Georgetown (DC)","5","17","1","0.23913","359","612","-253"
"1886","New York (NY)","9","15","2","0.38462","180","565","-385"
"1887","Fordham (NY)","8","12","1","0.40476","157","445","-288"
"1888","Amherst (MA)","6","17","3","0.28846","192","791","-599"
"1889","New York (NY)","8","21","4","0.30303","278","647","-369"
"1890","New York (NY)","25","14","2","0.63415","727","538","189"
"1891","Delaware","32","30","7","0.51449","966","971","-5"
"1892","Beloit (WI)","29","31","3","0.48413","726","797","-71"
"1893","Marquette (WI)","39","34","3","0.53289","1091","885","206"
"1894","Manhattan (NY)","32","29","7","0.52206","853","692","161"
"1895","Delaware","44","35","6","0.55294","889","813","76"
"1896","Manhattan (NY)","51","49","6","0.50943","949","1164","-215"
"1897","Stevens Tech (NJ)","37","50","4","0.42857","661","1048","-387"
"1898","Manhattan (NY)","37","43","9","0.46629","781","1050","-269"
"1899","Manhattan (NY)","34","40","6","0.46250","594","1063","-469"
"1900","Manhattan (NY)","43","47","11","0.48020","991","1049","-58"
"1901","Ferris St. (MI)","51","44","7","0.53431","906","852","54"
"1902","Indiana St.","56","48","5","0.53670","1053","927","126"
"1903","Manhattan (NY)","30","49","7","0.38953","762","1319","-557"
"1904","Saint Francis (NY)","44","53","9","0.45755","787","1363","-576"
"1905","Bluffton (OH)","38","59","5","0.39706","850","1433","-583"
"1906","Ferris St. (MI)","32","43","12","0.43678","677","854","-177"
"1907","Ferris St. (MI)","32","48","10","0.41111","722","1208","-486"
"1908","Western Illinois","36","45","10","0.45055","760","1069","-309"
"1909","Delaware Valley (PA)","27","52","2","0.34568","682","1287","-605"
"1910","East Stroudsburg (PA)","23","31","3","0.42982","583","738","-155"
"1911","Western Illinois","32","44","7","0.42771","661","902","-241"
"1912","Indiana (PA)","36","56","7","0.39899","1134","1463","-329"
"1913","Saint Francis (NY)","52","67","8","0.44094","1672","2360","-688"
"1914","Delaware Valley (PA)","41","50","6","0.45361","1217","1585","-368"
"1915","Western Illinois","34","35","11","0.49375","932","1217","-285"
"1916","Morgan St. (MD)","44","43","7","0.50532","1493","1270","223"
"1917","Morgan St. (MD)","21","21","2","0.50000","408","883","-475"
"1918","Oklahoma Baptist University","7","16","2","0.32000","258","358","-100"
"1919","Western Illinois","53","41","8","0.55882","1478","1056","422"
"1920","Virginia Union","28","39","2","0.42029","506","893","-387"
"1921","Cooper Union (NY)","19","34","3","0.36607","441","1112","-671"
"1922","Cooper Union (NY)","27","34","6","0.44776","703","832","-129"
"1923","Cooper Union (NY)","31","45","2","0.41026","718","1112","-394"
"1924","East Stroudsburg (PA)","34","40","6","0.46250","946","1175","-229"
"1925","Saint Anselm (NH)","32","28","10","0.52857","847","802","45"
"1926","Saint Anselm (NH)","22","30","4","0.42857","515","702","-187"
"1927","Bethune-Cookman (FL)","20","29","8","0.42105","674","783","-109"
"1928","Saint Anselm (NH)","28","24","7","0.53390","564","1095","-531"
"1929","Saint Anselm (NH)","25","32","5","0.44355","616","843","-227"
"1930","Saint Anselm (NH)","31","27","10","0.52941","643","549","94"
"1931","Campbell (NC)","21","17","4","0.54762","465","428","37"
"1932","Campbell (NC)","7","30","3","0.21250","254","760","-506"
"1933","Campbell (NC)","11","13","3","0.46296","262","324","-62"
"1934","Bowie St. (MD)","4","7","2","0.38462","116","94","22"
"1935","Florida Southern","7","12","1","0.37500","170","162","8"
"1936","Bowie St. (MD)","5","2","1","0.68750","154","97","57"
"1937","Bowie St. (MD)","6","3","0","0.66667","98","87","11"
"1938","West Alabama","7","5","0","0.58333","151","88","63"
"1939","Elizabeth City St. (NC)","7","13","0","0.35000","150","307","-157"
"1940","Elizabeth City St. (NC)","6","5","4","0.53333","128","67","61"
"1941","Arkansas-Pine Bluff","3","9","5","0.32353","178","223","-45"
"1942","Brevard College (NC)","10","6","2","0.61111","225","189","36"
"1943","Clark Atlanta (GA)","6","8","0","0.42857","127","206","-79"
"1944","Abilene Christian (TX)","9","11","1","0.45238","158","255","-97"
"1945","Benedict (SC)","10","15","2","0.40741","299","296","3"
"1946","Elizabeth City St. (NC)","7","20","3","0.28333","144","540","-396"
"1947","Clark Atlanta (GA)","3","6","2","0.36364","49","230","-181"
"1948","Virginia-Lynchburg","4","6","1","0.40909","77","302","-225"
"1949","Virginia-Lynchburg","0","3","1","0.12500","7","70","-63"
"1950","Virginia-Lynchburg","2","3","0","0.40000","53","98","-45"
"1951","Lane (TN)","8","6","0","0.57143","295","234","61"
"1952","Lane (TN)","9","5","1","0.63333","220","206","14"
"1953","Lane (TN)","1","7","0","0.12500","58","215","-157"
"1954","Lane (TN)","2","6","0","0.25000","105","135","-30"
"1955","Lane (TN)","2","4","0","0.33333","83","129","-46"
"1957","Louisiana College","2","7","0","0.22222","106","179","-73"
"1959","Azusa Pacific (CA)","2","3","0","0.40000","117","90","27"
"1960","Azusa Pacific (CA)","4","3","1","0.56250","103","76","27"
"1961","Azusa Pacific (CA)","3","3","0","0.50000","123","147","-24"
"1963","San Francisco (CA)","2","5","0","0.28571","58","98","-40"
"1964","New York (NY)","0","2","0","0.00000","20","48","-28"
"1965","Adelphi (NY)","4","8","0","0.33333","198","216","-18"
"1966","Fairfield (CT)","18","22","2","0.45238","545","652","-107"
"1967","La Salle (PA)","25","31","0","0.44643","846","1080","-234"
"1968","Centenary (LA)","17","42","2","0.29508","726","1393","-667"
"1969","Bluffton (OH)","33","43","0","0.43421","1058","1548","-490"
"1970","Saint John's (NY)","35","54","1","0.39444","1379","1783","-404"
"1971","Bluffton (OH)","43","45","1","0.48876","1360","1384","-24"
"1972","Marquette (WI)","39","44","2","0.47059","1217","1351","-134"
"1973","Brooklyn (NY)","30","52","1","0.36747","1007","1611","-604"
"1974","Marquette (WI)","33","36","3","0.47917","959","1169","-210"
"1975","Marquette (WI)","31","22","4","0.57895","1042","932","110"
"1976","Bluffton (OH)","23","33","1","0.41228","862","1186","-324"
"1977","Manhattan (NY)","14","28","1","0.33721","568","923","-355"
"1978","Fairfield (CT)","5","7","1","0.42308","194","203","-9"
"1979","Fairfield (CT)","7","8","0","0.46667","247","260","-13"
"1980","Westfield St. (MA)","6","5","4","0.53333","184","196","-12"
"1981","San Francisco (CA)","17","14","0","0.54839","567","498","69"
"1982","Manhattan (NY)","18","16","0","0.52941","580","644","-64"
"1983","SUNY-Stony Brook (NY)","15","11","0","0.57692","474","453","21"
"1984","Stonehill (MA)","7","12","0","0.36842","231","439","-208"
"1985","Manhattan (NY)","10","10","0","0.50000","313","316","-3"
"1986","Marquette (WI)","13","17","0","0.43333","497","564","-67"
"1987","Marquette (WI)","10","17","0","0.37037","389","487","-98"
"1988","Marquette (WI)","1","5","0","0.16667","80","125","-45"
"1989","Marquette (WI)","4","4","0","0.50000","209","151","58"
"1990","Marquette (WI)","1","7","0","0.12500","80","180","-100"
"1991","Marquette (WI)","1","5","0","0.16667","106","182","-76"
"1992","Marquette (WI)","2","5","0","0.28571","81","129","-48"
"1993","Marquette (WI)","7","1","0","0.87500","212","126","86"
"1994","Marquette (WI)","1","6","0","0.14286","125","184","-59"
"1995","Marquette (WI)","3","4","0","0.42857","141","191","-50"
"1996","Marquette (WI)","3","5","0","0.37500","139","182","-43"
"1998","Madison College (WI)","2","15","0","0.11765","221","613","-392"
"1999","Marquette (WI)","0","7","0","0.00000","110","298","-188"
"2000","Marquette (WI)","1","5","0","0.16667","60","96","-36"
"2001","Marquette (WI)","2","6","0","0.25000","144","179","-35"
"2002","Marquette (WI)","3","4","0","0.42857","127","208","-81"
"2003","Marquette (WI)","1","6","0","0.14286","71","151","-80"
"2004","Marquette (WI)","0","6","0","0.00000","53","238","-185"
"2005","Marquette (WI)","2","5","0","0.28571","92","226","-134"
"2006","Marquette (WI)","1","6","0","0.14286","62","206","-144"
"2007","Marquette (WI)","2","5","0","0.28571","140","215","-75"
"2008","Marquette (WI)","0","7","0","0.00000","61","304","-243"
"2009","Marquette (WI)","0","1","0","0.00000","0","22","-22"
"1869","Rutgers (NJ)","2","2","0","0.50000","18","18","0"
"1870","Rutgers (NJ)","2","2","0","0.50000","17","17","0"
"1872","Columbia (NY)","5","4","0","0.55556","22","16","6"
"1873","Rutgers (NJ)","7","4","1","0.62500","31","26","5"
"1874","Harvard (MA)","9","7","0","0.56250","54","41","13"
"1875","Harvard (MA)","12","6","2","0.65000","52","29","23"
"1876","Harvard (MA)","13","8","1","0.61364","45","29","16"
"1877","Harvard (MA)","9","7","3","0.55263","31","21","10"
"1878","Pennsylvania","14","9","5","0.58929","42","24","18"
"1879","Harvard (MA)","13","9","12","0.55882","46","27","19"
"1880","Harvard (MA)","18","11","4","0.60606","75","53","22"
"1881","Rutgers (NJ)","22","18","8","0.54167","70","47","23"
"1882","Rutgers (NJ)","41","28","2","0.59155","176","111","65"
"1883","Rutgers (NJ)","38","32","1","0.54225","1288","965","323"
"1884","Pennsylvania","47","29","5","0.61111","1728","1184","544"
"1885","Michigan","34","17","4","0.65455","1437","612","825"
"1886","Lehigh (PA)","48","21","4","0.68493","1850","637","1213"
"1887","California","67","35","3","0.65238","2660","935","1725"
"1888","Princeton (NJ)","70","56","6","0.55303","2468","1899","569"
"1889","Brown (RI)","82","51","11","0.60764","2879","1796","1083"
"1890","Brown (RI)","77","76","9","0.50309","3002","2455","547"
"1891","Southern California","94","76","13","0.54918","2813","2189","624"
"1892","Minnesota","93","80","9","0.53571","2972","2394","578"
"1893","Duke (NC)","79","94","9","0.45879","2176","2912","-736"
"1894","Colorado St.","50","62","4","0.44828","1161","1518","-357"
"1895","Boston (MA)","31","44","11","0.42442","692","1031","-339"
"1896","Rhode Island","54","62","12","0.46875","1126","1201","-75"
"1897","Boston (MA)","32","40","6","0.44872","792","785","7"
"1898","Miami (OH)","47","23","4","0.66216","921","644","277"
"1899","New Hampshire","33","32","6","0.50704","571","522","49"
"1900","New Hampshire","22","35","11","0.40441","442","686","-244"
"1901","Marshall (WV)","18","34","3","0.35455","302","917","-615"
"1902","Saint John's (MN)","9","22","4","0.31429","148","460","-312"
"1903","Wichita St. (KS)","14","25","2","0.36585","376","546","-170"
"1904","Oklahoma St.","11","14","1","0.44231","194","394","-200"
"1905","Miami (OH)","7","25","5","0.25676","245","494","-249"
"1906","Rensselaer Tech (NY)","3","7","4","0.35714","92","107","-15"
"1907","Marshall (WV)","5","10","2","0.35294","71","238","-167"
"1908","Fort Hays St. (KS)","5","6","1","0.45833","56","91","-35"
"1909","Fort Hays St. (KS)","1","3","1","0.30000","12","68","-56"
"1910","Texas St.","0","1","0","0.00000","0","19","-19"
"1912","Fort Hays St. (KS)","1","2","0","0.33333","20","132","-112"
"1913","Eureka (IL)","1","6","0","0.14286","39","203","-164"
"1914","Eureka (IL)","3","4","0","0.42857","57","201","-144"
"1915","Texas St.","1","1","1","0.50000","13","20","-7"
"1916","Texas St.","0","2","1","0.16667","0","106","-106"
"1917","Boston (MA)","4","4","0","0.50000","73","136","-63"
"1918","Monmouth (IL)","1","7","0","0.12500","26","137","-111"
"1930","Troy (AL)","1","2","0","0.33333","7","73","-66"
"2013","Grambling St. (LA)","0","1","0","0.00000","0","0","0"
"1897","Michigan St.","4","2","1","0.64286","146","106","40"
"1898","Michigan St.","4","3","0","0.57143","142","127","15"
"1899","Michigan St.","2","4","1","0.35714","81","101","-20"
"1900","Michigan St.","1","6","0","0.14286","51","111","-60"
"1901","Michigan St.","3","4","1","0.43750","120","94","26"
"1902","Michigan St.","4","5","0","0.44444","93","208","-115"
"1899","Albion (MI)","3","5","0","0.37500","70","94","-24"
"1900","Albion (MI)","6","1","2","0.77778","146","40","106"
"1901","Albion (MI)","7","4","1","0.62500","196","134","62"
"1902","Albion (MI)","5","6","0","0.45455","179","181","-2"
"1903","Michigan St.","6","1","1","0.81250","178","24","154"
"1904","Michigan St.","8","1","0","0.88889","380","16","364"
"1905","Michigan St.","10","2","0","0.83333","349","75","274"
"1906","Michigan St.","7","2","2","0.72727","195","28","167"
"1907","Michigan St.","4","2","1","0.64286","127","60","67"
"1908","Michigan St.","6","0","2","0.87500","205","22","183"
"1909","Michigan St.","9","1","0","0.90000","291","17","274"
"1910","Michigan St.","6","1","0","0.85714","168","8","160"
"1911","Missouri","2","4","2","0.37500","61","67","-6"
"1912","Missouri","5","3","0","0.62500","135","69","66"
"1913","Missouri","7","1","0","0.87500","193","67","126"
"1917","Michigan St.","0","9","0","0.00000","23","179","-156"
"1919","Michigan St.","4","4","1","0.50000","132","99","33"
"1922","California-Davis","3","4","2","0.44444","178","53","125"
"1911","Michigan St.","5","1","0","0.83333","93","30","63"
"1912","Michigan St.","7","1","0","0.87500","297","98","199"
"1913","Michigan St.","7","0","0","1.00000","180","28","152"
"1914","Michigan St.","5","2","0","0.71429","188","57","131"
"1915","Michigan St.","5","1","0","0.83333","258","38","220"
"1912","Colgate (NY)","5","2","0","0.71429","90","47","43"
"1914","Villanova (PA)","4","3","1","0.56250","30","71","-41"
"1915","Villanova (PA)","6","1","0","0.85714","100","29","71"
"1916","Michigan St.","4","2","1","0.64286","126","26","100"
"1924","Villanova (PA)","2","5","1","0.31250","70","109","-39"
"1918","Michigan St.","4","3","0","0.57143","133","69","64"
"1920","Michigan St.","4","6","0","0.40000","270","166","104"
"1921","Kansas","4","3","0","0.57143","92","97","-5"
"1922","Kansas","3","4","1","0.43750","104","75","29"
"1923","Kansas","5","0","3","0.81250","125","6","119"
"1924","Kansas","2","5","1","0.31250","91","56","35"
"1925","Kansas","2","5","1","0.31250","30","68","-38"
"1927","Butler (IN)","4","3","1","0.56250","155","133","22"
"1928","Butler (IN)","6","2","0","0.75000","170","44","126"
"1929","Butler (IN)","4","4","0","0.50000","85","67","18"
"1945","Nebraska","4","5","0","0.44444","145","200","-55"
"1948","Nebraska","2","8","0","0.20000","137","273","-136"
"1921","Michigan St.","3","5","0","0.37500","68","126","-58"
"1922","Michigan St.","3","5","2","0.40000","111","135","-24"
"1915","DePauw (IN)","5","3","0","0.62500","159","79","80"
"1916","Kalamazoo (MI)","7","0","0","1.00000","291","40","251"
"1917","Kalamazoo (MI)","5","5","0","0.50000","184","225","-41"
"1919","Kalamazoo (MI)","5","2","0","0.71429","187","70","117"
"1920","Kalamazoo (MI)","5","3","1","0.61111","200","143","57"
"1921","Kalamazoo (MI)","7","2","0","0.77778","234","104","130"
"1922","Kalamazoo (MI)","4","4","1","0.50000","96","92","4"
"1923","Michigan St.","3","5","0","0.37500","56","144","-88"
"1924","Michigan St.","5","3","0","0.62500","210","48","162"
"1925","Michigan St.","3","5","0","0.37500","105","106","-1"
"1926","Michigan St.","3","4","1","0.43750","97","171","-74"
"1927","Michigan St.","4","5","0","0.44444","111","128","-17"
"1928","Michigan St.","3","4","1","0.43750","153","66","87"
"1929","Michigan","5","3","1","0.61111","109","75","34"
"1930","Michigan","8","0","1","0.94444","111","23","88"
"1931","Michigan","8","1","1","0.85000","181","27","154"
"1932","Michigan","8","0","0","1.00000","123","13","110"
"1933","Michigan","7","0","1","0.93750","131","18","113"
"1934","Michigan","1","7","0","0.12500","21","143","-122"
"1935","Michigan","4","4","0","0.50000","68","131","-63"
"1936","Michigan","1","7","0","0.12500","36","127","-91"
"1937","Michigan","4","4","0","0.50000","54","110","-56"
"1929","Michigan St.","5","3","0","0.62500","244","104","140"
"1930","Michigan St.","5","1","2","0.75000","151","32","119"
"1931","Michigan St.","5","3","1","0.61111","291","61","230"
"1932","Michigan St.","7","1","0","0.87500","220","64","156"
"1933","Fordham (NY)","6","2","0","0.75000","195","40","155"
"1934","Fordham (NY)","5","3","0","0.62500","165","92","73"
"1935","Fordham (NY)","6","1","2","0.77778","134","41","93"
"1936","Fordham (NY)","5","1","2","0.75000","128","33","95"
"1937","Fordham (NY)","7","0","1","0.93750","182","16","166"
"1938","Fordham (NY)","6","1","2","0.77778","186","30","156"
"1939","Fordham (NY)","6","2","0","0.75000","124","48","76"
"1940","Fordham (NY)","7","2","0","0.77778","162","62","100"
"1941","Fordham (NY)","8","1","0","0.88889","182","67","115"
"1919","Northwestern (IL)","2","5","0","0.28571","49","111","-62"
"1920","Kansas St.","3","3","3","0.50000","93","55","38"
"1921","Kansas St.","5","3","0","0.62500","84","64","20"
"1922","Kansas St.","5","1","2","0.75000","154","61","93"
"1923","Kansas St.","4","2","2","0.62500","107","72","35"
"1924","Kansas St.","3","4","1","0.43750","68","79","-11"
"1925","Kansas St.","5","2","1","0.68750","70","43","27"
"1926","Kansas St.","5","3","0","0.62500","85","42","43"
"1927","Kansas St.","3","5","0","0.37500","101","146","-45"
"1928","Florida","8","1","0","0.88889","336","44","292"
"1929","Florida","8","2","0","0.80000","187","73","114"
"1930","Florida","6","3","1","0.65000","199","60","139"
"1931","Florida","2","6","2","0.30000","73","168","-95"
"1932","Florida","3","6","0","0.33333","108","136","-28"
"1933","Michigan St.","4","2","2","0.62500","73","49","24"
"1934","Michigan St.","8","1","0","0.88889","153","56","97"
"1935","Michigan St.","6","2","0","0.75000","207","57","150"
"1936","Michigan St.","6","1","2","0.77778","143","40","103"
"1937","Michigan St.","8","2","0","0.80000","117","42","75"
"1938","Michigan St.","6","3","0","0.66667","133","59","74"
"1939","Michigan St.","4","4","1","0.50000","102","92","10"
"1940","Michigan St.","3","4","1","0.43750","108","76","32"
"1941","Michigan St.","5","3","1","0.61111","150","77","73"
"1942","Michigan St.","4","3","2","0.55556","120","99","21"
"1944","Michigan St.","6","1","0","0.85714","167","31","136"
"1945","Michigan St.","5","3","1","0.61111","120","128","-8"
"1946","Michigan St.","5","5","0","0.50000","181","202","-21"
"1946","Syracuse (NY)","4","5","0","0.44444","146","158","-12"
"1947","Michigan St.","7","2","0","0.77778","167","101","66"
"1948","Michigan St.","6","2","2","0.70000","359","130","229"
"1949","Michigan St.","6","3","0","0.66667","309","107","202"
"1950","Michigan St.","8","1","0","0.88889","243","107","136"
"1951","Michigan St.","9","0","0","1.00000","270","114","156"
"1952","Michigan St.","9","0","0","1.00000","312","84","228"
"1953","Michigan St.","9","1","0","0.90000","240","110","130"
"1954","Michigan St.","3","6","0","0.33333","177","149","28"
"1955","Michigan St.","9","1","0","0.90000","253","83","170"
"1956","Michigan St.","7","2","0","0.77778","239","87","152"
"1957","Michigan St.","8","1","0","0.88889","264","75","189"
"1958","Michigan St.","3","5","1","0.38889","117","123","-6"
"1959","Michigan St.","5","4","0","0.55556","149","118","31"
"1960","Michigan St.","6","2","1","0.72222","193","118","75"
"1961","Michigan St.","7","2","0","0.77778","192","50","142"
"1962","Michigan St.","5","4","0","0.55556","189","96","93"
"1963","Michigan St.","6","2","1","0.72222","148","63","85"
"1964","Michigan St.","4","5","0","0.44444","136","141","-5"
"1965","Michigan St.","10","1","0","0.90909","263","76","187"
"1966","Michigan St.","9","0","1","0.95000","293","99","194"
"1967","Michigan St.","3","7","0","0.30000","173","193","-20"
"1968","Michigan St.","5","5","0","0.50000","202","151","51"
"1969","Michigan St.","4","6","0","0.40000","202","231","-29"
"1970","Michigan St.","4","6","0","0.40000","190","215","-25"
"1971","Michigan St.","6","5","0","0.54545","225","169","56"
"1972","Michigan St.","5","5","1","0.50000","158","156","2"
"1965","Alma (MI)","3","5","0","0.37500","79","147","-68"
"1966","Alma (MI)","4","5","0","0.44444","102","93","9"
"1967","Alma (MI)","8","0","0","1.00000","217","41","176"
"1968","Alma (MI)","8","0","0","1.00000","248","65","183"
"1969","Alma (MI)","6","3","0","0.66667","218","113","105"
"1970","Alma (MI)","5","3","0","0.62500","195","104","91"
"1973","Michigan St.","5","6","0","0.45455","114","164","-50"
"1974","Michigan St.","7","3","1","0.68182","270","196","74"
"1975","Michigan St.","7","4","0","0.63636","222","167","55"
"1977","Bowling Green (OH)","5","7","0","0.41667","275","296","-21"
"1978","Bowling Green (OH)","4","7","0","0.36364","277","267","10"
"1979","Bowling Green (OH)","4","7","0","0.36364","194","265","-71"
"1980","Bowling Green (OH)","4","7","0","0.36364","189","186","3"
"1981","Bowling Green (OH)","5","5","1","0.50000","155","132","23"
"1982","Bowling Green (OH)","7","5","0","0.58333","265","199","66"
"1983","Bowling Green (OH)","8","3","0","0.72727","277","242","35"
"1984","Bowling Green (OH)","8","3","0","0.72727","327","198","129"
"1985","Bowling Green (OH)","11","1","0","0.91667","355","223","132"
"1986","San Diego St. (CA)","8","4","0","0.66667","292","279","13"
"1987","San Diego St. (CA)","5","7","0","0.41667","357","428","-71"
"1988","San Diego St. (CA)","3","8","0","0.27273","204","384","-180"
"1966","Fresno St. (CA)","7","3","0","0.70000","158","214","-56"
"1967","Fresno St. (CA)","3","8","0","0.27273","240","267","-27"
"1968","Fresno St. (CA)","7","4","0","0.63636","269","226","43"
"1969","Fresno St. (CA)","6","4","0","0.60000","237","227","10"
"1970","Fresno St. (CA)","8","4","0","0.66667","289","273","16"
"1971","Fresno St. (CA)","6","5","0","0.54545","215","165","50"
"1972","Fresno St. (CA)","6","4","1","0.59091","237","158","79"
"1973","San Jose St. (CA)","5","4","2","0.54545","193","173","20"
"1974","San Jose St. (CA)","8","3","1","0.70833","323","199","124"
"1975","San Jose St. (CA)","9","2","0","0.81818","291","152","139"
"1976","Michigan St.","4","6","1","0.40909","236","278","-42"
"1977","Michigan St.","7","3","1","0.68182","260","162","98"
"1978","Michigan St.","8","3","0","0.72727","411","170","241"
"1979","Michigan St.","5","6","0","0.45455","240","253","-13"
"1980","Arizona St.","7","4","0","0.63636","311","216","95"
"1981","Arizona St.","9","2","0","0.81818","394","193","201"
"1982","Arizona St.","10","2","0","0.83333","294","145","149"
"1983","Arizona St.","6","4","1","0.59091","320","200","120"
"1984","Arizona St.","5","6","0","0.45455","297","203","94"
"1975","Saginaw Valley St. (MI)","3","7","0","0.30000","128","219","-91"
"1976","Saginaw Valley St. (MI)","4","7","0","0.36364","213","158","55"
"1977","Saginaw Valley St. (MI)","6","5","0","0.54545","193","188","5"
"1978","Saginaw Valley St. (MI)","4","5","1","0.45000","211","210","1"
"1979","Saginaw Valley St. (MI)","8","2","1","0.77273","295","130","165"
"1980","Michigan St.","3","8","0","0.27273","221","279","-58"
"1981","Michigan St.","5","6","0","0.45455","263","249","14"
"1982","Michigan St.","2","9","0","0.18182","202","242","-40"
"1983","Michigan St.","4","6","1","0.40909","162","233","-71"
"1984","Michigan St.","6","6","0","0.50000","193","203","-10"
"1985","Michigan St.","7","5","0","0.58333","258","219","39"
"1986","Michigan St.","6","5","0","0.54545","285","197","88"
"1987","Michigan St.","9","2","1","0.79167","261","153","108"
"1988","Michigan St.","6","5","1","0.54167","269","177","92"
"1989","Michigan St.","8","4","0","0.66667","356","163","193"
"1990","Michigan St.","8","3","1","0.70833","312","223","89"
"1991","Michigan St.","3","8","0","0.27273","162","272","-110"
"1992","Michigan St.","5","6","0","0.45455","238","261","-23"
"1993","Michigan St.","6","6","0","0.50000","277","289","-12"
"1994","Michigan St.","0","11","0","0.00000","280","267","13"
"1990","Toledo (OH)","9","2","0","0.81818","284","178","106"
"1995","Michigan St.","6","5","1","0.54167","287","338","-51"
"1996","Michigan St.","6","6","0","0.50000","358","302","56"
"1997","Michigan St.","7","5","0","0.58333","342","237","105"
"1998","Michigan St.","6","6","0","0.50000","336","294","42"
"1999","Michigan St.","9","2","0","0.81818","341","211","130"
"2000","Louisiana St.","8","4","0","0.66667","320","235","85"
"2001","Louisiana St.","10","3","0","0.76923","418","302","116"
"2002","Louisiana St.","8","5","0","0.61538","323","238","85"
"2003","Louisiana St.","13","1","0","0.92857","475","154","321"
"2004","Louisiana St.","9","3","0","0.75000","344","205","139"
"2007","Alabama","2","6","0","0.25000","352","286","66"
"2008","Alabama","12","2","0","0.85714","422","200","222"
"2009","Alabama","14","0","0","1.00000","449","164","285"
"2010","Alabama","10","3","0","0.76923","464","176","288"
"2011","Alabama","12","1","0","0.92308","453","106","347"
"2012","Alabama","13","1","0","0.92857","542","153","389"
"2013","Alabama","11","2","0","0.84615","496","181","315"
"1999","Michigan St.","1","0","0","1.00000","37","34","3"
"2000","Michigan St.","5","6","0","0.45455","197","233","-36"
"2001","Michigan St.","7","5","0","0.58333","374","311","63"
"2002","Michigan St.","3","6","0","0.33333","211","271","-60"
"2002","Michigan St.","1","2","0","0.33333","105","127","-22"
"1989","Idaho","9","3","0","0.75000","407","314","93"
"1990","Idaho","9","4","0","0.69231","477","342","135"
"1991","Idaho","6","5","0","0.54545","375","313","62"
"1992","Idaho","9","3","0","0.75000","466","247","219"
"1993","Idaho","11","3","0","0.78571","593","353","240"
"1994","Idaho","9","3","0","0.75000","493","289","204"
"1995","Utah St.","4","7","0","0.36364","293","287","6"
"1996","Utah St.","6","5","0","0.54545","330","339","-9"
"1997","Utah St.","6","6","0","0.50000","389","296","93"
"1998","Louisville (KY)","7","5","0","0.58333","473","435","38"
"1999","Louisville (KY)","7","5","0","0.58333","443","365","78"
"2000","Louisville (KY)","9","3","0","0.75000","405","268","137"
"2001","Louisville (KY)","11","2","0","0.84615","394","223","171"
"2002","Louisville (KY)","7","6","0","0.53846","374","319","55"
"2003","Michigan St.","8","5","0","0.61538","363","293","70"
"2004","Michigan St.","5","7","0","0.41667","353","326","27"
"2005","Michigan St.","5","6","0","0.45455","372","316","56"
"2006","Michigan St.","4","8","0","0.33333","302","341","-39"
"2012","Arkansas","4","8","0","0.33333","282","365","-83"
"2013","Fort Lewis (CO)","4","7","0","0.36364","161","334","-173"
"2004","Cincinnati (OH)","7","5","0","0.58333","344","320","24"
"2005","Cincinnati (OH)","4","7","0","0.36364","192","345","-153"
"2006","Cincinnati (OH)","7","5","0","0.58333","247","231","16"
"2007","Michigan St.","7","6","0","0.53846","430","346","84"
"2008","Michigan St.","9","4","0","0.69231","326","287","39"
"2009","Michigan St.","6","7","0","0.46154","386","342","44"
"2010","Michigan St.","11","2","0","0.84615","383","290","93"
"2011","Michigan St.","11","3","0","0.78571","434","257","177"
"2012","Michigan St.","7","6","0","0.53846","260","212","48"
"2013","Michigan St.","13","1","0","0.92857","411","185","226"
"1911","Middle Tennessee St.","0","2","0","0.00000","0","26","-26"
"1912","Middle Tennessee St.","1","0","0","1.00000","29","7","22"
"1913","Middle Tennessee St.","5","1","1","0.78571","164","48","116"
"1914","Middle Tennessee St.","5","0","1","0.91667","132","13","119"
"1915","Middle Tennessee St.","2","3","1","0.41667","34","92","-58"
"1916","Middle Tennessee St.","5","2","0","0.71429","116","30","86"
"1919","Middle Tennessee St.","4","0","0","1.00000","148","6","142"
"1920","Middle Tennessee St.","4","1","0","0.80000","126","54","72"
"1921","Middle Tennessee St.","3","2","1","0.58333","36","74","-38"
"1922","Middle Tennessee St.","2","6","0","0.25000","20","175","-155"
"1923","Middle Tennessee St.","4","1","0","0.80000","121","39","82"
"1917","Middle Tennessee St.","7","0","0","1.00000","201","0","201"
"1929","Auburn (AL)","0","4","0","0.00000","6","122","-116"
"1930","Citadel (SC)","4","5","2","0.45455","60","95","-35"
"1931","Citadel (SC)","5","4","1","0.55000","93","125","-32"
"1935","Middle Tennessee St.","8","0","0","1.00000","128","25","103"
"1936","Middle Tennessee St.","7","1","0","0.87500","112","65","47"
"1937","Middle Tennessee St.","6","1","1","0.81250","134","40","94"
"1938","Middle Tennessee St.","2","6","0","0.25000","65","115","-50"
"1872","Stevens Tech (NJ)","0","1","0","0.00000","0","6","-6"
"1873","New York (NY)","3","3","0","0.50000","15","13","2"
"1874","Stevens Tech (NJ)","2","3","0","0.40000","10","20","-10"
"1875","Stevens Tech (NJ)","4","4","0","0.50000","21","20","1"
"1876","New York (NY)","2","3","1","0.41667","16","19","-3"
"1877","Stevens Tech (NJ)","3","1","2","0.66667","9","14","-5"
"1878","Stevens Tech (NJ)","3","3","3","0.50000","3","9","-6"
"1879","Stevens Tech (NJ)","2","3","5","0.45000","8","14","-6"
"1880","Stevens Tech (NJ)","1","5","0","0.16667","3","16","-13"
"1881","Stevens Tech (NJ)","3","8","3","0.32143","16","29","-13"
"1882","Lawrence (WI)","7","8","1","0.46875","17","25","-8"
"1883","Stevens Tech (NJ)","7","6","1","0.53571","187","128","59"
"1884","Fordham (NY)","9","10","0","0.47368","221","261","-40"
"1885","Georgetown (DC)","5","17","1","0.23913","359","612","-253"
"1886","New York (NY)","9","15","2","0.38462","180","565","-385"
"1887","Fordham (NY)","8","12","1","0.40476","157","445","-288"
"1888","Amherst (MA)","6","17","3","0.28846","192","791","-599"
"1889","New York (NY)","8","21","4","0.30303","278","647","-369"
"1890","New York (NY)","25","14","2","0.63415","727","538","189"
"1891","Delaware","32","30","7","0.51449","966","971","-5"
"1892","Beloit (WI)","29","31","3","0.48413","726","797","-71"
"1893","Marquette (WI)","39","34","3","0.53289","1091","885","206"
"1894","Manhattan (NY)","32","29","7","0.52206","853","692","161"
"1895","Delaware","44","35","6","0.55294","889","813","76"
"1896","Manhattan (NY)","51","49","6","0.50943","949","1164","-215"
"1897","Stevens Tech (NJ)","37","50","4","0.42857","661","1048","-387"
"1898","Manhattan (NY)","37","43","9","0.46629","781","1050","-269"
"1899","Manhattan (NY)","34","40","6","0.46250","594","1063","-469"
"1900","Manhattan (NY)","43","47","11","0.48020","991","1049","-58"
"1901","Ferris St. (MI)","51","44","7","0.53431","906","852","54"
"1902","Indiana St.","56","48","5","0.53670","1053","927","126"
"1903","Manhattan (NY)","30","49","7","0.38953","762","1319","-557"
"1904","Saint Francis (NY)","44","53","9","0.45755","787","1363","-576"
"1905","Bluffton (OH)","38","59","5","0.39706","850","1433","-583"
"1906","Ferris St. (MI)","32","43","12","0.43678","677","854","-177"
"1907","Ferris St. (MI)","32","48","10","0.41111","722","1208","-486"
"1908","Western Illinois","36","45","10","0.45055","760","1069","-309"
"1909","Delaware Valley (PA)","27","52","2","0.34568","682","1287","-605"
"1910","East Stroudsburg (PA)","23","31","3","0.42982","583","738","-155"
"1911","Western Illinois","32","44","7","0.42771","661","902","-241"
"1912","Indiana (PA)","36","56","7","0.39899","1134","1463","-329"
"1913","Saint Francis (NY)","52","67","8","0.44094","1672","2360","-688"
"1914","Delaware Valley (PA)","41","50","6","0.45361","1217","1585","-368"
"1915","Western Illinois","34","35","11","0.49375","932","1217","-285"
"1916","Morgan St. (MD)","44","43","7","0.50532","1493","1270","223"
"1917","Morgan St. (MD)","21","21","2","0.50000","408","883","-475"
"1918","Oklahoma Baptist University","7","16","2","0.32000","258","358","-100"
"1919","Western Illinois","53","41","8","0.55882","1478","1056","422"
"1920","Virginia Union","28","39","2","0.42029","506","893","-387"
"1921","Cooper Union (NY)","19","34","3","0.36607","441","1112","-671"
"1922","Cooper Union (NY)","27","34","6","0.44776","703","832","-129"
"1923","Cooper Union (NY)","31","45","2","0.41026","718","1112","-394"
"1924","East Stroudsburg (PA)","34","40","6","0.46250","946","1175","-229"
"1925","Saint Anselm (NH)","32","28","10","0.52857","847","802","45"
"1926","Saint Anselm (NH)","22","30","4","0.42857","515","702","-187"
"1927","Bethune-Cookman (FL)","20","29","8","0.42105","674","783","-109"
"1928","Saint Anselm (NH)","28","24","7","0.53390","564","1095","-531"
"1929","Saint Anselm (NH)","25","32","5","0.44355","616","843","-227"
"1930","Saint Anselm (NH)","31","27","10","0.52941","643","549","94"
"1931","Campbell (NC)","21","17","4","0.54762","465","428","37"
"1932","Campbell (NC)","7","30","3","0.21250","254","760","-506"
"1933","Campbell (NC)","11","13","3","0.46296","262","324","-62"
"1934","Bowie St. (MD)","4","7","2","0.38462","116","94","22"
"1935","Florida Southern","7","12","1","0.37500","170","162","8"
"1936","Bowie St. (MD)","5","2","1","0.68750","154","97","57"
"1937","Bowie St. (MD)","6","3","0","0.66667","98","87","11"
"1938","West Alabama","7","5","0","0.58333","151","88","63"
"1939","Elizabeth City St. (NC)","7","13","0","0.35000","150","307","-157"
"1940","Elizabeth City St. (NC)","6","5","4","0.53333","128","67","61"
"1941","Arkansas-Pine Bluff","3","9","5","0.32353","178","223","-45"
"1942","Brevard College (NC)","10","6","2","0.61111","225","189","36"
"1943","Clark Atlanta (GA)","6","8","0","0.42857","127","206","-79"
"1944","Abilene Christian (TX)","9","11","1","0.45238","158","255","-97"
"1945","Benedict (SC)","10","15","2","0.40741","299","296","3"
"1946","Elizabeth City St. (NC)","7","20","3","0.28333","144","540","-396"
"1947","Clark Atlanta (GA)","3","6","2","0.36364","49","230","-181"
"1948","Virginia-Lynchburg","4","6","1","0.40909","77","302","-225"
"1949","Virginia-Lynchburg","0","3","1","0.12500","7","70","-63"
"1950","Virginia-Lynchburg","2","3","0","0.40000","53","98","-45"
"1951","Lane (TN)","8","6","0","0.57143","295","234","61"
"1952","Lane (TN)","9","5","1","0.63333","220","206","14"
"1953","Lane (TN)","1","7","0","0.12500","58","215","-157"
"1954","Lane (TN)","2","6","0","0.25000","105","135","-30"
"1955","Lane (TN)","2","4","0","0.33333","83","129","-46"
"1957","Louisiana College","2","7","0","0.22222","106","179","-73"
"1959","Azusa Pacific (CA)","2","3","0","0.40000","117","90","27"
"1960","Azusa Pacific (CA)","4","3","1","0.56250","103","76","27"
"1961","Azusa Pacific (CA)","3","3","0","0.50000","123","147","-24"
"1963","San Francisco (CA)","2","5","0","0.28571","58","98","-40"
"1964","New York (NY)","0","2","0","0.00000","20","48","-28"
"1965","Adelphi (NY)","4","8","0","0.33333","198","216","-18"
"1966","Fairfield (CT)","18","22","2","0.45238","545","652","-107"
"1967","La Salle (PA)","25","31","0","0.44643","846","1080","-234"
"1968","Centenary (LA)","17","42","2","0.29508","726","1393","-667"
"1969","Bluffton (OH)","33","43","0","0.43421","1058","1548","-490"
"1970","Saint John's (NY)","35","54","1","0.39444","1379","1783","-404"
"1971","Bluffton (OH)","43","45","1","0.48876","1360","1384","-24"
"1972","Marquette (WI)","39","44","2","0.47059","1217","1351","-134"
"1973","Brooklyn (NY)","30","52","1","0.36747","1007","1611","-604"
"1974","Marquette (WI)","33","36","3","0.47917","959","1169","-210"
"1975","Marquette (WI)","31","22","4","0.57895","1042","932","110"
"1976","Bluffton (OH)","23","33","1","0.41228","862","1186","-324"
"1977","Manhattan (NY)","14","28","1","0.33721","568","923","-355"
"1978","Fairfield (CT)","5","7","1","0.42308","194","203","-9"
"1979","Fairfield (CT)","7","8","0","0.46667","247","260","-13"
"1980","Westfield St. (MA)","6","5","4","0.53333","184","196","-12"
"1981","San Francisco (CA)","17","14","0","0.54839","567","498","69"
"1982","Manhattan (NY)","18","16","0","0.52941","580","644","-64"
"1983","SUNY-Stony Brook (NY)","15","11","0","0.57692","474","453","21"
"1984","Stonehill (MA)","7","12","0","0.36842","231","439","-208"
"1985","Manhattan (NY)","10","10","0","0.50000","313","316","-3"
"1986","Marquette (WI)","13","17","0","0.43333","497","564","-67"
"1987","Marquette (WI)","10","17","0","0.37037","389","487","-98"
"1988","Marquette (WI)","1","5","0","0.16667","80","125","-45"
"1989","Marquette (WI)","4","4","0","0.50000","209","151","58"
"1990","Marquette (WI)","1","7","0","0.12500","80","180","-100"
"1991","Marquette (WI)","1","5","0","0.16667","106","182","-76"
"1992","Marquette (WI)","2","5","0","0.28571","81","129","-48"
"1993","Marquette (WI)","7","1","0","0.87500","212","126","86"
"1994","Marquette (WI)","1","6","0","0.14286","125","184","-59"
"1995","Marquette (WI)","3","4","0","0.42857","141","191","-50"
"1996","Marquette (WI)","3","5","0","0.37500","139","182","-43"
"1998","Madison College (WI)","2","15","0","0.11765","221","613","-392"
"1999","Marquette (WI)","0","7","0","0.00000","110","298","-188"
"2000","Marquette (WI)","1","5","0","0.16667","60","96","-36"
"2001","Marquette (WI)","2","6","0","0.25000","144","179","-35"
"2002","Marquette (WI)","3","4","0","0.42857","127","208","-81"
"2003","Marquette (WI)","1","6","0","0.14286","71","151","-80"
"2004","Marquette (WI)","0","6","0","0.00000","53","238","-185"
"2005","Marquette (WI)","2","5","0","0.28571","92","226","-134"
"2006","Marquette (WI)","1","6","0","0.14286","62","206","-144"
"2007","Marquette (WI)","2","5","0","0.28571","140","215","-75"
"2008","Marquette (WI)","0","7","0","0.00000","61","304","-243"
"2009","Marquette (WI)","0","1","0","0.00000","0","22","-22"
"1924","Middle Tennessee St.","1","7","0","0.12500","26","160","-134"
"1925","Middle Tennessee St.","3","4","2","0.44444","104","121","-17"
"1926","Middle Tennessee St.","4","2","1","0.64286","102","124","-22"
"1927","Middle Tennessee St.","6","2","0","0.75000","197","54","143"
"1928","Middle Tennessee St.","3","4","1","0.43750","85","84","1"
"1929","Middle Tennessee St.","6","3","1","0.65000","85","92","-7"
"1930","Middle Tennessee St.","5","5","1","0.50000","127","98","29"
"1931","Middle Tennessee St.","6","4","0","0.60000","163","64","99"
"1932","Middle Tennessee St.","4","6","0","0.40000","63","117","-54"
"1933","Middle Tennessee St.","1","7","1","0.16667","44","194","-150"
"1934","Middle Tennessee St.","1","8","0","0.11111","32","99","-67"
"1939","Middle Tennessee St.","1","6","1","0.18750","39","125","-86"
"1943","Vanderbilt (TN)","5","0","0","1.00000","143","33","110"
"1940","Middle Tennessee St.","4","4","0","0.50000","107","71","36"
"1941","Middle Tennessee St.","4","3","1","0.56250","120","87","33"
"1942","Middle Tennessee St.","4","2","1","0.64286","106","77","29"
"1946","Middle Tennessee St.","6","2","1","0.72222","149","75","74"
"1947","Middle Tennessee St.","9","1","0","0.90000","226","61","165"
"1948","Middle Tennessee St.","5","5","0","0.50000","93","116","-23"
"1949","Middle Tennessee St.","8","0","1","0.94444","252","74","178"
"1950","Middle Tennessee St.","9","2","0","0.81818","303","139","164"
"1951","Middle Tennessee St.","7","2","2","0.72727","318","106","212"
"1952","Middle Tennessee St.","6","5","0","0.54545","214","194","20"
"1953","Middle Tennessee St.","7","4","0","0.63636","186","179","7"
"1954","Middle Tennessee St.","4","4","2","0.50000","153","156","-3"
"1955","Middle Tennessee St.","7","2","1","0.75000","187","205","-18"
"1956","Middle Tennessee St.","7","3","0","0.70000","202","132","70"
"1957","Middle Tennessee St.","10","0","0","1.00000","241","40","201"
"1958","Middle Tennessee St.","8","2","0","0.80000","196","77","119"
"1959","Middle Tennessee St.","10","0","1","0.95455","324","93","231"
"1960","Middle Tennessee St.","5","5","0","0.50000","115","126","-11"
"1961","Middle Tennessee St.","7","4","0","0.63636","201","128","73"
"1962","Middle Tennessee St.","6","4","0","0.60000","161","104","57"
"1963","Middle Tennessee St.","8","2","0","0.80000","213","106","107"
"1964","Middle Tennessee St.","8","2","1","0.77273","156","65","91"
"1965","Middle Tennessee St.","10","0","0","1.00000","286","157","129"
"1966","Middle Tennessee St.","7","3","0","0.70000","160","95","65"
"1967","Middle Tennessee St.","5","5","0","0.50000","236","231","5"
"1968","Middle Tennessee St.","2","8","0","0.20000","146","279","-133"
"1953","Shepherd (WV)","2","5","1","0.31250","82","126","-44"
"1954","Shepherd (WV)","5","2","1","0.68750","147","83","64"
"1955","Shepherd (WV)","8","0","0","1.00000","299","31","268"
"1969","Middle Tennessee St.","1","9","0","0.10000","134","216","-82"
"1970","Middle Tennessee St.","6","3","1","0.65000","167","105","62"
"1971","Middle Tennessee St.","7","4","0","0.63636","196","178","18"
"1972","Middle Tennessee St.","7","3","1","0.68182","216","172","44"
"1973","Middle Tennessee St.","4","7","0","0.36364","148","264","-116"
"1974","Middle Tennessee St.","3","8","0","0.27273","164","254","-90"
"1975","Middle Tennessee St.","4","7","0","0.36364","189","254","-65"
"1976","Middle Tennessee St.","4","7","0","0.36364","205","281","-76"
"1977","Middle Tennessee St.","3","8","0","0.27273","125","283","-158"
"1978","Middle Tennessee St.","1","9","1","0.13636","95","340","-245"
"1977","Austin Peay St. (TN)","8","3","0","0.72727","182","132","50"
"1978","Austin Peay St. (TN)","6","4","0","0.60000","151","143","8"
"1979","Middle Tennessee St.","1","9","0","0.10000","137","333","-196"
"1980","Middle Tennessee St.","2","8","0","0.20000","85","224","-139"
"1981","Middle Tennessee St.","6","5","0","0.54545","158","173","-15"
"1982","Middle Tennessee St.","8","3","0","0.72727","231","110","121"
"1983","Middle Tennessee St.","8","2","0","0.80000","296","111","185"
"1984","Middle Tennessee St.","11","3","0","0.78571","374","220","154"
"1985","Middle Tennessee St.","11","1","0","0.91667","388","173","215"
"1986","Middle Tennessee St.","6","5","0","0.54545","254","155","99"
"1987","Middle Tennessee St.","6","5","0","0.54545","248","160","88"
"1988","Middle Tennessee St.","7","4","0","0.63636","294","115","179"
"1989","Middle Tennessee St.","9","4","0","0.69231","318","225","93"
"1990","Middle Tennessee St.","11","2","0","0.84615","425","128","297"
"1991","Middle Tennessee St.","9","4","0","0.69231","345","193","152"
"1992","Middle Tennessee St.","10","3","0","0.76923","417","189","228"
"1993","Middle Tennessee St.","5","6","0","0.45455","354","235","119"
"1994","Middle Tennessee St.","8","3","1","0.70833","401","229","172"
"1995","Middle Tennessee St.","7","4","0","0.63636","303","201","102"
"1996","Middle Tennessee St.","6","5","0","0.54545","220","206","14"
"1997","Middle Tennessee St.","4","6","0","0.40000","292","244","48"
"1998","Middle Tennessee St.","5","5","0","0.50000","250","256","-6"
"1999","Middle Tennessee St.","3","8","0","0.27273","272","379","-107"
"2000","Middle Tennessee St.","6","5","0","0.54545","350","316","34"
"2001","Middle Tennessee St.","8","3","0","0.72727","408","286","122"
"2002","Middle Tennessee St.","4","8","0","0.33333","297","332","-35"
"2003","Middle Tennessee St.","4","8","0","0.33333","332","375","-43"
"2004","Middle Tennessee St.","5","6","0","0.45455","269","293","-24"
"2005","Middle Tennessee St.","4","7","0","0.36364","210","206","4"
"2006","Middle Tennessee St.","7","6","0","0.53846","296","302","-6"
"2007","Middle Tennessee St.","5","7","0","0.41667","308","339","-31"
"2008","Middle Tennessee St.","5","7","0","0.41667","274","299","-25"
"2009","Middle Tennessee St.","10","3","0","0.76923","416","308","108"
"2010","Middle Tennessee St.","6","7","0","0.46154","344","365","-21"
"2011","Middle Tennessee St.","2","10","0","0.16667","267","441","-174"
"2012","Middle Tennessee St.","8","4","0","0.66667","319","336","-17"
"2013","Middle Tennessee St.","8","5","0","0.61538","377","341","36"
"1883","Minnesota","1","2","0","0.33333","9","8","1"
"1885","Minnesota","0","2","0","0.00000","13","27","-14"
"1890","Kentucky","1","0","0","1.00000","8","2","6"
"1896","Saint John's (NY)","1","0","0","1.00000","6","0","6"
"1898","Emporia St. (KS)","0","2","0","0.00000","0","60","-60"
"1900","Boston College (MA)","1","0","0","1.00000","5","0","5"
"1901","Saint John's (NY)","0","1","0","0.00000","0","61","-61"
"1902","La Salle (PA)","0","4","0","0.00000","12","65","-53"
"1904","Louisiana-Lafayette","2","0","1","0.83333","28","4","24"
"1908","Saint John's (NY)","0","2","0","0.00000","0","18","-18"
"1909","North Carolina A&T","0","1","0","0.00000","0","11","-11"
"1910","Clarion (PA)","0","1","0","0.00000","0","39","-39"
"1917","Texas St.","1","0","0","1.00000","12","0","12"
"1924","Manhattan (NY)","4","4","0","0.50000","74","69","5"
"1929","Campbellsville (KY)","0","1","0","0.00000","6","54","-48"
"1943","William & Mary Freshmen (VA)","4","2","0","0.66667","157","56","101"
"1886","Minnesota","1","1","0","0.50000","16","26","-10"
"1887","Minnesota","2","0","0","1.00000","22","0","22"
"1888","Minnesota","1","1","0","0.50000","22","16","6"
"1889","Minnesota","3","1","0","0.75000","46","28","18"
"1890","Minnesota","5","1","1","0.78571","208","33","175"
"1891","Minnesota","3","1","1","0.70000","102","46","56"
"1869","Rutgers (NJ)","2","2","0","0.50000","18","18","0"
"1870","Rutgers (NJ)","2","2","0","0.50000","17","17","0"
"1872","Columbia (NY)","5","4","0","0.55556","22","16","6"
"1873","Rutgers (NJ)","7","4","1","0.62500","31","26","5"
"1874","Harvard (MA)","9","7","0","0.56250","54","41","13"
"1875","Harvard (MA)","12","6","2","0.65000","52","29","23"
"1876","Harvard (MA)","13","8","1","0.61364","45","29","16"
"1877","Harvard (MA)","9","7","3","0.55263","31","21","10"
"1878","Pennsylvania","14","9","5","0.58929","42","24","18"
"1879","Harvard (MA)","13","9","12","0.55882","46","27","19"
"1880","Harvard (MA)","18","11","4","0.60606","75","53","22"
"1881","Rutgers (NJ)","22","18","8","0.54167","70","47","23"
"1882","Rutgers (NJ)","41","28","2","0.59155","176","111","65"
"1883","Rutgers (NJ)","38","32","1","0.54225","1288","965","323"
"1884","Pennsylvania","47","29","5","0.61111","1728","1184","544"
"1885","Michigan","34","17","4","0.65455","1437","612","825"
"1886","Lehigh (PA)","48","21","4","0.68493","1850","637","1213"
"1887","California","67","35","3","0.65238","2660","935","1725"
"1888","Princeton (NJ)","70","56","6","0.55303","2468","1899","569"
"1889","Brown (RI)","82","51","11","0.60764","2879","1796","1083"
"1890","Brown (RI)","77","76","9","0.50309","3002","2455","547"
"1891","Southern California","94","76","13","0.54918","2813","2189","624"
"1892","Minnesota","93","80","9","0.53571","2972","2394","578"
"1893","Duke (NC)","79","94","9","0.45879","2176","2912","-736"
"1894","Colorado St.","50","62","4","0.44828","1161","1518","-357"
"1895","Boston (MA)","31","44","11","0.42442","692","1031","-339"
"1896","Rhode Island","54","62","12","0.46875","1126","1201","-75"
"1897","Boston (MA)","32","40","6","0.44872","792","785","7"
"1898","Miami (OH)","47","23","4","0.66216","921","644","277"
"1899","New Hampshire","33","32","6","0.50704","571","522","49"
"1900","New Hampshire","22","35","11","0.40441","442","686","-244"
"1901","Marshall (WV)","18","34","3","0.35455","302","917","-615"
"1902","Saint John's (MN)","9","22","4","0.31429","148","460","-312"
"1903","Wichita St. (KS)","14","25","2","0.36585","376","546","-170"
"1904","Oklahoma St.","11","14","1","0.44231","194","394","-200"
"1905","Miami (OH)","7","25","5","0.25676","245","494","-249"
"1906","Rensselaer Tech (NY)","3","7","4","0.35714","92","107","-15"
"1907","Marshall (WV)","5","10","2","0.35294","71","238","-167"
"1908","Fort Hays St. (KS)","5","6","1","0.45833","56","91","-35"
"1909","Fort Hays St. (KS)","1","3","1","0.30000","12","68","-56"
"1910","Texas St.","0","1","0","0.00000","0","19","-19"
"1912","Fort Hays St. (KS)","1","2","0","0.33333","20","132","-112"
"1913","Eureka (IL)","1","6","0","0.14286","39","203","-164"
"1914","Eureka (IL)","3","4","0","0.42857","57","201","-144"
"1915","Texas St.","1","1","1","0.50000","13","20","-7"
"1916","Texas St.","0","2","1","0.16667","0","106","-106"
"1917","Boston (MA)","4","4","0","0.50000","73","136","-63"
"1918","Monmouth (IL)","1","7","0","0.12500","26","137","-111"
"1930","Troy (AL)","1","2","0","0.33333","7","73","-66"
"2013","Grambling St. (LA)","0","1","0","0.00000","0","0","0"
"1893","Minnesota","7","0","0","1.00000","158","38","120"
"1894","Minnesota","3","1","0","0.75000","74","8","66"
"1893","California","4","1","1","0.75000","88","50","38"
"1894","Lehigh (PA)","5","9","0","0.35714","120","236","-116"
"1895","Minnesota","7","3","0","0.70000","136","58","78"
"1896","Minnesota","8","2","0","0.80000","168","24","144"
"1897","Minnesota","4","4","0","0.50000","112","77","35"
"1898","Minnesota","4","5","0","0.44444","92","73","19"
"1899","Minnesota","6","3","2","0.63636","149","79","70"
"1891","Army (NY)","4","1","1","0.75000","80","73","7"
"1900","Minnesota","10","0","2","0.91667","299","23","276"
"1901","Minnesota","9","1","1","0.86364","183","18","165"
"1902","Minnesota","9","2","1","0.79167","335","34","301"
"1903","Minnesota","14","0","1","0.96667","656","12","644"
"1904","Minnesota","13","0","0","1.00000","725","12","713"
"1905","Minnesota","11","1","0","0.91667","542","22","520"
"1906","Minnesota","4","1","0","0.80000","47","29","18"
"1907","Minnesota","2","2","1","0.50000","55","52","3"
"1908","Minnesota","3","2","1","0.58333","32","50","-18"
"1909","Minnesota","6","1","0","0.85714","158","27","131"
"1910","Minnesota","6","1","0","0.85714","179","6","173"
"1911","Minnesota","6","0","1","0.92857","102","15","87"
"1912","Minnesota","4","3","0","0.57143","87","38","49"
"1913","Minnesota","5","2","0","0.71429","116","32","84"
"1914","Minnesota","6","1","0","0.85714","123","44","79"
"1915","Minnesota","6","0","1","0.92857","191","35","156"
"1916","Minnesota","6","1","0","0.85714","348","28","320"
"1917","Minnesota","4","1","0","0.80000","164","25","139"
"1918","Minnesota","5","2","1","0.68750","133","39","94"
"1919","Minnesota","4","2","1","0.64286","130","45","85"
"1920","Minnesota","1","6","0","0.14286","62","92","-30"
"1921","Minnesota","3","4","0","0.42857","60","141","-81"
"1907","Western Michigan","3","2","1","0.58333","44","8","36"
"1908","Western Michigan","3","3","0","0.50000","33","98","-65"
"1909","Western Michigan","7","0","0","1.00000","194","9","185"
"1910","Western Michigan","4","1","1","0.75000","75","20","55"
"1911","Western Michigan","2","3","0","0.40000","110","59","51"
"1912","Western Michigan","3","2","1","0.58333","86","50","36"
"1913","Western Michigan","4","0","0","1.00000","59","15","44"
"1914","Western Michigan","6","0","0","1.00000","180","7","173"
"1915","Western Michigan","5","1","0","0.83333","291","43","248"
"1916","Western Michigan","5","1","0","0.83333","389","38","351"
"1917","Western Michigan","4","3","0","0.57143","203","105","98"
"1918","Western Michigan","3","2","0","0.60000","223","30","193"
"1919","Western Michigan","4","1","0","0.80000","156","91","65"
"1920","Western Michigan","3","4","0","0.42857","119","133","-14"
"1921","Western Michigan","6","2","0","0.75000","262","40","222"
"1922","Minnesota","3","3","1","0.50000","79","65","14"
"1923","Minnesota","5","1","1","0.78571","114","60","54"
"1924","Minnesota","3","3","2","0.50000","68","63","5"
"1925","UCLA","5","3","1","0.61111","91","130","-39"
"1926","UCLA","5","3","0","0.62500","153","67","86"
"1927","UCLA","6","2","1","0.72222","144","54","90"
"1928","UCLA","4","4","1","0.50000","171","136","35"
"1929","UCLA","4","4","0","0.50000","121","190","-69"
"1930","UCLA","3","5","0","0.37500","77","125","-48"
"1931","UCLA","3","4","1","0.43750","83","57","26"
"1932","UCLA","6","4","0","0.60000","149","61","88"
"1933","UCLA","5","4","1","0.55000","89","62","27"
"1934","UCLA","7","3","0","0.70000","146","69","77"
"1935","UCLA","8","2","0","0.80000","160","79","81"
"1936","UCLA","6","3","1","0.65000","143","91","52"
"1937","UCLA","2","6","1","0.27778","93","133","-40"
"1938","UCLA","7","4","1","0.62500","217","106","111"
"1917","Dartmouth (NH)","5","3","0","0.62500","83","68","15"
"1918","Dartmouth (NH)","3","3","0","0.50000","78","83","-5"
"1919","Dartmouth (NH)","6","1","1","0.81250","141","53","88"
"1920","Dartmouth (NH)","7","2","0","0.77778","199","68","131"
"1921","West Virginia","5","4","1","0.55000","161","82","79"
"1922","West Virginia","10","0","1","0.95455","267","34","233"
"1923","West Virginia","7","1","1","0.83333","297","41","256"
"1924","West Virginia","8","1","0","0.88889","282","47","235"
"1925","Minnesota","5","2","1","0.68750","176","91","85"
"1926","Minnesota","5","3","0","0.62500","269","57","212"
"1927","Minnesota","6","0","2","0.87500","209","51","158"
"1928","Minnesota","6","2","0","0.75000","182","36","146"
"1929","Minnesota","6","2","0","0.75000","179","55","124"
"1930","Oregon","7","2","0","0.77778","131","35","96"
"1931","Oregon","6","2","2","0.70000","90","87","3"
"1932","Wisconsin","6","1","1","0.81250","151","48","103"
"1933","Wisconsin","2","5","1","0.31250","54","79","-25"
"1934","Wisconsin","4","4","0","0.50000","48","84","-36"
"1935","Wisconsin","1","7","0","0.12500","53","171","-118"
"1936","Toledo (OH)","2","6","0","0.25000","94","58","36"
"1937","Toledo (OH)","6","3","0","0.66667","128","96","32"
"1938","Toledo (OH)","6","3","1","0.65000","156","83","73"
"1939","Toledo (OH)","7","3","0","0.70000","180","59","121"
"1940","Toledo (OH)","6","3","0","0.66667","146","78","68"
"1941","Toledo (OH)","7","4","0","0.63636","195","122","73"
"1942","Toledo (OH)","4","4","1","0.50000","91","114","-23"
"1943","Maryland","4","5","0","0.44444","105","194","-89"
"1944","Maryland","1","7","1","0.16667","46","170","-124"
"1930","Minnesota","3","4","1","0.43750","126","81","45"
"1931","Minnesota","7","3","0","0.70000","191","72","119"
"1932","Princeton (NJ)","2","2","3","0.50000","96","41","55"
"1933","Princeton (NJ)","9","0","0","1.00000","217","8","209"
"1934","Princeton (NJ)","7","1","0","0.87500","280","38","242"
"1935","Princeton (NJ)","9","0","0","1.00000","256","32","224"
"1936","Princeton (NJ)","4","2","2","0.62500","145","80","65"
"1937","Princeton (NJ)","4","4","0","0.50000","96","126","-30"
"1938","Michigan","6","1","1","0.81250","131","40","91"
"1939","Michigan","6","2","0","0.75000","219","94","125"
"1940","Michigan","7","1","0","0.87500","196","34","162"
"1941","Michigan","6","1","1","0.81250","147","41","106"
"1942","Michigan","7","3","0","0.70000","221","134","87"
"1943","Michigan","8","1","0","0.88889","302","73","229"
"1944","Michigan","8","2","0","0.80000","204","91","113"
"1945","Michigan","7","3","0","0.70000","187","99","88"
"1946","Michigan","6","2","1","0.72222","233","73","160"
"1947","Michigan","10","0","0","1.00000","394","53","341"
"1919","Montana","2","3","2","0.42857","80","121","-41"
"1920","Montana","4","3","0","0.57143","227","92","135"
"1921","Montana","3","3","1","0.50000","66","90","-24"
"1925","Mississippi St.","3","4","1","0.43750","101","60","41"
"1926","Mississippi St.","5","4","0","0.55556","134","98","36"
"1927","Tulane (LA)","2","5","1","0.31250","56","120","-64"
"1928","Tulane (LA)","6","3","1","0.65000","264","76","188"
"1929","Tulane (LA)","9","0","0","1.00000","279","45","234"
"1930","Tulane (LA)","8","1","0","0.88889","263","30","233"
"1931","Tulane (LA)","11","1","0","0.91667","350","56","294"
"1932","Minnesota","5","3","0","0.62500","86","42","44"
"1933","Minnesota","4","0","4","0.75000","64","32","32"
"1934","Minnesota","8","0","0","1.00000","270","38","232"
"1935","Minnesota","8","0","0","1.00000","194","46","148"
"1936","Minnesota","7","1","0","0.87500","203","32","171"
"1937","Minnesota","6","2","0","0.75000","184","50","134"
"1938","Minnesota","6","2","0","0.75000","97","38","59"
"1939","Minnesota","3","4","1","0.43750","154","82","72"
"1940","Minnesota","8","0","0","1.00000","154","71","83"
"1941","Minnesota","8","0","0","1.00000","186","38","148"
"1945","Minnesota","4","5","0","0.44444","177","155","22"
"1946","Minnesota","5","4","0","0.55556","130","114","16"
"1947","Minnesota","6","3","0","0.66667","174","127","47"
"1948","Minnesota","7","2","0","0.77778","203","94","109"
"1949","Minnesota","7","2","0","0.77778","231","80","151"
"1950","Minnesota","1","7","1","0.16667","79","196","-117"
"1926","Colgate (NY)","5","2","2","0.66667","218","58","160"
"1927","Colgate (NY)","4","2","3","0.61111","99","33","66"
"1942","Minnesota","5","4","0","0.55556","152","91","61"
"1943","Minnesota","5","4","0","0.55556","170","184","-14"
"1944","Minnesota","5","3","1","0.61111","225","162","63"
"1946","Pittsburgh (PA)","3","5","1","0.38889","88","136","-48"
"1947","Ohio St.","2","6","1","0.27778","60","150","-90"
"1948","Ohio St.","6","3","0","0.66667","184","94","90"
"1949","Ohio St.","7","1","2","0.80000","207","136","71"
"1950","Ohio St.","6","3","0","0.66667","286","111","175"
"1951","Minnesota","2","6","1","0.27778","162","258","-96"
"1952","Minnesota","4","3","2","0.55556","131","171","-40"
"1953","Minnesota","4","4","1","0.50000","150","160","-10"
"1952","Mississippi St.","5","4","0","0.55556","225","186","39"
"1953","Mississippi St.","5","2","3","0.65000","196","119","77"
"1954","Minnesota","7","2","0","0.77778","195","127","68"
"1955","Minnesota","3","6","0","0.33333","110","172","-62"
"1956","Minnesota","6","1","2","0.77778","127","87","40"
"1957","Minnesota","4","5","0","0.44444","201","188","13"
"1958","Minnesota","1","8","0","0.11111","115","157","-42"
"1959","Minnesota","2","7","0","0.22222","98","159","-61"
"1960","Minnesota","8","2","0","0.80000","228","88","140"
"1961","Minnesota","8","2","0","0.80000","161","78","83"
"1962","Minnesota","6","2","1","0.72222","131","61","70"
"1963","Minnesota","3","6","0","0.33333","95","117","-22"
"1964","Minnesota","5","4","0","0.55556","136","131","5"
"1965","Minnesota","5","4","1","0.55000","188","160","28"
"1966","Minnesota","4","5","1","0.45000","124","160","-36"
"1967","Minnesota","8","2","0","0.80000","163","106","57"
"1968","Minnesota","6","4","0","0.60000","207","190","17"
"1969","Minnesota","4","5","1","0.45000","210","260","-50"
"1970","Minnesota","3","6","1","0.35000","180","237","-57"
"1971","Minnesota","4","7","0","0.36364","212","278","-66"
"1969","Wake Forest (NC)","3","7","0","0.30000","125","279","-154"
"1970","Wake Forest (NC)","6","5","0","0.54545","191","241","-50"
"1971","Wake Forest (NC)","6","5","0","0.54545","218","178","40"
"1972","Minnesota","4","7","0","0.36364","185","304","-119"
"1973","Minnesota","7","4","0","0.63636","260","295","-35"
"1974","Minnesota","4","7","0","0.36364","161","332","-171"
"1975","Minnesota","6","5","0","0.54545","236","192","44"
"1976","Minnesota","6","5","0","0.54545","201","211","-10"
"1977","Minnesota","7","5","0","0.58333","171","180","-9"
"1978","Minnesota","5","6","0","0.45455","210","267","-57"
"1966","South Dakota","5","5","0","0.50000","225","160","65"
"1967","South Dakota","2","8","0","0.20000","127","226","-99"
"1968","South Dakota","9","1","0","0.90000","299","173","126"
"1969","South Dakota","3","7","0","0.30000","208","228","-20"
"1970","South Dakota","4","4","2","0.50000","290","227","63"
"1971","South Dakota","3","7","0","0.30000","172","191","-19"
"1972","South Dakota","9","1","0","0.90000","296","144","152"
"1973","South Dakota","8","3","0","0.72727","347","193","154"
"1974","South Dakota","8","3","0","0.72727","297","198","99"
"1975","Northern Arizona","1","9","0","0.10000","155","268","-113"
"1976","Northern Arizona","8","3","0","0.72727","249","184","65"
"1977","Northern Arizona","9","3","0","0.75000","324","204","120"
"1978","Northern Arizona","8","2","0","0.80000","259","174","85"
"1979","Minnesota","4","6","1","0.40909","264","271","-7"
"1980","Minnesota","5","6","0","0.45455","210","250","-40"
"1981","Minnesota","6","5","0","0.54545","274","264","10"
"1982","Minnesota","3","8","0","0.27273","247","295","-48"
"1983","Minnesota","1","10","0","0.09091","181","518","-337"
"1969","William & Mary (VA)","3","7","0","0.30000","146","250","-104"
"1970","William & Mary (VA)","5","7","0","0.41667","218","335","-117"
"1971","William & Mary (VA)","5","6","0","0.45455","278","241","37"
"1972","North Carolina St.","8","3","1","0.70833","409","240","169"
"1973","North Carolina St.","9","3","0","0.75000","396","251","145"
"1974","North Carolina St.","9","2","1","0.79167","317","241","76"
"1975","North Carolina St.","7","4","1","0.62500","260","210","50"
"1977","Arkansas","11","1","0","0.91667","389","101","288"
"1978","Arkansas","9","2","1","0.79167","336","147","189"
"1979","Arkansas","10","2","0","0.83333","284","132","152"
"1980","Arkansas","7","5","0","0.58333","272","236","36"
"1981","Arkansas","8","4","0","0.66667","325","219","106"
"1982","Arkansas","9","2","1","0.79167","303","139","164"
"1983","Arkansas","6","5","0","0.54545","204","172","32"
"1984","Minnesota","4","7","0","0.36364","194","316","-122"
"1985","Minnesota","6","5","0","0.54545","273","227","46"
"1986","Notre Dame (IN)","5","6","0","0.45455","299","219","80"
"1987","Notre Dame (IN)","8","4","0","0.66667","339","218","121"
"1988","Notre Dame (IN)","12","0","0","1.00000","393","156","237"
"1989","Notre Dame (IN)","12","1","0","0.92308","427","189","238"
"1990","Notre Dame (IN)","9","3","0","0.75000","359","259","100"
"1991","Notre Dame (IN)","10","3","0","0.76923","465","289","176"
"1992","Notre Dame (IN)","10","1","1","0.87500","437","181","256"
"1993","Notre Dame (IN)","11","1","0","0.91667","427","215","212"
"1994","Notre Dame (IN)","6","5","1","0.54167","342","280","62"
"1995","Notre Dame (IN)","9","3","0","0.75000","392","247","145"
"1996","Notre Dame (IN)","8","3","0","0.72727","407","181","226"
"1999","South Carolina","0","11","0","0.00000","87","278","-191"
"2000","South Carolina","8","4","0","0.66667","283","181","102"
"2001","South Carolina","9","3","0","0.75000","310","230","80"
"2002","South Carolina","5","7","0","0.41667","225","262","-37"
"2003","South Carolina","5","7","0","0.41667","268","314","-46"
"2004","South Carolina","6","5","0","0.54545","243","229","14"
"1985","Minnesota","1","0","0","1.00000","20","13","7"
"1986","Minnesota","6","6","0","0.50000","261","316","-55"
"1987","Minnesota","6","5","0","0.54545","257","262","-5"
"1988","Minnesota","2","7","2","0.27273","195","246","-51"
"1989","Minnesota","6","5","0","0.54545","263","283","-20"
"1990","Minnesota","6","5","0","0.54545","224","281","-57"
"1991","Minnesota","2","9","0","0.18182","104","302","-198"
"1976","North Dakota St.","9","3","0","0.75000","221","125","96"
"1977","North Dakota St.","9","2","1","0.79167","374","163","211"
"1978","North Dakota St.","6","4","0","0.60000","308","187","121"
"1979","Texas St.","7","4","0","0.63636","271","202","69"
"1980","Texas St.","8","3","0","0.72727","356","140","216"
"1981","Texas St.","13","1","0","0.92857","554","138","416"
"1982","Texas St.","14","0","0","1.00000","446","199","247"
"1983","Texas Christian","1","8","2","0.18182","174","252","-78"
"1984","Texas Christian","8","4","0","0.66667","376","280","96"
"1985","Texas Christian","3","8","0","0.27273","150","383","-233"
"1986","Texas Christian","3","8","0","0.27273","259","376","-117"
"1987","Texas Christian","5","6","0","0.45455","261","226","35"
"1988","Texas Christian","4","7","0","0.36364","206","286","-80"
"1989","Texas Christian","4","7","0","0.36364","183","301","-118"
"1990","Texas Christian","5","6","0","0.45455","292","353","-61"
"1991","Texas Christian","7","4","0","0.63636","279","267","12"
"1992","Minnesota","2","9","0","0.18182","200","313","-113"
"1993","Minnesota","4","7","0","0.36364","253","354","-101"
"1994","Minnesota","3","8","0","0.27273","256","348","-92"
"1995","Minnesota","3","8","0","0.27273","272","368","-96"
"1996","Minnesota","4","7","0","0.36364","236","340","-104"
"1986","Kent St. (OH)","5","6","0","0.45455","179","288","-109"
"1987","Kent St. (OH)","7","4","0","0.63636","233","212","21"
"1988","Kansas","1","10","0","0.09091","189","496","-307"
"1989","Kansas","4","7","0","0.36364","248","383","-135"
"1990","Kansas","3","7","1","0.31818","213","365","-152"
"1991","Kansas","6","5","0","0.54545","313","244","69"
"1992","Kansas","8","4","0","0.66667","373","262","111"
"1993","Kansas","5","7","0","0.41667","242","256","-14"
"1994","Kansas","6","5","0","0.54545","314","242","72"
"1995","Kansas","10","2","0","0.83333","345","261","84"
"1996","Kansas","4","7","0","0.36364","300","358","-58"
"1997","Minnesota","3","9","0","0.25000","238","334","-96"
"1998","Minnesota","5","6","0","0.45455","229","249","-20"
"1999","Minnesota","8","4","0","0.66667","368","196","172"
"2000","Minnesota","6","6","0","0.50000","375","318","57"
"2001","Minnesota","4","7","0","0.36364","308","299","9"
"2002","Minnesota","8","5","0","0.61538","376","319","57"
"2003","Minnesota","10","3","0","0.76923","503","285","218"
"2004","Minnesota","7","5","0","0.58333","361","273","88"
"2005","Minnesota","7","5","0","0.58333","429","348","81"
"2006","Minnesota","6","7","0","0.46154","376","338","38"
"2007","Minnesota","1","11","0","0.08333","315","440","-125"
"2008","Minnesota","7","6","0","0.53846","302","322","-20"
"2009","Minnesota","6","7","0","0.46154","272","309","-37"
"2010","Minnesota","1","6","0","0.14286","174","222","-48"
"1993","Nevada","7","4","0","0.63636","419","315","104"
"1994","Nevada-Las Vegas","7","5","0","0.58333","315","329","-14"
"1995","Nevada-Las Vegas","2","9","0","0.18182","222","520","-298"
"1996","Nevada-Las Vegas","1","11","0","0.08333","276","551","-275"
"1997","Nevada-Las Vegas","3","8","0","0.27273","281","332","-51"
"1998","Nevada-Las Vegas","0","11","0","0.00000","156","389","-233"
"2010","Minnesota","2","3","0","0.40000","104","174","-70"
"1994","Saginaw Valley St. (MI)","6","4","0","0.60000","294","220","74"
"1995","Saginaw Valley St. (MI)","7","3","0","0.70000","359","234","125"
"1996","Saginaw Valley St. (MI)","7","3","0","0.70000","269","157","112"
"1997","Saginaw Valley St. (MI)","9","2","0","0.81818","457","209","248"
"1998","Saginaw Valley St. (MI)","9","2","0","0.81818","467","222","245"
"1999","Emporia St. (KS)","5","6","0","0.45455","299","247","52"
"2000","Emporia St. (KS)","6","5","0","0.54545","293","236","57"
"2001","Southern Illinois","1","10","0","0.09091","167","339","-172"
"2002","Southern Illinois","4","8","0","0.33333","414","360","54"
"2003","Southern Illinois","10","2","0","0.83333","437","229","208"
"2004","Southern Illinois","10","2","0","0.83333","511","158","353"
"2005","Southern Illinois","9","4","0","0.69231","449","298","151"
"2006","Southern Illinois","9","4","0","0.69231","448","256","192"
"2007","Southern Illinois","12","2","0","0.85714","530","243","287"
"2008","Northern Illinois","6","7","0","0.46154","314","234","80"
"2009","Northern Illinois","7","6","0","0.53846","372","281","91"
"2010","Northern Illinois","10","3","0","0.76923","492","248","244"
"2011","Minnesota","3","9","0","0.25000","221","380","-159"
"2012","Minnesota","6","7","0","0.46154","287","321","-34"
"2013","Minnesota","4","2","0","0.66667","191","124","67"
"2013","Minnesota","4","3","0","0.57143","143","165","-22"
"1893","Mississippi","4","1","0","0.80000","120","28","92"
"1894","Mississippi","6","1","0","0.85714","115","48","67"
"1895","Mississippi","2","1","0","0.66667","24","28","-4"
"1894","Beloit (WI)","6","3","0","0.66667","138","137","1"
"1895","Beloit (WI)","5","1","0","0.83333","230","56","174"
"1896","Mississippi","1","2","0","0.33333","24","22","2"
"1898","Beloit (WI)","4","5","1","0.45000","100","95","5"
"1899","Beloit (WI)","5","2","2","0.66667","136","82","54"
"1900","Beloit (WI)","7","1","2","0.80000","253","23","230"
"1901","Beloit (WI)","6","3","3","0.62500","182","162","20"
"1902","Beloit (WI)","2","5","0","0.28571","28","133","-105"
"1903","Beloit (WI)","3","7","0","0.30000","64","296","-232"
"1908","Morningside (IA)","2","4","1","0.35714","22","83","-61"
"1909","Morningside (IA)","4","3","1","0.56250","230","55","175"
"1910","Morningside (IA)","5","3","0","0.62500","82","47","35"
"1898","Mississippi","1","1","0","0.50000","18","16","2"
"1899","Mississippi","3","4","0","0.42857","44","47","-3"
"1900","Mississippi","0","3","0","0.00000","5","30","-25"
"1901","Mississippi","2","4","0","0.33333","34","129","-95"
"1902","Mississippi","4","3","0","0.57143","121","46","75"
"1903","Mississippi St.","3","0","2","0.80000","71","6","65"
"1904","Mississippi St.","2","5","0","0.28571","106","130","-24"
"1905","Mississippi St.","3","4","0","0.42857","98","94","4"
"1906","Mississippi St.","2","2","1","0.50000","101","45","56"
"1901","Alabama","2","1","2","0.60000","92","23","69"
"1902","Auburn (AL)","0","2","0","0.00000","5","28","-23"
"1903","Mississippi","2","1","1","0.62500","34","39","-5"
"1904","Mississippi","4","3","0","0.57143","185","106","79"
"1869","Rutgers (NJ)","2","2","0","0.50000","18","18","0"
"1870","Rutgers (NJ)","2","2","0","0.50000","17","17","0"
"1872","Columbia (NY)","5","4","0","0.55556","22","16","6"
"1873","Rutgers (NJ)","7","4","1","0.62500","31","26","5"
"1874","Harvard (MA)","9","7","0","0.56250","54","41","13"
"1875","Harvard (MA)","12","6","2","0.65000","52","29","23"
"1876","Harvard (MA)","13","8","1","0.61364","45","29","16"
"1877","Harvard (MA)","9","7","3","0.55263","31","21","10"
"1878","Pennsylvania","14","9","5","0.58929","42","24","18"
"1879","Harvard (MA)","13","9","12","0.55882","46","27","19"
"1880","Harvard (MA)","18","11","4","0.60606","75","53","22"
"1881","Rutgers (NJ)","22","18","8","0.54167","70","47","23"
"1882","Rutgers (NJ)","41","28","2","0.59155","176","111","65"
"1883","Rutgers (NJ)","38","32","1","0.54225","1288","965","323"
"1884","Pennsylvania","47","29","5","0.61111","1728","1184","544"
"1885","Michigan","34","17","4","0.65455","1437","612","825"
"1886","Lehigh (PA)","48","21","4","0.68493","1850","637","1213"
"1887","California","67","35","3","0.65238","2660","935","1725"
"1888","Princeton (NJ)","70","56","6","0.55303","2468","1899","569"
"1889","Brown (RI)","82","51","11","0.60764","2879","1796","1083"
"1890","Brown (RI)","77","76","9","0.50309","3002","2455","547"
"1891","Southern California","94","76","13","0.54918","2813","2189","624"
"1892","Minnesota","93","80","9","0.53571","2972","2394","578"
"1893","Duke (NC)","79","94","9","0.45879","2176","2912","-736"
"1894","Colorado St.","50","62","4","0.44828","1161","1518","-357"
"1895","Boston (MA)","31","44","11","0.42442","692","1031","-339"
"1896","Rhode Island","54","62","12","0.46875","1126","1201","-75"
"1897","Boston (MA)","32","40","6","0.44872","792","785","7"
"1898","Miami (OH)","47","23","4","0.66216","921","644","277"
"1899","New Hampshire","33","32","6","0.50704","571","522","49"
"1900","New Hampshire","22","35","11","0.40441","442","686","-244"
"1901","Marshall (WV)","18","34","3","0.35455","302","917","-615"
"1902","Saint John's (MN)","9","22","4","0.31429","148","460","-312"
"1903","Wichita St. (KS)","14","25","2","0.36585","376","546","-170"
"1904","Oklahoma St.","11","14","1","0.44231","194","394","-200"
"1905","Miami (OH)","7","25","5","0.25676","245","494","-249"
"1906","Rensselaer Tech (NY)","3","7","4","0.35714","92","107","-15"
"1907","Marshall (WV)","5","10","2","0.35294","71","238","-167"
"1908","Fort Hays St. (KS)","5","6","1","0.45833","56","91","-35"
"1909","Fort Hays St. (KS)","1","3","1","0.30000","12","68","-56"
"1910","Texas St.","0","1","0","0.00000","0","19","-19"
"1912","Fort Hays St. (KS)","1","2","0","0.33333","20","132","-112"
"1913","Eureka (IL)","1","6","0","0.14286","39","203","-164"
"1914","Eureka (IL)","3","4","0","0.42857","57","201","-144"
"1915","Texas St.","1","1","1","0.50000","13","20","-7"
"1916","Texas St.","0","2","1","0.16667","0","106","-106"
"1917","Boston (MA)","4","4","0","0.50000","73","136","-63"
"1918","Monmouth (IL)","1","7","0","0.12500","26","137","-111"
"1930","Troy (AL)","1","2","0","0.33333","7","73","-66"
"2013","Grambling St. (LA)","0","1","0","0.00000","0","0","0"
"1906","Mississippi","4","2","0","0.66667","71","64","7"
"1907","Mississippi","0","6","0","0.00000","6","195","-189"
"1908","Mississippi","3","5","0","0.37500","99","125","-26"
"1909","Mississippi","4","3","2","0.55556","99","49","50"
"1910","Mississippi","7","1","0","0.87500","144","9","135"
"1911","Mississippi","6","3","0","0.66667","184","55","129"
"1912","Mississippi","5","3","0","0.62500","127","100","27"
"1913","Mississippi","6","3","1","0.65000","139","79","60"
"1914","Mississippi","5","4","1","0.55000","110","125","-15"
"1920","Texas Christian","9","1","0","0.90000","170","109","61"
"1921","Texas Christian","6","3","1","0.65000","132","75","57"
"1923","California-Davis","2","7","0","0.22222","43","192","-149"
"1924","California-Davis","5","4","1","0.55000","123","104","19"
"1925","California-Davis","5","3","0","0.62500","81","98","-17"
"1926","California-Davis","2","6","1","0.27778","84","147","-63"
"1927","California-Davis","4","3","1","0.56250","84","82","2"
"1929","Loyola Marymount (CA)","6","3","0","0.66667","131","85","46"
"1915","Mississippi","2","6","0","0.25000","51","334","-283"
"1916","Mississippi","3","6","0","0.33333","128","188","-60"
"1917","Mississippi","1","4","1","0.25000","49","226","-177"
"1918","Mississippi","1","3","0","0.25000","39","53","-14"
"1922","Mississippi St.","3","4","2","0.44444","56","184","-128"
"1919","Mississippi","4","4","0","0.50000","105","128","-23"
"1920","Mississippi","4","3","0","0.57143","217","85","132"
"1921","Mississippi","3","6","0","0.33333","179","133","46"
"1922","Mississippi","4","5","1","0.45000","87","183","-96"
"1923","Mississippi","4","6","0","0.40000","81","145","-64"
"1926","Northern Illinois","5","1","1","0.78571","71","26","45"
"1927","Northern Illinois","1","4","1","0.25000","49","92","-43"
"1928","Northern Illinois","0","6","1","0.07143","12","139","-127"
"1924","Mississippi","4","5","0","0.44444","36","142","-106"
"1925","Kalamazoo (MI)","5","2","1","0.68750","123","25","98"
"1926","Kalamazoo (MI)","3","4","1","0.43750","71","70","1"
"1927","Kalamazoo (MI)","3","5","0","0.37500","78","70","8"
"1928","Kalamazoo (MI)","3","3","2","0.50000","49","149","-100"
"1929","Kalamazoo (MI)","1","4","3","0.31250","38","78","-40"
"1930","Kalamazoo (MI)","5","3","0","0.62500","94","98","-4"
"1931","Kalamazoo (MI)","5","4","0","0.55556","118","84","34"
"1932","Kalamazoo (MI)","4","3","1","0.56250","43","58","-15"
"1933","Kalamazoo (MI)","3","2","2","0.57143","67","50","17"
"1934","Kalamazoo (MI)","3","3","1","0.50000","32","51","-19"
"1935","Kalamazoo (MI)","2","3","2","0.42857","68","32","36"
"1936","Kalamazoo (MI)","7","0","1","0.93750","113","26","87"
"1937","Kalamazoo (MI)","7","1","0","0.87500","145","68","77"
"1938","Kalamazoo (MI)","3","4","1","0.43750","97","94","3"
"1939","Kalamazoo (MI)","3","5","0","0.37500","80","58","22"
"1940","Kalamazoo (MI)","1","6","1","0.18750","49","90","-41"
"1941","Kalamazoo (MI)","5","2","1","0.68750","68","38","30"
"1925","Mississippi","5","5","0","0.50000","147","87","60"
"1926","Mississippi","5","4","0","0.55556","113","110","3"
"1927","Mississippi","5","3","1","0.61111","177","80","97"
"1928","Mississippi","5","4","0","0.55556","156","121","35"
"1929","Mississippi","1","6","2","0.22222","73","222","-149"
"1930","Mississippi","3","5","1","0.38889","128","140","-12"
"1931","Mississippi","2","6","1","0.27778","73","210","-137"
"1932","Mississippi","5","6","0","0.45455","148","148","0"
"1933","Mississippi","6","3","2","0.63636","167","79","88"
"1934","Mississippi","4","5","1","0.45000","114","98","16"
"1935","Mississippi","9","3","0","0.75000","311","86","225"
"1936","Mississippi","5","5","2","0.50000","150","98","52"
"1937","Mississippi","4","5","1","0.45000","127","106","21"
"1928","Georgia","4","5","0","0.44444","122","113","9"
"1929","Georgia","6","4","0","0.60000","155","97","58"
"1930","Georgia","7","2","1","0.75000","185","71","114"
"1931","Georgia","8","2","0","0.80000","201","118","83"
"1932","Georgia","2","5","2","0.33333","122","116","6"
"1933","Georgia","8","2","0","0.80000","148","86","62"
"1934","Georgia","7","3","0","0.70000","141","56","85"
"1935","Georgia","6","4","0","0.60000","169","88","81"
"1936","Georgia","5","4","1","0.55000","115","159","-44"
"1937","Georgia","6","3","2","0.63636","151","64","87"
"1938","Mississippi","9","2","0","0.81818","232","120","112"
"1939","Mississippi","7","2","0","0.77778","230","64","166"
"1940","Mississippi","9","2","0","0.81818","251","100","151"
"1941","Mississippi","6","2","1","0.72222","131","67","64"
"1942","Mississippi","2","7","0","0.22222","132","163","-31"
"1944","Mississippi","2","6","0","0.25000","77","178","-101"
"1945","Mississippi","4","5","0","0.44444","100","183","-83"
"1924","Birmingham-Southern (AL)","4","4","1","0.50000","75","141","-66"
"1925","Birmingham-Southern (AL)","7","3","1","0.68182","215","135","80"
"1926","Birmingham-Southern (AL)","5","3","2","0.60000","202","101","101"
"1927","Birmingham-Southern (AL)","3","6","0","0.33333","88","120","-32"
"1929","Tennessee-Chattanooga","8","2","0","0.80000","165","100","65"
"1930","Tennessee-Chattanooga","5","3","2","0.60000","109","88","21"
"1946","Mississippi","2","7","0","0.22222","76","144","-68"
"1947","Alabama","8","3","0","0.72727","210","101","109"
"1948","Alabama","6","4","1","0.59091","228","170","58"
"1949","Alabama","6","3","1","0.65000","227","130","97"
"1950","Alabama","9","2","0","0.81818","328","107","221"
"1951","Alabama","5","6","0","0.45455","263","188","75"
"1952","Alabama","10","2","0","0.83333","325","139","186"
"1953","Alabama","6","3","3","0.62500","178","152","26"
"1954","Alabama","4","5","2","0.45455","123","104","19"
"1947","Mississippi","9","2","0","0.81818","269","110","159"
"1948","Mississippi","8","1","0","0.88889","226","93","133"
"1949","Mississippi","4","5","1","0.45000","246","243","3"
"1950","Mississippi","5","5","0","0.50000","207","183","24"
"1951","Mississippi","6","3","1","0.65000","254","157","97"
"1952","Mississippi","8","1","2","0.81818","244","120","124"
"1953","Mississippi","7","2","1","0.75000","236","113","123"
"1954","Mississippi","9","2","0","0.81818","283","68","215"
"1955","Mississippi","10","1","0","0.90909","265","110","155"
"1956","Mississippi","7","3","0","0.70000","207","82","125"
"1957","Mississippi","9","1","1","0.86364","271","59","212"
"1958","Mississippi","9","2","0","0.81818","222","68","154"
"1959","Mississippi","10","1","0","0.90909","350","21","329"
"1960","Mississippi","10","0","1","0.95455","280","70","210"
"1961","Mississippi","9","2","0","0.81818","333","52","281"
"1962","Mississippi","10","0","0","1.00000","247","53","194"
"1963","Mississippi","7","1","2","0.80000","214","45","169"
"1964","Mississippi","5","5","1","0.50000","217","127","90"
"1965","Mississippi","7","4","0","0.63636","179","115","64"
"1966","Mississippi","8","3","0","0.72727","170","65","105"
"1967","Mississippi","6","4","1","0.59091","181","165","16"
"1968","Mississippi","7","3","1","0.68182","212","197","15"
"1969","Mississippi","8","3","0","0.72727","334","162","172"
"1970","Mississippi","7","4","0","0.63636","313","255","58"
"1973","Mississippi","5","3","0","0.62500","165","137","28"
"1971","Mississippi","10","2","0","0.83333","363","222","141"
"1972","Mississippi","5","5","0","0.50000","192","142","50"
"1973","Mississippi","1","2","0","0.33333","37","40","-3"
"1978","Gardner-Webb (NC)","4","5","1","0.45000","160","154","6"
"1974","Mississippi","3","8","0","0.27273","135","241","-106"
"1975","Mississippi","6","5","0","0.54545","170","162","8"
"1976","Mississippi","6","5","0","0.54545","153","180","-27"
"1977","Mississippi","6","5","0","0.54545","208","196","12"
"1973","Vanderbilt (TN)","5","6","0","0.45455","181","262","-81"
"1974","Vanderbilt (TN)","7","3","2","0.66667","313","199","114"
"1975","Texas Tech","6","5","0","0.54545","272","251","21"
"1976","Texas Tech","10","2","0","0.83333","336","206","130"
"1977","Texas Tech","7","5","0","0.58333","299","246","53"
"1978","Mississippi","5","6","0","0.45455","181","240","-59"
"1979","Mississippi","4","7","0","0.36364","251","298","-47"
"1980","Mississippi","3","8","0","0.27273","263","266","-3"
"1981","Mississippi","4","6","1","0.40909","167","284","-117"
"1982","Mississippi","4","7","0","0.36364","208","262","-54"
"1983","Duke (NC)","3","8","0","0.27273","246","350","-104"
"1984","Duke (NC)","2","9","0","0.18182","128","301","-173"
"1985","Duke (NC)","4","7","0","0.36364","193","252","-59"
"1986","Duke (NC)","4","7","0","0.36364","200","284","-84"
"1974","Southeastern Louisiana","6","4","0","0.60000","217","197","20"
"1975","Southeastern Louisiana","4","7","0","0.36364","217","246","-29"
"1976","Southeastern Louisiana","9","1","1","0.86364","237","148","89"
"1977","Southeastern Louisiana","6","4","0","0.60000","189","135","54"
"1978","Southeastern Louisiana","7","3","1","0.68182","198","78","120"
"1979","Southeastern Louisiana","6","5","0","0.54545","191","135","56"
"1980","Louisiana Tech","5","6","0","0.45455","193","220","-27"
"1981","Louisiana Tech","4","6","1","0.40909","205","241","-36"
"1982","Louisiana Tech","10","3","0","0.76923","340","177","163"
"1983","Mississippi","7","5","0","0.58333","179","264","-85"
"1984","Mississippi","4","6","1","0.40909","194","203","-9"
"1985","Mississippi","4","6","1","0.40909","210","276","-66"
"1986","Mississippi","8","3","1","0.70833","240","167","73"
"1987","Mississippi","3","8","0","0.27273","223","309","-86"
"1988","Mississippi","5","6","0","0.45455","221","223","-2"
"1989","Mississippi","8","4","0","0.66667","309","314","-5"
"1990","Mississippi","9","3","0","0.75000","260","226","34"
"1991","Mississippi","5","6","0","0.45455","242","223","19"
"1992","Mississippi","9","3","0","0.75000","243","174","69"
"1993","Mississippi","6","5","0","0.54545","242","142","100"
"1983","New Mexico","6","6","0","0.50000","239","233","6"
"1984","New Mexico","4","8","0","0.33333","251","359","-108"
"1985","New Mexico","3","8","0","0.27273","289","415","-126"
"1986","New Mexico","4","8","0","0.33333","317","338","-21"
"1994","Mississippi","4","7","0","0.36364","246","205","41"
"1995","Mississippi","6","5","0","0.54545","209","208","1"
"1996","Mississippi","5","6","0","0.45455","203","270","-67"
"1997","Mississippi","8","4","0","0.66667","267","240","27"
"1998","Mississippi","6","5","0","0.54545","245","256","-11"
"1999","Auburn (AL)","5","6","0","0.45455","233","236","-3"
"2000","Auburn (AL)","9","4","0","0.69231","316","266","50"
"2001","Auburn (AL)","7","5","0","0.58333","254","281","-27"
"2002","Auburn (AL)","9","4","0","0.69231","388","231","157"
"2003","Auburn (AL)","8","5","0","0.61538","342","212","130"
"2004","Auburn (AL)","13","0","0","1.00000","417","147","270"
"2005","Auburn (AL)","9","3","0","0.75000","386","186","200"
"2006","Auburn (AL)","11","2","0","0.84615","322","181","141"
"2007","Auburn (AL)","9","4","0","0.69231","315","220","95"
"2008","Auburn (AL)","5","7","0","0.41667","208","216","-8"
"2010","Texas Tech","8","5","0","0.61538","430","402","28"
"2011","Texas Tech","5","7","0","0.41667","406","471","-65"
"2012","Texas Tech","7","5","0","0.58333","453","382","71"
"2013","Cincinnati (OH)","9","4","0","0.69231","417","273","144"
"1998","Mississippi","1","0","0","1.00000","35","18","17"
"1999","Mississippi","8","4","0","0.66667","323","228","95"
"2000","Mississippi","7","5","0","0.58333","352","329","23"
"2001","Mississippi","7","4","0","0.63636","391","310","81"
"2002","Mississippi","7","6","0","0.53846","351","331","20"
"2003","Mississippi","10","3","0","0.76923","442","285","157"
"2004","Mississippi","4","7","0","0.36364","215","278","-63"
"2008","Duke (NC)","4","8","0","0.33333","241","281","-40"
"2009","Duke (NC)","5","7","0","0.41667","302","340","-38"
"2010","Duke (NC)","3","9","0","0.25000","303","425","-122"
"2011","Duke (NC)","3","9","0","0.25000","270","374","-104"
"2012","Duke (NC)","6","7","0","0.46154","410","468","-58"
"2013","Duke (NC)","10","4","0","0.71429","459","373","86"
"2005","Mississippi","3","8","0","0.27273","148","245","-97"
"2006","Mississippi","4","8","0","0.33333","188","275","-87"
"2007","Mississippi","3","9","0","0.25000","241","342","-101"
"2013","Southern California","6","2","0","0.75000","241","171","70"
"1993","Murray St. (KY)","4","7","0","0.36364","201","279","-78"
"1994","Murray St. (KY)","5","6","0","0.45455","262","321","-59"
"1995","Murray St. (KY)","11","1","0","0.91667","455","149","306"
"1996","Murray St. (KY)","11","2","0","0.84615","463","206","257"
"1997","Boise St. (ID)","5","6","0","0.45455","285","358","-73"
"1998","Arkansas","9","3","0","0.75000","390","227","163"
"1999","Arkansas","8","4","0","0.66667","353","214","139"
"2000","Arkansas","6","6","0","0.50000","278","289","-11"
"2001","Arkansas","7","5","0","0.58333","294","279","15"
"2002","Arkansas","9","5","0","0.64286","370","277","93"
"2003","Arkansas","9","4","0","0.69231","436","305","131"
"2004","Arkansas","5","6","0","0.45455","328","270","58"
"2005","Arkansas","4","7","0","0.36364","283","271","12"
"2006","Arkansas","10","4","0","0.71429","404","256","148"
"2007","Arkansas","8","4","0","0.66667","478","307","171"
"2008","Mississippi","9","4","0","0.69231","417","247","170"
"2009","Mississippi","9","4","0","0.69231","384","230","154"
"2010","Mississippi","4","8","0","0.33333","367","422","-55"
"2011","Mississippi","2","10","0","0.16667","193","385","-192"
"2008","Lambuth (TN)","8","4","0","0.66667","522","356","166"
"2009","Lambuth (TN)","12","1","0","0.92308","495","231","264"
"2011","Arkansas St.","10","2","0","0.83333","402","232","170"
"2012","Mississippi","7","6","0","0.53846","409","359","50"
"2013","Mississippi","8","5","0","0.61538","390","308","82"
"1895","Mississippi St.","0","2","0","0.00000","0","37","-37"
"1896","Mississippi St.","0","4","0","0.00000","0","135","-135"
"1901","Mississippi St.","2","2","1","0.50000","34","74","-40"
"1902","Mississippi St.","1","4","1","0.25000","42","81","-39"
"1902","Mississippi","4","3","0","0.57143","121","46","75"
"1903","Mississippi St.","3","0","2","0.80000","71","6","65"
"1904","Mississippi St.","2","5","0","0.28571","106","130","-24"
"1905","Mississippi St.","3","4","0","0.42857","98","94","4"
"1906","Mississippi St.","2","2","1","0.50000","101","45","56"
"1907","Mississippi St.","6","3","0","0.66667","210","77","133"
"1908","Mississippi St.","3","4","0","0.42857","108","113","-5"
"1909","Mississippi St.","5","4","0","0.55556","150","44","106"
"1910","Mississippi St.","7","2","0","0.77778","219","36","183"
"1911","Mississippi St.","7","2","1","0.75000","206","29","177"
"1912","Mississippi St.","4","3","0","0.57143","102","75","27"
"1913","Mississippi St.","6","1","1","0.81250","156","47","109"
"1914","Mississippi St.","6","2","0","0.75000","289","38","251"
"1915","Mississippi St.","5","2","1","0.68750","110","36","74"
"1916","Mississippi St.","4","4","1","0.50000","125","60","65"
"1931","Indiana","3","5","2","0.40000","57","98","-41"
"1932","Indiana","3","4","1","0.43750","65","76","-11"
"1933","Indiana","1","5","2","0.25000","25","96","-71"
"1917","Mississippi St.","7","1","0","0.87500","184","39","145"
"1918","Mississippi St.","3","2","0","0.60000","65","13","52"
"1919","Mississippi St.","6","2","0","0.75000","158","34","124"
"1920","Mississippi St.","5","3","0","0.62500","112","68","44"
"1921","Mississippi St.","4","4","1","0.50000","111","125","-14"
"1917","Mississippi","1","4","1","0.25000","49","226","-177"
"1918","Mississippi","1","3","0","0.25000","39","53","-14"
"1922","Mississippi St.","3","4","2","0.44444","56","184","-128"
"1917","Virginia Military Institute","4","4","1","0.50000","162","114","48"
"1919","Sewanee (TN)","3","6","0","0.33333","81","132","-51"
"1920","Sewanee (TN)","4","3","1","0.56250","124","81","43"
"1923","Mississippi St.","5","2","2","0.66667","83","66","17"
"1924","Mississippi St.","5","4","0","0.55556","82","89","-7"
"1928","Colgate (NY)","6","3","0","0.66667","175","107","68"
"1929","Virginia","4","3","2","0.55556","129","139","-10"
"1930","Virginia","4","6","0","0.40000","144","215","-71"
"1919","Montana","2","3","2","0.42857","80","121","-41"
"1920","Montana","4","3","0","0.57143","227","92","135"
"1921","Montana","3","3","1","0.50000","66","90","-24"
"1925","Mississippi St.","3","4","1","0.43750","101","60","41"
"1926","Mississippi St.","5","4","0","0.55556","134","98","36"
"1927","Tulane (LA)","2","5","1","0.31250","56","120","-64"
"1928","Tulane (LA)","6","3","1","0.65000","264","76","188"
"1929","Tulane (LA)","9","0","0","1.00000","279","45","234"
"1930","Tulane (LA)","8","1","0","0.88889","263","30","233"
"1931","Tulane (LA)","11","1","0","0.91667","350","56","294"
"1932","Minnesota","5","3","0","0.62500","86","42","44"
"1933","Minnesota","4","0","4","0.75000","64","32","32"
"1934","Minnesota","8","0","0","1.00000","270","38","232"
"1935","Minnesota","8","0","0","1.00000","194","46","148"
"1936","Minnesota","7","1","0","0.87500","203","32","171"
"1937","Minnesota","6","2","0","0.75000","184","50","134"
"1938","Minnesota","6","2","0","0.75000","97","38","59"
"1939","Minnesota","3","4","1","0.43750","154","82","72"
"1940","Minnesota","8","0","0","1.00000","154","71","83"
"1941","Minnesota","8","0","0","1.00000","186","38","148"
"1945","Minnesota","4","5","0","0.44444","177","155","22"
"1946","Minnesota","5","4","0","0.55556","130","114","16"
"1947","Minnesota","6","3","0","0.66667","174","127","47"
"1948","Minnesota","7","2","0","0.77778","203","94","109"
"1949","Minnesota","7","2","0","0.77778","231","80","151"
"1950","Minnesota","1","7","1","0.16667","79","196","-117"
"1927","Mississippi St.","5","3","0","0.62500","93","54","39"
"1928","Mississippi St.","2","4","2","0.37500","70","166","-96"
"1929","Mississippi St.","1","5","2","0.25000","51","139","-88"
"1932","Northern Colorado","5","2","1","0.68750","79","51","28"
"1933","Northern Colorado","4","3","0","0.57143","74","48","26"
"1934","Northern Colorado","6","1","0","0.85714","148","31","117"
"1935","Northern Colorado","4","3","0","0.57143","69","65","4"
"1936","Northern Colorado","5","4","0","0.55556","104","127","-23"
"1937","Northern Colorado","2","6","0","0.25000","83","121","-38"
"1938","Northern Colorado","3","4","1","0.43750","82","85","-3"
"1939","Northern Colorado","4","4","0","0.50000","79","70","9"
"1940","Northern Colorado","2","5","1","0.31250","80","112","-32"
"1941","Northern Colorado","3","5","0","0.37500","59","112","-53"
"1942","Northern Colorado","4","5","0","0.44444","146","92","54"
"1945","Northern Colorado","4","3","0","0.57143","239","124","115"
"1946","Northern Colorado","6","3","0","0.66667","218","102","116"
"1947","Northern Colorado","4","4","1","0.50000","132","146","-14"
"1948","Northern Colorado","4","4","0","0.50000","99","151","-52"
"1949","Northern Colorado","0","8","0","0.00000","91","364","-273"
"1950","Northern Colorado","6","3","1","0.65000","181","131","50"
"1951","Northern Colorado","4","3","0","0.57143","174","98","76"
"1952","Northern Colorado","5","3","0","0.62500","237","148","89"
"1953","Northern Colorado","2","5","0","0.28571","68","107","-39"
"1930","Mississippi St.","2","7","0","0.22222","47","170","-123"
"1931","Mississippi St.","2","6","0","0.25000","47","187","-140"
"1932","Mississippi St.","3","5","0","0.37500","33","155","-122"
"1933","Mississippi St.","3","6","1","0.35000","69","149","-80"
"1934","Mississippi St.","4","6","0","0.40000","79","126","-47"
"1930","Army (NY)","9","1","1","0.86364","268","22","246"
"1931","Army (NY)","8","2","1","0.77273","296","72","224"
"1932","Army (NY)","8","2","0","0.80000","261","39","222"
"1935","Mississippi St.","8","3","0","0.72727","191","77","114"
"1936","Mississippi St.","7","3","1","0.68182","232","38","194"
"1937","Mississippi St.","5","4","1","0.55000","119","117","2"
"1938","Mississippi St.","4","6","0","0.40000","123","131","-8"
"1941","Yale (CT)","1","7","0","0.12500","54","136","-82"
"1937","Memphis (TN)","3","6","0","0.33333","117","99","18"
"1938","Memphis (TN)","10","0","0","1.00000","281","41","240"
"1939","Mississippi St.","8","2","0","0.80000","216","32","184"
"1940","Mississippi St.","10","0","1","0.95455","245","58","187"
"1941","Mississippi St.","8","1","1","0.85000","191","55","136"
"1942","Mississippi St.","8","2","0","0.80000","200","77","123"
"1944","Mississippi St.","6","2","0","0.75000","219","79","140"
"1945","Mississippi St.","6","3","0","0.66667","221","108","113"
"1946","Mississippi St.","8","2","0","0.80000","271","71","200"
"1947","Mississippi St.","7","3","0","0.70000","169","89","80"
"1948","Mississippi St.","4","4","1","0.50000","103","87","16"
"1942","Southeastern Louisiana","5","5","0","0.50000","242","152","90"
"1947","Virginia Military Institute","3","5","1","0.38889","120","152","-32"
"1948","Virginia Military Institute","6","3","0","0.66667","184","116","68"
"1949","Mississippi St.","0","8","1","0.05556","38","224","-186"
"1950","Mississippi St.","4","5","0","0.44444","169","137","32"
"1951","Mississippi St.","4","5","0","0.44444","82","127","-45"
"1952","Mississippi St.","5","4","0","0.55556","225","186","39"
"1953","Mississippi St.","5","2","3","0.65000","196","119","77"
"1954","Minnesota","7","2","0","0.77778","195","127","68"
"1955","Minnesota","3","6","0","0.33333","110","172","-62"
"1956","Minnesota","6","1","2","0.77778","127","87","40"
"1957","Minnesota","4","5","0","0.44444","201","188","13"
"1958","Minnesota","1","8","0","0.11111","115","157","-42"
"1959","Minnesota","2","7","0","0.22222","98","159","-61"
"1960","Minnesota","8","2","0","0.80000","228","88","140"
"1961","Minnesota","8","2","0","0.80000","161","78","83"
"1962","Minnesota","6","2","1","0.72222","131","61","70"
"1963","Minnesota","3","6","0","0.33333","95","117","-22"
"1964","Minnesota","5","4","0","0.55556","136","131","5"
"1965","Minnesota","5","4","1","0.55000","188","160","28"
"1966","Minnesota","4","5","1","0.45000","124","160","-36"
"1967","Minnesota","8","2","0","0.80000","163","106","57"
"1968","Minnesota","6","4","0","0.60000","207","190","17"
"1969","Minnesota","4","5","1","0.45000","210","260","-50"
"1970","Minnesota","3","6","1","0.35000","180","237","-57"
"1971","Minnesota","4","7","0","0.36364","212","278","-66"
"1954","Mississippi St.","6","4","0","0.60000","192","120","72"
"1955","Mississippi St.","6","4","0","0.60000","173","142","31"
"1956","Washington","5","5","0","0.50000","232","206","26"
"1957","Texas","6","4","1","0.59091","159","149","10"
"1958","Texas","7","3","0","0.70000","157","152","5"
"1959","Texas","9","2","0","0.81818","216","96","120"
"1960","Texas","7","3","1","0.68182","167","78","89"
"1961","Texas","10","1","0","0.90909","303","66","237"
"1962","Texas","9","1","1","0.86364","184","72","112"
"1963","Texas","11","0","0","1.00000","243","71","172"
"1964","Texas","10","1","0","0.90909","220","81","139"
"1965","Texas","6","4","0","0.60000","231","153","78"
"1966","Texas","7","4","0","0.63636","194","111","83"
"1967","Texas","6","4","0","0.60000","186","123","63"
"1968","Texas","9","1","1","0.86364","379","198","181"
"1969","Texas","11","0","0","1.00000","435","119","316"
"1970","Texas","10","1","0","0.90909","423","149","274"
"1971","Texas","8","3","0","0.72727","281","168","113"
"1972","Texas","10","1","0","0.90909","271","121","150"
"1973","Texas","8","3","0","0.72727","367","162","205"
"1974","Texas","8","4","0","0.66667","367","197","170"
"1975","Texas","10","2","0","0.83333","401","181","220"
"1976","Texas","5","5","1","0.50000","195","188","7"
"1956","Mississippi St.","4","6","0","0.40000","148","152","-4"
"1957","Mississippi St.","6","2","1","0.72222","175","100","75"
"1958","Mississippi St.","3","6","0","0.33333","127","129","-2"
"1959","Mississippi St.","2","7","0","0.22222","96","198","-102"
"1960","Mississippi St.","2","6","1","0.27778","101","119","-18"
"1961","Mississippi St.","5","5","0","0.50000","111","135","-24"
"1962","Mississippi St.","3","6","0","0.33333","76","132","-56"
"1963","Mississippi St.","7","2","2","0.72727","185","94","91"
"1964","Mississippi St.","4","6","0","0.40000","155","143","12"
"1965","Mississippi St.","4","6","0","0.40000","202","172","30"
"1966","Mississippi St.","2","8","0","0.20000","75","176","-101"
"1967","Mississippi St.","1","9","0","0.10000","49","259","-210"
"1968","Mississippi St.","0","8","2","0.10000","146","260","-114"
"1969","Mississippi St.","3","7","0","0.30000","193","385","-192"
"1970","Mississippi St.","6","5","0","0.54545","171","264","-93"
"1971","Mississippi St.","2","9","0","0.18182","120","311","-191"
"1972","Mississippi St.","4","7","0","0.36364","197","254","-57"
"1973","Mississippi St.","4","5","2","0.45455","219","255","-36"
"1974","Mississippi St.","9","3","0","0.75000","327","224","103"
"1975","Mississippi St.","2","9","0","0.18182","165","166","-1"
"1976","Mississippi St.","0","11","0","0.00000","269","178","91"
"1977","Mississippi St.","0","11","0","0.00000","193","227","-34"
"1978","Mississippi St.","6","5","0","0.54545","232","205","27"
"1981","North Texas","2","9","0","0.18182","111","235","-124"
"1972","Texas A&M","3","8","0","0.27273","165","243","-78"
"1973","Texas A&M","5","6","0","0.45455","292","231","61"
"1974","Texas A&M","8","3","0","0.72727","222","131","91"
"1975","Texas A&M","10","2","0","0.83333","265","124","141"
"1976","Texas A&M","10","2","0","0.83333","364","140","224"
"1977","Texas A&M","8","4","0","0.66667","350","304","46"
"1978","Texas A&M","4","2","0","0.66667","176","78","98"
"1979","Mississippi St.","3","8","0","0.27273","162","179","-17"
"1980","Mississippi St.","9","3","0","0.75000","301","247","54"
"1981","Mississippi St.","8","4","0","0.66667","212","137","75"
"1982","Mississippi St.","5","6","0","0.45455","252","244","8"
"1983","Mississippi St.","3","8","0","0.27273","196","279","-83"
"1984","Mississippi St.","4","7","0","0.36364","198","230","-32"
"1985","Mississippi St.","5","6","0","0.45455","257","288","-31"
"1986","Mississippi St.","6","5","0","0.54545","195","275","-80"
"1987","Mississippi St.","4","7","0","0.36364","169","259","-90"
"1988","Mississippi St.","1","10","0","0.09091","172","332","-160"
"1989","Mississippi St.","5","6","0","0.45455","205","207","-2"
"1990","Mississippi St.","5","6","0","0.45455","207","236","-29"
"1976","Washington St.","3","8","0","0.27273","240","331","-91"
"1977","Pittsburgh (PA)","9","2","1","0.79167","428","134","294"
"1978","Pittsburgh (PA)","8","4","0","0.66667","263","187","76"
"1979","Pittsburgh (PA)","11","1","0","0.91667","291","116","175"
"1980","Pittsburgh (PA)","11","1","0","0.91667","380","130","250"
"1981","Pittsburgh (PA)","11","1","0","0.91667","385","160","225"
"1982","Texas A&M","5","6","0","0.45455","286","314","-28"
"1983","Texas A&M","5","5","1","0.50000","218","174","44"
"1984","Texas A&M","6","5","0","0.54545","245","217","28"
"1985","Texas A&M","10","2","0","0.83333","375","196","179"
"1986","Texas A&M","9","3","0","0.75000","372","215","157"
"1987","Texas A&M","10","2","0","0.83333","313","168","145"
"1988","Texas A&M","7","5","0","0.58333","293","253","40"
"1991","Mississippi St.","7","5","0","0.58333","291","194","97"
"1992","Mississippi St.","7","5","0","0.58333","252","197","55"
"1993","Mississippi St.","4","5","2","0.45455","241","245","-4"
"1994","Mississippi St.","8","4","0","0.66667","373","262","111"
"1995","Mississippi St.","3","8","0","0.27273","261","357","-96"
"1996","Mississippi St.","5","6","0","0.45455","249","229","20"
"1997","Mississippi St.","7","4","0","0.63636","226","215","11"
"1998","Mississippi St.","8","5","0","0.61538","350","256","94"
"1999","Mississippi St.","10","2","0","0.83333","255","156","99"
"2000","Mississippi St.","8","4","0","0.66667","390","306","84"
"2001","Mississippi St.","3","8","0","0.27273","196","288","-92"
"2002","Mississippi St.","3","9","0","0.25000","227","339","-112"
"2003","Mississippi St.","2","10","0","0.16667","225","471","-246"
"2004","Mississippi St.","3","8","0","0.27273","173","280","-107"
"2005","Mississippi St.","3","8","0","0.27273","153","259","-106"
"2006","Mississippi St.","3","9","0","0.25000","221","309","-88"
"2007","Mississippi St.","8","5","0","0.61538","279","301","-22"
"2008","Mississippi St.","4","8","0","0.33333","183","296","-113"
"2009","Mississippi St.","5","7","0","0.41667","307","321","-14"
"2010","Mississippi St.","9","4","0","0.69231","377","258","119"
"2011","Mississippi St.","7","6","0","0.53846","329","256","73"
"2012","Mississippi St.","8","5","0","0.61538","383","303","80"
"2013","Mississippi St.","7","6","0","0.53846","360","299","61"
"1890","Missouri","2","1","0","0.66667","112","34","78"
"1891","Missouri","3","1","0","0.75000","106","28","78"
"1892","Missouri","1","2","0","0.33333","28","13","15"
"1893","Missouri","4","3","0","0.57143","154","136","18"
"1894","Missouri","4","3","0","0.57143","134","108","26"
"1896","Texas","4","5","2","0.45455","104","84","20"
"1897","Maine","1","2","0","0.33333","24","13","11"
"1893","Stanford (CA)","9","0","1","0.95000","290","17","273"
"1895","Missouri","7","1","0","0.87500","156","42","114"
"1896","Missouri","11","5","1","0.67647","319","94","225"
"1897","Missouri","5","6","0","0.45455","112","143","-31"
"1898","Missouri","4","4","1","0.50000","88","103","-15"
"1899","Missouri","9","2","0","0.81818","242","56","186"
"1902","Lafayette (PA)","8","3","0","0.72727","203","56","147"
"1903","Brown (RI)","5","4","1","0.55000","98","161","-63"
"1904","New York (NY)","3","6","0","0.33333","99","152","-53"
"1900","Missouri","4","4","1","0.50000","71","80","-9"
"1901","Missouri","2","6","1","0.27778","30","155","-125"
"1900","Notre Dame (IN)","6","3","1","0.65000","261","73","188"
"1901","Notre Dame (IN)","8","1","1","0.85000","145","19","126"
"1902","Missouri","5","3","0","0.62500","99","80","19"
"1903","Missouri","1","7","1","0.16667","46","83","-37"
"1904","Missouri","3","6","0","0.33333","50","130","-80"
"1905","Missouri","5","4","0","0.55556","94","79","15"
"1903","Drake (IA)","5","3","0","0.62500","170","93","77"
"1904","Drake (IA)","5","4","0","0.55556","213","165","48"
"1906","Missouri","5","2","1","0.68750","116","44","72"
"1907","Missouri","7","2","0","0.77778","278","41","237"
"1908","Missouri","6","2","0","0.75000","196","45","151"
"1903","Virginia Military Institute","2","1","0","0.66667","36","28","8"
"1904","Virginia Military Institute","3","5","0","0.37500","70","70","0"
"1906","Princeton (NJ)","9","0","1","0.95000","205","9","196"
"1907","Princeton (NJ)","7","2","0","0.77778","282","23","259"
"1908","Princeton (NJ)","5","2","3","0.65000","84","25","59"
"1909","Missouri","7","0","1","0.93750","86","36","50"
"1910","Princeton (NJ)","7","1","0","0.87500","101","5","96"
"1911","Princeton (NJ)","8","0","2","0.90000","179","15","164"
"1915","Swarthmore (PA)","5","3","0","0.62500","94","77","17"
"1916","Swarthmore (PA)","6","1","1","0.81250","94","45","49"
"1919","Princeton (NJ)","4","2","1","0.64286","94","54","40"
"1920","Princeton (NJ)","6","0","1","0.92857","144","23","121"
"1921","Princeton (NJ)","4","3","0","0.57143","91","45","46"
"1922","Princeton (NJ)","8","0","0","1.00000","127","34","93"
"1923","Princeton (NJ)","3","3","1","0.50000","73","73","0"
"1924","Princeton (NJ)","4","2","1","0.64286","112","48","64"
"1925","Princeton (NJ)","5","1","1","0.78571","125","44","81"
"1926","Princeton (NJ)","5","1","1","0.78571","90","54","36"
"1927","Princeton (NJ)","6","1","0","0.85714","151","31","120"
"1928","Princeton (NJ)","5","1","2","0.75000","143","29","114"
"1929","Princeton (NJ)","2","4","1","0.35714","66","67","-1"
"1930","Princeton (NJ)","1","5","1","0.21429","46","73","-27"
"1909","Penn St.","5","0","2","0.85714","166","11","155"
"1910","Missouri","4","2","2","0.62500","77","17","60"
"1911","Penn St.","8","0","1","0.94444","199","15","184"
"1912","Penn St.","8","0","0","1.00000","285","6","279"
"1913","Penn St.","2","6","0","0.25000","78","94","-16"
"1914","Penn St.","5","3","1","0.61111","121","52","69"
"1916","Syracuse (NY)","5","4","0","0.55556","276","87","189"
"1899","Albion (MI)","3","5","0","0.37500","70","94","-24"
"1900","Albion (MI)","6","1","2","0.77778","146","40","106"
"1901","Albion (MI)","7","4","1","0.62500","196","134","62"
"1902","Albion (MI)","5","6","0","0.45455","179","181","-2"
"1903","Michigan St.","6","1","1","0.81250","178","24","154"
"1904","Michigan St.","8","1","0","0.88889","380","16","364"
"1905","Michigan St.","10","2","0","0.83333","349","75","274"
"1906","Michigan St.","7","2","2","0.72727","195","28","167"
"1907","Michigan St.","4","2","1","0.64286","127","60","67"
"1908","Michigan St.","6","0","2","0.87500","205","22","183"
"1909","Michigan St.","9","1","0","0.90000","291","17","274"
"1910","Michigan St.","6","1","0","0.85714","168","8","160"
"1911","Missouri","2","4","2","0.37500","61","67","-6"
"1912","Missouri","5","3","0","0.62500","135","69","66"
"1913","Missouri","7","1","0","0.87500","193","67","126"
"1917","Michigan St.","0","9","0","0.00000","23","179","-156"
"1919","Michigan St.","4","4","1","0.50000","132","99","33"
"1922","California-Davis","3","4","2","0.44444","178","53","125"
"1906","Eastern Michigan","5","0","1","0.91667","52","11","41"
"1907","Eastern Michigan","3","2","0","0.60000","72","13","59"
"1908","Eastern Michigan","1","4","0","0.20000","15","40","-25"
"1914","Missouri","5","3","0","0.62500","128","48","80"
"1915","Missouri","2","5","1","0.31250","72","102","-30"
"1916","Missouri","6","1","1","0.81250","112","21","91"
"1917","Missouri","3","5","0","0.37500","98","124","-26"
"1919","Nebraska","3","3","2","0.50000","56","60","-4"
"1920","Nebraska","5","3","1","0.61111","151","84","67"
"1919","Missouri","5","1","2","0.75000","91","42","49"
"1921","Albion (MI)","6","2","0","0.75000","166","62","104"
"1922","Albion (MI)","5","2","2","0.66667","113","41","72"
"1923","Albion (MI)","7","2","0","0.77778","133","53","80"
"1920","Missouri","7","1","0","0.87500","156","61","95"
"1921","Missouri","6","2","0","0.75000","136","50","86"
"1922","Purdue (IN)","1","5","1","0.21429","36","126","-90"
"1923","Purdue (IN)","2","5","1","0.31250","65","106","-41"
"1924","Purdue (IN)","5","2","0","0.71429","137","46","91"
"1925","Purdue (IN)","3","4","1","0.43750","119","39","80"
"1926","Purdue (IN)","5","2","1","0.68750","146","67","79"
"1927","Purdue (IN)","6","2","0","0.75000","170","38","132"
"1928","Purdue (IN)","5","2","1","0.68750","143","41","102"
"1929","Purdue (IN)","8","0","0","1.00000","187","44","143"
"1930","Washington","5","4","0","0.55556","182","67","115"
"1931","Washington","5","3","1","0.61111","166","83","83"
"1932","Washington","6","2","2","0.70000","193","56","137"
"1933","Washington","5","4","0","0.55556","88","81","7"
"1934","Washington","6","1","1","0.81250","104","51","53"
"1935","Washington","5","3","0","0.62500","93","42","51"
"1936","Washington","7","2","1","0.75000","148","56","92"
"1937","Washington","7","2","2","0.72727","187","52","135"
"1938","Washington","3","5","1","0.38889","68","83","-15"
"1939","Washington","4","5","0","0.44444","77","93","-16"
"1940","Washington","7","2","0","0.77778","169","54","115"
"1941","Washington","5","4","0","0.55556","120","94","26"
"1942","Saint Mary's (CA)","6","3","1","0.65000","135","46","89"
"1943","Saint Mary's (CA)","2","5","0","0.28571","93","126","-33"
"1944","Saint Mary's (CA)","0","5","0","0.00000","14","148","-134"
"1945","Saint Mary's (CA)","7","2","0","0.77778","282","65","217"
"1946","Saint Mary's (CA)","6","3","0","0.66667","229","160","69"
"1947","Saint Mary's (CA)","3","7","0","0.30000","178","246","-68"
"1915","Alabama","6","2","0","0.75000","250","51","199"
"1916","Alabama","6","3","0","0.66667","156","62","94"
"1917","Alabama","5","2","1","0.68750","168","29","139"
"1920","Idaho","4","2","0","0.66667","75","48","27"
"1921","Idaho","4","3","1","0.56250","98","68","30"
"1922","Missouri","5","3","0","0.62500","98","90","8"
"1912","Howard Payne (TX)","2","3","1","0.41667","152","119","33"
"1913","Howard Payne (TX)","3","4","2","0.44444","79","66","13"
"1923","Missouri","2","3","3","0.43750","31","40","-9"
"1924","Missouri","7","2","0","0.77778","110","41","69"
"1925","Missouri","6","1","1","0.81250","110","44","66"
"1926","Missouri","5","1","2","0.75000","122","33","89"
"1927","Missouri","7","2","0","0.77778","129","90","39"
"1928","Missouri","4","4","0","0.50000","138","102","36"
"1929","Missouri","5","2","1","0.68750","78","28","50"
"1930","Missouri","2","5","2","0.33333","41","132","-91"
"1931","Missouri","2","8","0","0.20000","72","193","-121"
"1934","New Mexico","8","1","0","0.88889","251","73","178"
"1935","New Mexico","6","4","0","0.60000","145","102","43"
"1936","New Mexico","2","7","0","0.22222","71","95","-24"
"1939","Kansas","2","6","0","0.25000","47","107","-60"
"1940","Kansas","2","7","0","0.22222","75","183","-108"
"1941","Kansas","3","6","0","0.33333","74","222","-148"
"1942","Kansas","2","8","0","0.20000","77","248","-171"
"1932","Missouri","1","7","1","0.16667","32","184","-152"
"1933","Missouri","1","8","0","0.11111","58","193","-135"
"1934","Missouri","0","8","1","0.05556","25","172","-147"
"1943","Missouri","3","5","0","0.37500","170","142","28"
"1944","Missouri","3","5","2","0.40000","176","224","-48"
"1945","Missouri","6","4","0","0.60000","170","174","-4"
"1926","Truman St. (MO)","7","1","0","0.87500","228","54","174"
"1927","Truman St. (MO)","8","1","0","0.88889","268","50","218"
"1928","Truman St. (MO)","7","2","1","0.75000","183","29","154"
"1929","Truman St. (MO)","5","3","1","0.61111","114","67","47"
"1930","Truman St. (MO)","5","5","0","0.50000","95","131","-36"
"1931","Truman St. (MO)","6","1","1","0.81250","140","32","108"
"1932","Truman St. (MO)","8","0","0","1.00000","132","14","118"
"1933","Truman St. (MO)","9","0","0","1.00000","212","26","186"
"1934","Truman St. (MO)","8","0","0","1.00000","180","13","167"
"1935","Missouri","3","3","3","0.50000","97","77","20"
"1936","Missouri","6","2","1","0.72222","107","74","33"
"1937","Missouri","3","6","1","0.35000","42","64","-22"
"1938","Missouri","6","3","0","0.66667","111","82","29"
"1939","Missouri","8","2","0","0.80000","155","79","76"
"1940","Missouri","6","3","0","0.66667","213","125","88"
"1941","Missouri","8","2","0","0.80000","226","39","187"
"1942","Missouri","8","3","1","0.70833","288","107","181"
"1946","Missouri","5","4","1","0.55000","158","166","-8"
"1947","Missouri","6","4","0","0.60000","240","116","124"
"1948","Missouri","8","3","0","0.72727","331","161","170"
"1949","Missouri","7","4","0","0.63636","264","225","39"
"1950","Missouri","4","5","1","0.45000","166","215","-49"
"1951","Missouri","3","7","0","0.30000","169","292","-123"
"1952","Missouri","5","5","0","0.50000","147","159","-12"
"1953","Missouri","6","4","0","0.60000","130","116","14"
"1954","Missouri","4","5","1","0.45000","198","261","-63"
"1955","Missouri","1","9","0","0.10000","92","192","-100"
"1956","Missouri","4","5","1","0.45000","200","183","17"
"1957","Missouri","5","4","1","0.55000","149","157","-8"
"1958","Arkansas","4","6","0","0.40000","147","150","-3"
"1959","Arkansas","9","2","0","0.81818","163","101","62"
"1960","Arkansas","8","3","0","0.72727","185","87","98"
"1961","Arkansas","8","3","0","0.72727","183","97","86"
"1962","Arkansas","9","2","0","0.81818","299","115","184"
"1963","Arkansas","5","5","0","0.50000","179","96","83"
"1964","Arkansas","11","0","0","1.00000","231","64","167"
"1965","Arkansas","10","1","0","0.90909","331","118","213"
"1966","Arkansas","8","2","0","0.80000","218","73","145"
"1967","Arkansas","4","5","1","0.45000","200","149","51"
"1968","Arkansas","10","1","0","0.90909","350","189","161"
"1969","Arkansas","9","2","0","0.81818","353","103","250"
"1970","Arkansas","9","2","0","0.81818","402","144","258"
"1971","Arkansas","8","3","1","0.70833","356","169","187"
"1972","Arkansas","6","5","0","0.54545","228","227","1"
"1973","Arkansas","5","5","1","0.50000","124","184","-60"
"1974","Arkansas","6","4","1","0.59091","285","164","121"
"1975","Arkansas","10","2","0","0.83333","336","123","213"
"1976","Arkansas","5","5","1","0.50000","220","204","16"
"1955","Arizona St.","8","2","1","0.77273","343","107","236"
"1956","Arizona St.","9","1","0","0.90000","306","83","223"
"1957","Arizona St.","10","0","0","1.00000","397","66","331"
"1958","Missouri","5","4","1","0.55000","164","141","23"
"1959","Missouri","6","5","0","0.54545","125","124","1"
"1960","Missouri","11","0","0","1.00000","295","93","202"
"1961","Missouri","7","2","1","0.75000","124","57","67"
"1962","Missouri","8","1","2","0.81818","204","62","142"
"1963","Missouri","7","3","0","0.70000","151","86","65"
"1964","Missouri","6","3","1","0.65000","142","88","54"
"1965","Missouri","8","2","1","0.77273","223","101","122"
"1966","Missouri","6","3","1","0.65000","121","116","5"
"1967","Missouri","7","3","0","0.70000","134","76","58"
"1968","Missouri","8","3","0","0.72727","308","136","172"
"1969","Missouri","9","2","0","0.81818","365","191","174"
"1970","Missouri","5","6","0","0.45455","243","223","20"
"1975","Notre Dame (IN)","8","3","0","0.72727","244","144","100"
"1976","Notre Dame (IN)","9","3","0","0.75000","294","158","136"
"1977","Notre Dame (IN)","11","1","0","0.91667","420","139","281"
"1978","Notre Dame (IN)","9","3","0","0.75000","293","197","96"
"1979","Notre Dame (IN)","7","4","0","0.63636","243","197","46"
"1980","Notre Dame (IN)","9","2","1","0.79167","248","128","120"
"1971","Missouri","1","10","0","0.09091","93","260","-167"
"1972","Missouri","7","5","0","0.58333","219","311","-92"
"1973","Missouri","8","4","0","0.66667","219","152","67"
"1974","Missouri","7","4","0","0.63636","204","217","-13"
"1975","Missouri","6","5","0","0.54545","282","241","41"
"1976","Missouri","6","5","0","0.54545","246","241","5"
"1977","Missouri","4","7","0","0.36364","195","180","15"
"1977","Washington St.","7","4","0","0.63636","263","236","27"
"1978","Missouri","8","4","0","0.66667","368","236","132"
"1979","Missouri","7","5","0","0.58333","260","166","94"
"1980","Missouri","8","4","0","0.66667","332","175","157"
"1981","Missouri","8","4","0","0.66667","276","159","117"
"1982","Missouri","5","4","2","0.54545","207","196","11"
"1983","Missouri","7","5","0","0.58333","292","202","90"
"1984","Missouri","3","7","1","0.31818","310","301","9"
"1985","Missouri","1","10","0","0.09091","206","342","-136"
"1986","Missouri","3","8","0","0.27273","196","314","-118"
"1987","Missouri","5","6","0","0.45455","226","209","17"
"1988","Missouri","3","7","1","0.31818","234","330","-96"
"1997","Vanderbilt (TN)","3","8","0","0.27273","138","204","-66"
"1998","Vanderbilt (TN)","2","9","0","0.18182","142","369","-227"
"1999","Vanderbilt (TN)","5","6","0","0.45455","252","256","-4"
"2000","Vanderbilt (TN)","3","8","0","0.27273","193","273","-80"
"2001","Vanderbilt (TN)","2","9","0","0.18182","226","402","-176"
"1984","Massachusetts","3","8","0","0.27273","148","219","-71"
"1985","Massachusetts","7","4","0","0.63636","198","127","71"
"1986","Texas-El Paso","4","8","0","0.33333","309","391","-82"
"1987","Texas-El Paso","7","4","0","0.63636","309","234","75"
"1988","Texas-El Paso","10","3","0","0.76923","445","275","170"
"1989","Missouri","2","9","0","0.18182","171","363","-192"
"1990","Missouri","4","7","0","0.36364","278","360","-82"
"1991","Missouri","3","7","1","0.31818","223","403","-180"
"1992","Missouri","3","8","0","0.27273","214","269","-55"
"1993","Missouri","3","7","1","0.31818","192","344","-152"
"1976","Tulane (LA)","2","9","0","0.18182","149","228","-79"
"1977","Tulane (LA)","3","8","0","0.27273","181","289","-108"
"1978","Tulane (LA)","4","7","0","0.36364","183","211","-28"
"1979","Tulane (LA)","9","3","0","0.75000","320","179","141"
"1980","Arizona","5","6","0","0.45455","215","275","-60"
"1981","Arizona","6","5","0","0.54545","253","205","48"
"1982","Arizona","6","4","1","0.59091","311","219","92"
"1983","Arizona","7","3","1","0.68182","343","188","155"
"1984","Arizona","7","4","0","0.63636","272","192","80"
"1985","Arizona","8","3","1","0.70833","252","146","106"
"1986","Arizona","9","3","0","0.75000","352","204","148"
"1987","Southern California","8","4","0","0.66667","321","229","92"
"1988","Southern California","10","2","0","0.83333","370","184","186"
"1989","Southern California","9","2","1","0.79167","336","132","204"
"1990","Southern California","8","4","1","0.65385","348","274","74"
"1991","Southern California","3","8","0","0.27273","229","276","-47"
"1992","Southern California","6","5","1","0.54167","264","249","15"
"1994","Missouri","3","8","1","0.29167","208","325","-117"
"1995","Missouri","3","8","0","0.27273","186","311","-125"
"1996","Missouri","5","6","0","0.45455","278","376","-98"
"1997","Missouri","7","5","0","0.58333","392","367","25"
"1998","Missouri","8","4","0","0.66667","334","236","98"
"1999","Missouri","4","7","0","0.36364","224","371","-147"
"2000","Missouri","3","8","0","0.27273","255","348","-93"
"2011","Missouri","1","0","0","1.00000","31","27","4"
"1991","Toledo (OH)","5","5","1","0.50000","187","209","-22"
"1992","Toledo (OH)","8","3","0","0.72727","269","153","116"
"1993","Toledo (OH)","4","7","0","0.36364","252","270","-18"
"1994","Toledo (OH)","6","4","1","0.59091","352","324","28"
"1995","Toledo (OH)","11","0","1","0.95833","411","264","147"
"1996","Toledo (OH)","7","4","0","0.63636","210","259","-49"
"1997","Toledo (OH)","9","3","0","0.75000","356","268","88"
"1998","Toledo (OH)","7","5","0","0.58333","229","216","13"
"1999","Toledo (OH)","6","5","0","0.54545","293","229","64"
"2000","Toledo (OH)","10","1","0","0.90909","400","125","275"
"2001","Missouri","4","7","0","0.36364","240","330","-90"
"2002","Missouri","5","7","0","0.41667","360","352","8"
"2003","Missouri","8","5","0","0.61538","399","287","112"
"2004","Missouri","5","6","0","0.45455","256","215","41"
"2005","Missouri","7","5","0","0.58333","369","350","19"
"2006","Missouri","8","5","0","0.61538","391","254","137"
"2007","Missouri","12","2","0","0.85714","558","326","232"
"2008","Missouri","10","4","0","0.71429","591","381","210"
"2009","Missouri","8","5","0","0.61538","377","330","47"
"2010","Missouri","10","3","0","0.76923","388","209","179"
"2011","Missouri","7","5","0","0.58333","396","279","117"
"2012","Missouri","5","7","0","0.41667","309","341","-32"
"2013","Missouri","12","2","0","0.85714","548","323","225"
"1882","Navy (MD)","1","0","0","1.00000","2","0","2"
"1869","Rutgers (NJ)","2","2","0","0.50000","18","18","0"
"1870","Rutgers (NJ)","2","2","0","0.50000","17","17","0"
"1872","Columbia (NY)","5","4","0","0.55556","22","16","6"
"1873","Rutgers (NJ)","7","4","1","0.62500","31","26","5"
"1874","Harvard (MA)","9","7","0","0.56250","54","41","13"
"1875","Harvard (MA)","12","6","2","0.65000","52","29","23"
"1876","Harvard (MA)","13","8","1","0.61364","45","29","16"
"1877","Harvard (MA)","9","7","3","0.55263","31","21","10"
"1878","Pennsylvania","14","9","5","0.58929","42","24","18"
"1879","Harvard (MA)","13","9","12","0.55882","46","27","19"
"1880","Harvard (MA)","18","11","4","0.60606","75","53","22"
"1881","Rutgers (NJ)","22","18","8","0.54167","70","47","23"
"1882","Rutgers (NJ)","41","28","2","0.59155","176","111","65"
"1883","Rutgers (NJ)","38","32","1","0.54225","1288","965","323"
"1884","Pennsylvania","47","29","5","0.61111","1728","1184","544"
"1885","Michigan","34","17","4","0.65455","1437","612","825"
"1886","Lehigh (PA)","48","21","4","0.68493","1850","637","1213"
"1887","California","67","35","3","0.65238","2660","935","1725"
"1888","Princeton (NJ)","70","56","6","0.55303","2468","1899","569"
"1889","Brown (RI)","82","51","11","0.60764","2879","1796","1083"
"1890","Brown (RI)","77","76","9","0.50309","3002","2455","547"
"1891","Southern California","94","76","13","0.54918","2813","2189","624"
"1892","Minnesota","93","80","9","0.53571","2972","2394","578"
"1893","Duke (NC)","79","94","9","0.45879","2176","2912","-736"
"1894","Colorado St.","50","62","4","0.44828","1161","1518","-357"
"1895","Boston (MA)","31","44","11","0.42442","692","1031","-339"
"1896","Rhode Island","54","62","12","0.46875","1126","1201","-75"
"1897","Boston (MA)","32","40","6","0.44872","792","785","7"
"1898","Miami (OH)","47","23","4","0.66216","921","644","277"
"1899","New Hampshire","33","32","6","0.50704","571","522","49"
"1900","New Hampshire","22","35","11","0.40441","442","686","-244"
"1901","Marshall (WV)","18","34","3","0.35455","302","917","-615"
"1902","Saint John's (MN)","9","22","4","0.31429","148","460","-312"
"1903","Wichita St. (KS)","14","25","2","0.36585","376","546","-170"
"1904","Oklahoma St.","11","14","1","0.44231","194","394","-200"
"1905","Miami (OH)","7","25","5","0.25676","245","494","-249"
"1906","Rensselaer Tech (NY)","3","7","4","0.35714","92","107","-15"
"1907","Marshall (WV)","5","10","2","0.35294","71","238","-167"
"1908","Fort Hays St. (KS)","5","6","1","0.45833","56","91","-35"
"1909","Fort Hays St. (KS)","1","3","1","0.30000","12","68","-56"
"1910","Texas St.","0","1","0","0.00000","0","19","-19"
"1912","Fort Hays St. (KS)","1","2","0","0.33333","20","132","-112"
"1913","Eureka (IL)","1","6","0","0.14286","39","203","-164"
"1914","Eureka (IL)","3","4","0","0.42857","57","201","-144"
"1915","Texas St.","1","1","1","0.50000","13","20","-7"
"1916","Texas St.","0","2","1","0.16667","0","106","-106"
"1917","Boston (MA)","4","4","0","0.50000","73","136","-63"
"1918","Monmouth (IL)","1","7","0","0.12500","26","137","-111"
"1930","Troy (AL)","1","2","0","0.33333","7","73","-66"
"2013","Grambling St. (LA)","0","1","0","0.00000","0","0","0"
"1892","Navy (MD)","5","2","0","0.71429","146","64","82"
"1892","Lehigh (PA)","3","6","0","0.33333","91","164","-73"
"1893","Navy (MD)","5","3","0","0.62500","122","78","44"
"1894","New York (NY)","0","3","0","0.00000","0","60","-60"
"1895","Yale (CT)","13","0","2","0.93333","316","38","278"
"1894","Navy (MD)","4","1","2","0.71429","72","30","42"
"1895","Dartmouth (NH)","7","5","1","0.57692","184","99","85"
"1896","Dartmouth (NH)","5","2","1","0.68750","120","84","36"
"1897","Dartmouth (NH)","4","3","0","0.57143","164","77","87"
"1898","Dartmouth (NH)","5","6","0","0.45455","205","137","68"
"1899","Dartmouth (NH)","2","7","0","0.22222","70","95","-25"
"1895","Navy (MD)","5","2","0","0.71429","152","16","136"
"1893","Virginia","8","3","0","0.72727","244","78","166"
"1894","Virginia","8","2","0","0.80000","404","30","374"
"1896","Navy (MD)","5","3","0","0.62500","180","53","127"
"1896","William & Mary (VA)","0","2","0","0.00000","0","14","-14"
"1897","Navy (MD)","8","1","0","0.88889","111","34","77"
"1898","Navy (MD)","7","1","0","0.87500","130","56","74"
"1899","Navy (MD)","5","3","0","0.62500","94","27","67"
"1912","Hampton (VA)","4","1","0","0.80000","152","19","133"
"1898","California","8","0","2","0.90000","221","5","216"
"1899","California","7","1","1","0.83333","142","2","140"
"1900","Navy (MD)","6","3","0","0.66667","106","51","55"
"1902","Princeton (NJ)","8","1","0","0.88889","164","17","147"
"1901","Navy (MD)","6","4","1","0.59091","113","81","32"
"1902","Navy (MD)","2","7","1","0.25000","35","99","-64"
"1903","Princeton (NJ)","11","0","0","1.00000","259","6","253"
"1904","Princeton (NJ)","8","2","0","0.80000","181","34","147"
"1905","Princeton (NJ)","8","2","0","0.80000","229","45","184"
"1899","Stanford (CA)","2","5","2","0.33333","61","78","-17"
"1903","Navy (MD)","4","7","1","0.37500","77","130","-53"
"1904","Navy (MD)","7","2","1","0.75000","149","38","111"
"1905","Navy (MD)","10","1","1","0.87500","243","23","220"
"1906","Navy (MD)","8","2","2","0.75000","149","14","135"
"1907","Navy (MD)","9","2","1","0.79167","118","34","84"
"1908","Navy (MD)","9","2","1","0.79167","218","38","180"
"1909","Navy (MD)","4","3","1","0.56250","99","42","57"
"1910","Navy (MD)","8","0","1","0.94444","99","0","99"
"1911","Navy (MD)","6","0","3","0.83333","116","11","105"
"1912","Navy (MD)","6","3","0","0.66667","126","61","65"
"1913","Navy (MD)","7","1","1","0.83333","304","29","275"
"1914","Navy (MD)","6","3","0","0.66667","174","83","91"
"1915","Navy (MD)","3","5","1","0.38889","99","118","-19"
"1916","Navy (MD)","6","3","1","0.65000","199","76","123"
"1906","North Dakota St.","5","0","0","1.00000","236","4","232"
"1907","North Dakota St.","3","0","0","1.00000","164","10","154"
"1908","Washington","6","0","1","0.92857","128","15","113"
"1909","Washington","7","0","0","1.00000","214","6","208"
"1910","Washington","6","0","0","1.00000","150","8","142"
"1911","Washington","7","0","0","1.00000","277","9","268"
"1912","Washington","6","0","0","1.00000","190","17","173"
"1913","Washington","7","0","0","1.00000","266","20","246"
"1914","Washington","6","0","1","0.92857","242","13","229"
"1915","Washington","7","0","0","1.00000","274","14","260"
"1916","Washington","6","0","1","0.92857","189","16","173"
"1917","Navy (MD)","7","1","0","0.87500","442","23","419"
"1918","Navy (MD)","4","1","0","0.80000","283","20","263"
"1919","Navy (MD)","7","1","0","0.87500","298","18","280"
"1920","Cornell (NY)","6","2","0","0.75000","231","68","163"
"1921","Cornell (NY)","8","0","0","1.00000","392","21","371"
"1922","Cornell (NY)","8","0","0","1.00000","339","27","312"
"1923","Cornell (NY)","8","0","0","1.00000","320","33","287"
"1924","Cornell (NY)","4","4","0","0.50000","209","71","138"
"1925","Cornell (NY)","6","2","0","0.75000","258","83","175"
"1926","Cornell (NY)","6","1","1","0.81250","191","64","127"
"1927","Cornell (NY)","3","3","2","0.50000","136","121","15"
"1928","Cornell (NY)","3","3","2","0.50000","72","86","-14"
"1929","Cornell (NY)","6","2","0","0.75000","204","60","144"
"1930","Cornell (NY)","6","2","0","0.75000","273","63","210"
"1931","Cornell (NY)","7","1","0","0.87500","239","20","219"
"1932","Cornell (NY)","5","2","1","0.68750","174","39","135"
"1933","Cornell (NY)","4","3","0","0.57143","116","89","27"
"1934","Cornell (NY)","2","5","0","0.28571","55","114","-59"
"1935","Cornell (NY)","0","6","1","0.07143","59","201","-142"
"1936","Boston College (MA)","6","1","2","0.77778","109","55","54"
"1937","Boston College (MA)","4","4","1","0.50000","109","68","41"
"1938","Boston College (MA)","6","1","2","0.77778","186","87","99"
"1909","Lafayette (PA)","7","0","1","0.93750","176","6","170"
"1910","Lafayette (PA)","7","2","0","0.77778","135","21","114"
"1916","Pennsylvania","7","3","1","0.68182","120","57","63"
"1917","Pennsylvania","9","2","0","0.81818","245","71","174"
"1918","Pennsylvania","5","3","0","0.62500","119","71","48"
"1919","Pennsylvania","6","2","1","0.72222","283","40","243"
"1920","Navy (MD)","6","2","0","0.75000","164","43","121"
"1921","Navy (MD)","6","1","0","0.85714","147","13","134"
"1922","Navy (MD)","5","2","0","0.71429","185","37","148"
"1923","Navy (MD)","5","1","3","0.72222","168","62","106"
"1924","Navy (MD)","2","6","0","0.25000","91","79","12"
"1905","Yale (CT)","10","0","0","1.00000","226","4","222"
"1925","Navy (MD)","5","2","1","0.68750","134","81","53"
"1922","William & Mary (VA)","6","3","0","0.66667","171","80","91"
"1923","Indiana","3","4","0","0.42857","48","117","-69"
"1924","Indiana","4","4","0","0.50000","147","100","47"
"1925","Indiana","3","4","1","0.43750","102","115","-13"
"1926","Navy (MD)","9","0","1","0.95000","236","88","148"
"1927","Navy (MD)","6","3","0","0.66667","192","84","108"
"1928","Navy (MD)","5","3","1","0.61111","121","21","100"
"1929","Navy (MD)","6","2","2","0.70000","233","59","174"
"1930","Navy (MD)","6","5","0","0.54545","148","117","31"
"1931","California","8","2","0","0.80000","106","41","65"
"1932","California","7","3","2","0.66667","169","89","80"
"1933","California","6","3","2","0.63636","161","39","122"
"1934","California","6","6","0","0.50000","176","110","66"
"1931","Navy (MD)","5","5","1","0.50000","78","95","-17"
"1932","Navy (MD)","2","6","1","0.27778","67","80","-13"
"1933","Navy (MD)","5","4","0","0.55556","90","86","4"
"1934","Navy (MD)","8","1","0","0.88889","138","70","68"
"1935","Navy (MD)","5","4","0","0.55556","136","89","47"
"1936","Navy (MD)","6","3","0","0.66667","115","74","41"
"1946","Navy (MD)","1","8","0","0.11111","105","186","-81"
"1947","Navy (MD)","1","7","1","0.16667","86","165","-79"
"1951","Pittsburgh (PA)","3","7","0","0.30000","156","215","-59"
"1954","Pittsburgh (PA)","4","2","0","0.66667","69","82","-13"
"1937","Navy (MD)","4","4","1","0.50000","150","74","76"
"1938","Navy (MD)","4","3","2","0.55556","126","60","66"
"1939","Navy (MD)","3","5","1","0.38889","88","107","-19"
"1940","Navy (MD)","6","2","1","0.72222","106","46","60"
"1941","Navy (MD)","7","1","1","0.83333","192","34","158"
"1942","Navy (MD)","5","4","0","0.55556","82","58","24"
"1943","Navy (MD)","8","1","0","0.88889","237","80","157"
"1944","Navy (MD)","6","3","0","0.66667","236","88","148"
"1945","Navy (MD)","7","1","1","0.83333","220","65","155"
"1937","New Hampshire","7","1","0","0.87500","144","31","113"
"1938","New Hampshire","3","6","0","0.33333","42","112","-70"
"1939","New Hampshire","3","5","0","0.37500","71","126","-55"
"1940","New Hampshire","5","3","0","0.62500","121","86","35"
"1941","New Hampshire","4","3","1","0.56250","153","62","91"
"1946","Kansas","7","2","1","0.75000","157","145","12"
"1947","Kansas","8","1","2","0.81818","304","102","202"
"1948","Navy (MD)","0","8","1","0.05556","77","227","-150"
"1949","Navy (MD)","3","5","1","0.38889","151","238","-87"
"1950","Baylor (TX)","7","3","0","0.70000","183","128","55"
"1951","Baylor (TX)","8","2","1","0.77273","245","131","114"
"1952","Baylor (TX)","4","4","2","0.50000","187","181","6"
"1953","Baylor (TX)","7","3","0","0.70000","219","166","53"
"1954","Baylor (TX)","7","4","0","0.63636","250","174","76"
"1955","Baylor (TX)","5","5","0","0.50000","146","143","3"
"1950","Navy (MD)","3","6","0","0.33333","122","176","-54"
"1951","Navy (MD)","2","6","1","0.27778","132","155","-23"
"1952","Navy (MD)","6","2","1","0.72222","147","75","72"
"1953","Navy (MD)","4","3","2","0.55556","186","99","87"
"1954","Navy (MD)","8","2","0","0.80000","304","73","231"
"1955","Navy (MD)","6","2","1","0.72222","188","56","132"
"1956","Navy (MD)","6","1","2","0.77778","207","76","131"
"1957","Navy (MD)","9","1","1","0.86364","281","71","210"
"1958","Navy (MD)","6","3","0","0.66667","212","134","78"
"1959","Navy (MD)","5","4","1","0.55000","199","166","33"
"1960","Navy (MD)","9","2","0","0.81818","262","103","159"
"1961","Navy (MD)","7","3","0","0.70000","201","136","65"
"1962","Navy (MD)","5","5","0","0.50000","184","174","10"
"1963","Navy (MD)","9","2","0","0.81818","320","165","155"
"1964","Navy (MD)","3","6","1","0.35000","140","185","-45"
"1970","Temple (PA)","7","3","0","0.70000","190","151","39"
"1971","Temple (PA)","6","2","1","0.72222","248","136","112"
"1972","Temple (PA)","5","4","0","0.55556","164","176","-12"
"1973","Temple (PA)","9","1","0","0.90000","353","167","186"
"1974","Temple (PA)","8","2","0","0.80000","335","142","193"
"1975","Temple (PA)","6","5","0","0.54545","289","225","64"
"1976","Temple (PA)","4","6","0","0.40000","196","216","-20"
"1977","Temple (PA)","5","5","1","0.50000","229","286","-57"
"1978","Temple (PA)","7","3","1","0.68182","280","203","77"
"1979","Temple (PA)","10","2","0","0.83333","399","198","201"
"1980","Temple (PA)","4","7","0","0.36364","170","262","-92"
"1981","Temple (PA)","5","5","0","0.50000","181","195","-14"
"1982","Temple (PA)","4","7","0","0.36364","220","202","18"
"1960","George Washington (DC)","5","3","1","0.61111","128","111","17"
"1961","Virginia","4","6","0","0.40000","123","190","-67"
"1962","Virginia","5","5","0","0.50000","194","167","27"
"1963","Virginia","2","7","1","0.25000","76","169","-93"
"1964","Virginia","5","5","0","0.50000","163","214","-51"
"1965","Navy (MD)","4","4","2","0.50000","128","129","-1"
"1966","Navy (MD)","4","6","0","0.40000","147","152","-5"
"1967","Navy (MD)","5","4","1","0.55000","205","253","-48"
"1968","Navy (MD)","2","8","0","0.20000","136","303","-167"
"1964","Connecticut","4","4","1","0.50000","99","123","-24"
"1965","Connecticut","3","6","0","0.33333","100","116","-16"
"1969","Navy (MD)","1","9","0","0.10000","98","307","-209"
"1970","Navy (MD)","2","9","0","0.18182","131","327","-196"
"1971","Navy (MD)","3","8","0","0.27273","146","331","-185"
"1972","Navy (MD)","4","7","0","0.36364","181","257","-76"
"1973","Navy (MD)","4","7","0","0.36364","221","232","-11"
"1974","Navy (MD)","4","7","0","0.36364","131","229","-98"
"1975","Navy (MD)","7","4","0","0.63636","227","125","102"
"1976","Navy (MD)","4","7","0","0.36364","187","257","-70"
"1977","Navy (MD)","5","6","0","0.45455","229","230","-1"
"1978","Navy (MD)","9","3","0","0.75000","260","136","124"
"1979","Navy (MD)","7","4","0","0.63636","180","154","26"
"1980","Navy (MD)","8","4","0","0.66667","226","146","80"
"1981","Navy (MD)","7","4","1","0.62500","244","183","61"
"1982","Virginia","2","9","0","0.18182","208","320","-112"
"1983","Virginia","6","5","0","0.54545","252","280","-28"
"1984","Virginia","8","2","2","0.75000","325","233","92"
"1985","Virginia","6","5","0","0.54545","262","217","45"
"1986","Virginia","3","8","0","0.27273","198","315","-117"
"1987","Virginia","8","4","0","0.66667","292","276","16"
"1988","Virginia","7","4","0","0.63636","251","244","7"
"1989","Virginia","10","3","0","0.76923","371","272","99"
"1990","Virginia","8","4","0","0.66667","464","227","237"
"1991","Virginia","8","3","1","0.70833","327","167","160"
"1992","Virginia","7","4","0","0.63636","341","229","112"
"1993","Virginia","7","5","0","0.58333","317","217","100"
"1994","Virginia","9","3","0","0.75000","370","195","175"
"1995","Virginia","9","4","0","0.69231","378","270","108"
"1996","Virginia","7","5","0","0.58333","341","203","138"
"1997","Virginia","7","4","0","0.63636","277","242","35"
"1998","Virginia","9","3","0","0.75000","358","247","111"
"1999","Virginia","7","5","0","0.58333","345","365","-20"
"2000","Virginia","6","6","0","0.50000","242","292","-50"
"1982","Navy (MD)","6","5","0","0.54545","220","196","24"
"1983","Navy (MD)","3","8","0","0.27273","202","272","-70"
"1984","Navy (MD)","4","6","1","0.40909","240","254","-14"
"1985","Navy (MD)","4","7","0","0.36364","253","239","14"
"1986","Navy (MD)","3","8","0","0.27273","238","306","-68"
"1975","Western Michigan","1","10","0","0.09091","119","297","-178"
"1976","Western Michigan","7","4","0","0.63636","270","202","68"
"1977","Western Michigan","4","7","0","0.36364","254","231","23"
"1978","Western Michigan","7","4","0","0.63636","220","152","68"
"1979","Western Michigan","6","5","0","0.54545","186","127","59"
"1980","Western Michigan","7","4","0","0.63636","233","179","54"
"1981","Western Michigan","6","5","0","0.54545","206","170","36"
"1987","Navy (MD)","2","9","0","0.18182","160","317","-157"
"1988","Navy (MD)","3","8","0","0.27273","221","274","-53"
"1989","Navy (MD)","3","8","0","0.27273","145","272","-127"
"1982","Indiana (PA)","4","6","0","0.40000","147","175","-28"
"1983","Indiana (PA)","5","5","0","0.50000","267","194","73"
"1984","Indiana (PA)","7","3","0","0.70000","302","163","139"
"1985","Indiana (PA)","8","2","1","0.77273","328","168","160"
"1986","Marshall (WV)","6","4","1","0.59091","287","199","88"
"1987","Marshall (WV)","10","5","0","0.66667","498","307","191"
"1988","Marshall (WV)","11","2","0","0.84615","370","234","136"
"1989","Marshall (WV)","6","5","0","0.54545","298","254","44"
"1990","Navy (MD)","5","6","0","0.45455","209","294","-85"
"1991","Navy (MD)","1","10","0","0.09091","160","321","-161"
"1992","Navy (MD)","1","10","0","0.09091","131","338","-207"
"1993","Navy (MD)","4","7","0","0.36364","203","307","-104"
"1994","Navy (MD)","3","8","0","0.27273","188","399","-211"
"1992","Utah St.","5","6","0","0.45455","300","328","-28"
"1993","Utah St.","7","5","0","0.58333","363","354","9"
"1994","Utah St.","3","8","0","0.27273","209","313","-104"
"1995","Navy (MD)","5","6","0","0.45455","223","189","34"
"1996","Navy (MD)","9","3","0","0.75000","392","309","83"
"1997","Navy (MD)","7","4","0","0.63636","398","209","189"
"1998","Navy (MD)","3","8","0","0.27273","255","376","-121"
"1999","Navy (MD)","5","7","0","0.41667","326","306","20"
"2000","Navy (MD)","1","10","0","0.09091","182","391","-209"
"2001","Navy (MD)","0","7","0","0.00000","122","242","-120"
"2003","Louisiana-Monroe","1","11","0","0.08333","239","467","-228"
"2004","Louisiana-Monroe","5","6","0","0.45455","211","303","-92"
"2005","Louisiana-Monroe","5","6","0","0.45455","239","339","-100"
"2006","Louisiana-Monroe","4","8","0","0.33333","262","267","-5"
"2007","Louisiana-Monroe","6","6","0","0.50000","282","332","-50"
"2008","Louisiana-Monroe","4","8","0","0.33333","284","374","-90"
"2009","Louisiana-Monroe","6","6","0","0.50000","307","328","-21"
"2001","Navy (MD)","0","3","0","0.00000","61","102","-41"
"1997","Georgia Southern","10","3","0","0.76923","423","229","194"
"1998","Georgia Southern","14","1","0","0.93333","654","363","291"
"1999","Georgia Southern","13","2","0","0.86667","747","262","485"
"2000","Georgia Southern","13","2","0","0.86667","506","274","232"
"2001","Georgia Southern","12","2","0","0.85714","525","215","310"
"2002","Navy (MD)","2","10","0","0.16667","290","436","-146"
"2003","Navy (MD)","8","5","0","0.61538","396","283","113"
"2004","Navy (MD)","10","2","0","0.83333","334","238","96"
"2005","Navy (MD)","8","4","0","0.66667","410","313","97"
"2006","Navy (MD)","9","4","0","0.69231","367","261","106"
"2007","Navy (MD)","8","4","0","0.66667","479","438","41"
"2008","Georgia Tech","9","4","0","0.69231","317","264","53"
"2009","Georgia Tech","10","3","0","0.76923","473","347","126"
"2010","Georgia Tech","6","7","0","0.46154","338","328","10"
"2011","Georgia Tech","8","5","0","0.61538","446","339","107"
"2012","Georgia Tech","7","7","0","0.50000","470","396","74"
"2013","Georgia Tech","7","6","0","0.53846","456","297","159"
"2007","Navy (MD)","0","1","0","0.00000","32","35","-3"
"2008","Navy (MD)","8","5","0","0.61538","353","286","67"
"2009","Navy (MD)","10","4","0","0.71429","392","272","120"
"2010","Navy (MD)","9","4","0","0.69231","386","303","83"
"2011","Navy (MD)","5","7","0","0.41667","356","347","9"
"2012","Navy (MD)","8","5","0","0.61538","325","334","-9"
"2013","Navy (MD)","9","4","0","0.69231","436","317","119"
"1890","Nebraska","2","0","0","1.00000","28","0","28"
"1869","Rutgers (NJ)","2","2","0","0.50000","18","18","0"
"1870","Rutgers (NJ)","2","2","0","0.50000","17","17","0"
"1872","Columbia (NY)","5","4","0","0.55556","22","16","6"
"1873","Rutgers (NJ)","7","4","1","0.62500","31","26","5"
"1874","Harvard (MA)","9","7","0","0.56250","54","41","13"
"1875","Harvard (MA)","12","6","2","0.65000","52","29","23"
"1876","Harvard (MA)","13","8","1","0.61364","45","29","16"
"1877","Harvard (MA)","9","7","3","0.55263","31","21","10"
"1878","Pennsylvania","14","9","5","0.58929","42","24","18"
"1879","Harvard (MA)","13","9","12","0.55882","46","27","19"
"1880","Harvard (MA)","18","11","4","0.60606","75","53","22"
"1881","Rutgers (NJ)","22","18","8","0.54167","70","47","23"
"1882","Rutgers (NJ)","41","28","2","0.59155","176","111","65"
"1883","Rutgers (NJ)","38","32","1","0.54225","1288","965","323"
"1884","Pennsylvania","47","29","5","0.61111","1728","1184","544"
"1885","Michigan","34","17","4","0.65455","1437","612","825"
"1886","Lehigh (PA)","48","21","4","0.68493","1850","637","1213"
"1887","California","67","35","3","0.65238","2660","935","1725"
"1888","Princeton (NJ)","70","56","6","0.55303","2468","1899","569"
"1889","Brown (RI)","82","51","11","0.60764","2879","1796","1083"
"1890","Brown (RI)","77","76","9","0.50309","3002","2455","547"
"1891","Southern California","94","76","13","0.54918","2813","2189","624"
"1892","Minnesota","93","80","9","0.53571","2972","2394","578"
"1893","Duke (NC)","79","94","9","0.45879","2176","2912","-736"
"1894","Colorado St.","50","62","4","0.44828","1161","1518","-357"
"1895","Boston (MA)","31","44","11","0.42442","692","1031","-339"
"1896","Rhode Island","54","62","12","0.46875","1126","1201","-75"
"1897","Boston (MA)","32","40","6","0.44872","792","785","7"
"1898","Miami (OH)","47","23","4","0.66216","921","644","277"
"1899","New Hampshire","33","32","6","0.50704","571","522","49"
"1900","New Hampshire","22","35","11","0.40441","442","686","-244"
"1901","Marshall (WV)","18","34","3","0.35455","302","917","-615"
"1902","Saint John's (MN)","9","22","4","0.31429","148","460","-312"
"1903","Wichita St. (KS)","14","25","2","0.36585","376","546","-170"
"1904","Oklahoma St.","11","14","1","0.44231","194","394","-200"
"1905","Miami (OH)","7","25","5","0.25676","245","494","-249"
"1906","Rensselaer Tech (NY)","3","7","4","0.35714","92","107","-15"
"1907","Marshall (WV)","5","10","2","0.35294","71","238","-167"
"1908","Fort Hays St. (KS)","5","6","1","0.45833","56","91","-35"
"1909","Fort Hays St. (KS)","1","3","1","0.30000","12","68","-56"
"1910","Texas St.","0","1","0","0.00000","0","19","-19"
"1912","Fort Hays St. (KS)","1","2","0","0.33333","20","132","-112"
"1913","Eureka (IL)","1","6","0","0.14286","39","203","-164"
"1914","Eureka (IL)","3","4","0","0.42857","57","201","-144"
"1915","Texas St.","1","1","1","0.50000","13","20","-7"
"1916","Texas St.","0","2","1","0.16667","0","106","-106"
"1917","Boston (MA)","4","4","0","0.50000","73","136","-63"
"1918","Monmouth (IL)","1","7","0","0.12500","26","137","-111"
"1930","Troy (AL)","1","2","0","0.33333","7","73","-66"
"2013","Grambling St. (LA)","0","1","0","0.00000","0","0","0"
"1891","Nebraska","1","1","0","0.50000","28","26","2"
"1892","Nebraska","1","0","0","1.00000","6","0","6"
"1892","Wisconsin","4","4","0","0.50000","102","96","6"
"1893","Nebraska","3","2","1","0.58333","80","80","0"
"1894","Nebraska","7","2","0","0.77778","120","42","78"
"1895","Texas","5","0","0","1.00000","96","0","96"
"1895","Nebraska","6","3","0","0.66667","138","62","76"
"1901","Arkansas","3","5","0","0.37500","98","52","46"
"1902","Arkansas","6","3","0","0.66667","148","73","75"
"1896","Nebraska","6","3","1","0.65000","102","64","38"
"1897","Nebraska","5","1","0","0.83333","84","15","69"
"1898","Brown (RI)","6","4","0","0.60000","136","96","40"
"1899","Brown (RI)","7","3","1","0.68182","175","57","118"
"1900","Brown (RI)","7","3","1","0.68182","155","67","88"
"1901","Brown (RI)","4","7","1","0.37500","70","212","-142"
"1902","Maine","6","2","0","0.75000","94","33","61"
"1904","Brown (RI)","6","5","0","0.54545","181","51","130"
"1905","Brown (RI)","7","4","0","0.63636","281","58","223"
"1906","Brown (RI)","6","3","0","0.66667","113","32","81"
"1907","Brown (RI)","7","3","0","0.70000","166","50","116"
"1910","Brown (RI)","7","2","1","0.75000","198","47","151"
"1911","Brown (RI)","7","3","1","0.68182","187","53","134"
"1912","Brown (RI)","6","4","0","0.60000","117","107","10"
"1913","Brown (RI)","4","5","0","0.44444","70","111","-41"
"1914","Brown (RI)","5","2","2","0.66667","105","65","40"
"1915","Brown (RI)","5","4","1","0.55000","166","46","120"
"1916","Brown (RI)","8","1","0","0.88889","254","37","217"
"1917","Brown (RI)","8","2","0","0.80000","160","62","98"
"1918","Brown (RI)","2","3","0","0.40000","48","98","-50"
"1919","Brown (RI)","5","4","1","0.55000","74","61","13"
"1920","Brown (RI)","6","3","0","0.66667","149","62","87"
"1921","Brown (RI)","5","3","1","0.61111","107","89","18"
"1922","Brown (RI)","6","2","1","0.72222","92","47","45"
"1923","Brown (RI)","6","4","0","0.60000","159","71","88"
"1924","Brown (RI)","5","4","0","0.55556","154","65","89"
"1925","Brown (RI)","5","4","1","0.55000","215","80","135"
"1898","Nebraska","8","3","0","0.72727","270","78","192"
"1899","Kansas","10","0","0","1.00000","280","37","243"
"1900","Stanford (CA)","7","2","1","0.75000","154","20","134"
"1901","Michigan","11","0","0","1.00000","550","0","550"
"1902","Michigan","11","0","0","1.00000","644","12","632"
"1903","Michigan","11","0","1","0.95833","565","6","559"
"1904","Michigan","10","0","0","1.00000","567","22","545"
"1905","Michigan","12","1","0","0.92308","495","2","493"
"1906","Michigan","4","1","1","0.75000","72","30","42"
"1907","Michigan","5","1","0","0.83333","107","6","101"
"1908","Michigan","5","2","1","0.68750","128","81","47"
"1909","Michigan","6","1","0","0.85714","115","34","81"
"1910","Michigan","3","0","3","0.75000","29","9","20"
"1911","Michigan","5","1","2","0.75000","90","38","52"
"1912","Michigan","5","2","0","0.71429","158","65","93"
"1913","Michigan","6","1","0","0.85714","175","21","154"
"1914","Michigan","6","3","0","0.66667","233","68","165"
"1915","Michigan","4","3","1","0.56250","130","81","49"
"1916","Michigan","7","2","0","0.77778","253","56","197"
"1917","Michigan","8","2","0","0.80000","304","53","251"
"1918","Michigan","5","0","0","1.00000","96","6","90"
"1919","Michigan","3","4","0","0.42857","93","102","-9"
"1920","Michigan","5","2","0","0.71429","121","21","100"
"1921","Michigan","5","1","1","0.78571","187","21","166"
"1922","Michigan","6","0","1","0.92857","183","13","170"
"1923","Michigan","8","0","0","1.00000","150","12","138"
"1925","Michigan","7","1","0","0.87500","227","3","224"
"1926","Michigan","7","1","0","0.87500","191","38","153"
"1899","Nebraska","2","7","1","0.25000","49","164","-115"
"1900","Miami (OH)","0","4","0","0.00000","12","77","-65"
"1900","Nebraska","7","1","2","0.80000","129","20","109"
"1901","Nebraska","7","2","0","0.77778","171","52","119"
"1902","Nebraska","10","1","0","0.90909","191","41","150"
"1903","Nebraska","11","0","0","1.00000","291","17","274"
"1904","Nebraska","9","3","0","0.75000","339","58","281"
"1905","Nebraska","9","2","0","0.81818","316","83","233"
"1904","Cincinnati (OH)","7","1","0","0.87500","182","10","172"
"1905","Cincinnati (OH)","5","3","0","0.62500","92","91","1"
"1906","Nebraska","6","4","0","0.60000","164","73","91"
"1907","Miami (OH)","6","1","0","0.85714","120","37","83"
"1908","Miami (OH)","7","0","0","1.00000","113","10","103"
"1905","Virginia","5","4","0","0.55556","169","78","91"
"1906","Virginia","7","2","2","0.72727","159","41","118"
"1907","Nebraska","8","2","0","0.80000","323","69","254"
"1908","Nebraska","7","2","1","0.75000","165","93","72"
"1909","Nebraska","3","3","2","0.50000","69","53","16"
"1910","Nebraska","7","1","0","0.87500","260","36","224"
"1911","Nebraska","5","1","2","0.75000","281","33","248"
"1912","Nebraska","7","1","0","0.87500","220","37","183"
"1913","Nebraska","8","0","0","1.00000","138","28","110"
"1914","Nebraska","7","0","1","0.93750","174","28","146"
"1915","Nebraska","8","0","0","1.00000","282","39","243"
"1916","Indiana","2","4","1","0.35714","51","90","-39"
"1917","Indiana","5","2","0","0.71429","225","59","166"
"1918","Indiana","2","2","0","0.50000","64","31","33"
"1919","Indiana","3","4","0","0.42857","70","64","6"
"1920","Indiana","5","2","0","0.71429","129","48","81"
"1921","Indiana","3","4","0","0.42857","86","94","-8"
"1907","Mount Union (OH)","9","2","0","0.81818","265","23","242"
"1909","Allegheny (PA)","2","4","1","0.35714","41","115","-74"
"1910","Allegheny (PA)","4","1","1","0.75000","81","29","52"
"1913","Oregon St.","3","2","3","0.56250","59","75","-16"
"1914","Oregon St.","7","0","2","0.88889","172","15","157"
"1915","Oregon St.","5","3","0","0.62500","166","73","93"
"1916","Nebraska","6","2","0","0.75000","145","51","94"
"1917","Nebraska","5","2","0","0.71429","228","33","195"
"1921","Clemson (SC)","1","6","2","0.22222","48","187","-139"
"1922","Clemson (SC)","5","4","0","0.55556","170","109","61"
"1923","Texas","8","0","1","0.94444","241","21","220"
"1924","Texas","5","3","1","0.61111","109","64","45"
"1925","Texas","6","2","1","0.72222","157","51","106"
"1926","Texas","5","4","0","0.55556","146","69","77"
"1927","Texas-El Paso","2","2","2","0.50000","69","69","0"
"1928","Texas-El Paso","3","4","1","0.43750","100","103","-3"
"1918","Nebraska","3","3","1","0.50000","65","55","10"
"1920","Florida","6","3","0","0.66667","113","91","22"
"1921","Florida","6","3","2","0.63636","134","61","73"
"1922","Florida","7","2","0","0.77778","239","51","188"
"1906","Eastern Michigan","5","0","1","0.91667","52","11","41"
"1907","Eastern Michigan","3","2","0","0.60000","72","13","59"
"1908","Eastern Michigan","1","4","0","0.20000","15","40","-25"
"1914","Missouri","5","3","0","0.62500","128","48","80"
"1915","Missouri","2","5","1","0.31250","72","102","-30"
"1916","Missouri","6","1","1","0.81250","112","21","91"
"1917","Missouri","3","5","0","0.37500","98","124","-26"
"1919","Nebraska","3","3","2","0.50000","56","60","-4"
"1920","Nebraska","5","3","1","0.61111","151","84","67"
"1918","Columbia (NY)","5","1","0","0.83333","87","27","60"
"1919","Columbia (NY)","2","4","3","0.38889","48","107","-59"
"1921","Nebraska","7","1","0","0.87500","283","17","266"
"1922","Nebraska","7","1","0","0.87500","276","28","248"
"1923","Nebraska","4","2","2","0.62500","112","71","41"
"1924","Nebraska","5","3","0","0.62500","120","77","43"
"1925","Denver (CO)","1","6","0","0.14286","27","152","-125"
"1926","Denver (CO)","4","4","0","0.50000","106","72","34"
"1927","Denver (CO)","5","2","0","0.71429","120","51","69"
"1928","Denver (CO)","4","4","1","0.50000","128","96","32"
"1931","Virginia","1","7","2","0.20000","40","112","-72"
"1932","Virginia","5","4","0","0.55556","95","67","28"
"1933","Virginia","2","6","2","0.30000","83","149","-66"
"1925","Nebraska","4","2","2","0.62500","69","29","40"
"1926","Nebraska","6","2","0","0.75000","123","46","77"
"1927","Nebraska","6","2","0","0.75000","211","59","152"
"1928","Nebraska","7","1","1","0.83333","144","31","113"
"1916","Louisiana St.","1","0","2","0.66667","62","21","41"
"1917","Texas A&M","8","0","0","1.00000","270","0","270"
"1919","Texas A&M","10","0","0","1.00000","275","0","275"
"1920","Texas A&M","6","1","1","0.81250","229","7","222"
"1921","Texas A&M","6","1","2","0.77778","110","57","53"
"1922","Texas A&M","5","4","0","0.55556","166","69","97"
"1923","Texas A&M","5","3","1","0.61111","135","23","112"
"1924","Texas A&M","7","2","1","0.75000","229","35","194"
"1925","Texas A&M","7","1","1","0.83333","191","25","166"
"1926","Texas A&M","5","3","1","0.61111","184","59","125"
"1927","Texas A&M","8","0","1","0.94444","262","32","230"
"1928","Texas A&M","5","4","1","0.55000","205","77","128"
"1929","Nebraska","4","1","3","0.68750","93","62","31"
"1930","Nebraska","4","3","2","0.55556","119","61","58"
"1931","Nebraska","8","2","0","0.80000","136","82","54"
"1932","Nebraska","7","1","1","0.83333","105","52","53"
"1933","Nebraska","8","1","0","0.88889","138","19","119"
"1934","Nebraska","6","3","0","0.66667","106","89","17"
"1935","Nebraska","6","2","1","0.72222","138","71","67"
"1936","Nebraska","7","2","0","0.77778","185","49","136"
"1937","Texas","2","6","1","0.27778","60","103","-43"
"1938","Texas","1","8","0","0.11111","52","162","-110"
"1939","Texas","5","4","0","0.55556","106","125","-19"
"1940","Texas","8","2","0","0.80000","172","77","95"
"1941","Texas","8","1","1","0.85000","338","55","283"
"1942","Texas","9","2","0","0.81818","244","49","195"
"1943","Texas","7","1","1","0.83333","277","54","223"
"1944","Texas","5","4","0","0.55556","119","76","43"
"1945","Texas","10","1","0","0.90909","257","86","171"
"1946","Texas","8","2","0","0.80000","290","68","222"
"1926","Army (NY)","7","1","1","0.83333","240","71","169"
"1927","Army (NY)","9","1","0","0.90000","197","37","160"
"1928","Army (NY)","8","2","0","0.80000","215","79","136"
"1929","Army (NY)","6","4","1","0.59091","276","132","144"
"1932","Louisiana St.","6","3","1","0.65000","187","31","156"
"1933","Louisiana St.","7","0","3","0.85000","176","27","149"
"1934","Louisiana St.","7","2","2","0.72727","172","77","95"
"1935","Oklahoma","6","3","0","0.66667","99","44","55"
"1936","Oklahoma","3","3","3","0.50000","84","67","17"
"1937","Nebraska","6","1","2","0.77778","99","42","57"
"1938","Nebraska","3","5","1","0.38889","68","84","-16"
"1939","Nebraska","7","1","1","0.83333","115","70","45"
"1940","Nebraska","8","2","0","0.80000","183","75","108"
"1941","Nebraska","4","5","0","0.44444","93","81","12"
"1942","Nebraska","3","7","0","0.30000","55","158","-103"
"1954","Eastern Kentucky","8","1","1","0.85000","181","54","127"
"1955","Eastern Kentucky","5","4","1","0.55000","139","130","9"
"1956","Eastern Kentucky","4","5","0","0.44444","119","107","12"
"1957","Eastern Kentucky","4","5","0","0.44444","162","165","-3"
"1958","Eastern Kentucky","3","6","0","0.33333","102","126","-24"
"1959","Eastern Kentucky","3","6","0","0.33333","79","103","-24"
"1960","Eastern Kentucky","3","6","1","0.35000","98","143","-45"
"1961","Eastern Kentucky","4","5","0","0.44444","114","138","-24"
"1962","Eastern Kentucky","6","3","0","0.66667","149","106","43"
"1963","Eastern Kentucky","2","8","0","0.20000","123","193","-70"
"1943","Nebraska","2","6","0","0.25000","79","261","-182"
"1944","Nebraska","2","6","0","0.25000","83","210","-127"
"1920","Michigan St.","4","6","0","0.40000","270","166","104"
"1921","Kansas","4","3","0","0.57143","92","97","-5"
"1922","Kansas","3","4","1","0.43750","104","75","29"
"1923","Kansas","5","0","3","0.81250","125","6","119"
"1924","Kansas","2","5","1","0.31250","91","56","35"
"1925","Kansas","2","5","1","0.31250","30","68","-38"
"1927","Butler (IN)","4","3","1","0.56250","155","133","22"
"1928","Butler (IN)","6","2","0","0.75000","170","44","126"
"1929","Butler (IN)","4","4","0","0.50000","85","67","18"
"1945","Nebraska","4","5","0","0.44444","145","200","-55"
"1948","Nebraska","2","8","0","0.20000","137","273","-136"
"1946","Nebraska","3","6","0","0.33333","126","161","-35"
"1947","Nebraska","2","7","0","0.22222","73","191","-118"
"1946","New Hampshire","6","1","1","0.81250","161","45","116"
"1947","New Hampshire","8","1","0","0.88889","255","59","196"
"1948","New Hampshire","5","3","0","0.62500","155","103","52"
"1949","Nebraska","4","5","0","0.44444","124","172","-48"
"1950","Nebraska","6","2","1","0.72222","267","217","50"
"1951","Nebraska","2","8","0","0.20000","121","259","-138"
"1952","Nebraska","5","4","1","0.55000","173","123","50"
"1953","Nebraska","3","6","1","0.35000","119","184","-65"
"1954","Nebraska","6","5","0","0.54545","233","202","31"
"1955","Nebraska","5","5","0","0.50000","127","176","-49"
"1956","Nebraska","4","6","0","0.40000","125","206","-81"
"1957","California","1","9","0","0.10000","109","176","-67"
"1958","California","7","4","0","0.63636","207","200","7"
"1959","California","2","8","0","0.20000","115","223","-108"
"1960","Illinois","5","4","0","0.55556","140","117","23"
"1961","Illinois","0","9","0","0.00000","53","289","-236"
"1962","Illinois","2","7","0","0.22222","75","234","-159"
"1963","Illinois","8","1","1","0.85000","170","96","74"
"1964","Illinois","6","3","0","0.66667","142","100","42"
"1965","Illinois","6","4","0","0.60000","235","118","117"
"1966","Illinois","4","6","0","0.40000","173","193","-20"
"1973","Miami (FL)","5","6","0","0.45455","163","240","-77"
"1974","Miami (FL)","6","5","0","0.54545","167","190","-23"
"1957","Nebraska","1","9","0","0.10000","67","243","-176"
"1958","Nebraska","3","7","0","0.30000","71","235","-164"
"1959","Nebraska","4","6","0","0.40000","108","160","-52"
"1960","Nebraska","4","6","0","0.40000","95","164","-69"
"1961","Nebraska","3","6","1","0.35000","119","135","-16"
"1957","Wyoming","4","3","3","0.55000","139","135","4"
"1958","Wyoming","8","3","0","0.72727","205","136","69"
"1959","Wyoming","9","1","0","0.90000","287","62","225"
"1960","Wyoming","8","2","0","0.80000","212","71","141"
"1961","Wyoming","6","1","2","0.77778","171","74","97"
"1962","Nebraska","9","2","0","0.81818","293","161","132"
"1963","Nebraska","10","1","0","0.90909","273","114","159"
"1964","Nebraska","9","2","0","0.81818","256","85","171"
"1965","Nebraska","10","1","0","0.90909","349","129","220"
"1966","Nebraska","9","2","0","0.81818","223","118","105"
"1967","Nebraska","6","4","0","0.60000","127","83","44"
"1968","Nebraska","6","4","0","0.60000","155","161","-6"
"1969","Nebraska","9","2","0","0.81818","254","119","135"
"1970","Nebraska","11","0","1","0.95833","426","189","237"
"1971","Nebraska","13","0","0","1.00000","507","104","403"
"1972","Nebraska","9","2","1","0.79167","501","97","404"
"1973","Nebraska","9","2","1","0.79167","306","163","143"
"1974","Nebraska","9","3","0","0.75000","373","132","241"
"1975","Nebraska","10","2","0","0.83333","367","137","230"
"1976","Nebraska","9","3","1","0.73077","416","181","235"
"1977","Nebraska","9","3","0","0.75000","315","200","115"
"1978","Nebraska","9","3","0","0.75000","444","216","228"
"1979","Nebraska","10","2","0","0.83333","380","131","249"
"1980","Nebraska","10","2","0","0.83333","470","110","360"
"1981","Nebraska","9","3","0","0.75000","364","125","239"
"1982","Nebraska","12","1","0","0.92308","514","167","347"
"1983","Nebraska","12","1","0","0.92308","654","217","437"
"1984","Nebraska","10","2","0","0.83333","387","115","272"
"1985","Nebraska","9","3","0","0.75000","421","163","258"
"1986","Nebraska","10","2","0","0.83333","446","165","281"
"1987","Nebraska","10","2","0","0.83333","451","164","287"
"1988","Nebraska","11","2","0","0.84615","477","205","272"
"1989","Nebraska","10","2","0","0.83333","509","215","294"
"1990","Nebraska","9","3","0","0.75000","434","192","242"
"1991","Nebraska","9","2","1","0.79167","454","230","224"
"1992","Nebraska","9","3","0","0.75000","441","199","242"
"1993","Nebraska","11","1","0","0.91667","437","194","243"
"1994","Nebraska","13","0","0","1.00000","459","162","297"
"1995","Nebraska","12","0","0","1.00000","638","174","464"
"1996","Nebraska","11","2","0","0.84615","553","174","379"
"1997","Nebraska","13","0","0","1.00000","607","214","393"
"1998","Nebraska","9","4","0","0.69231","403","206","197"
"1999","Nebraska","12","1","0","0.92308","442","171","271"
"2000","Nebraska","10","2","0","0.83333","522","230","292"
"2001","Nebraska","11","2","0","0.84615","463","226","237"
"2002","Nebraska","7","7","0","0.50000","383","335","48"
"2003","Nebraska","9","3","0","0.75000","305","185","120"
"2005","Ohio","4","7","0","0.36364","192","336","-144"
"2006","Ohio","9","5","0","0.64286","276","253","23"
"2007","Ohio","6","6","0","0.50000","366","359","7"
"2008","Ohio","4","8","0","0.33333","289","327","-38"
"2009","Ohio","9","5","0","0.64286","347","298","49"
"2010","Ohio","8","5","0","0.61538","357","309","48"
"2011","Ohio","10","4","0","0.71429","427","310","117"
"2012","Ohio","9","4","0","0.69231","412","322","90"
"2013","Ohio","7","6","0","0.53846","356","357","-1"
"2004","Nebraska","5","6","0","0.45455","275","298","-23"
"2005","Nebraska","8","4","0","0.66667","296","252","44"
"2006","Nebraska","9","5","0","0.64286","428","256","172"
"2007","Nebraska","5","7","0","0.41667","401","455","-54"
"2003","Nebraska","1","0","0","1.00000","17","3","14"
"2008","Nebraska","9","4","0","0.69231","460","371","89"
"2009","Nebraska","10","4","0","0.71429","352","146","206"
"2010","Nebraska","10","4","0","0.71429","432","243","189"
"2011","Nebraska","9","4","0","0.69231","379","304","75"
"2012","Nebraska","10","4","0","0.71429","487","386","101"
"2013","Nebraska","9","4","0","0.69231","415","323","92"
"1896","Nevada","1","2","0","0.33333","30","114","-84"
"1869","Rutgers (NJ)","2","2","0","0.50000","18","18","0"
"1870","Rutgers (NJ)","2","2","0","0.50000","17","17","0"
"1872","Columbia (NY)","5","4","0","0.55556","22","16","6"
"1873","Rutgers (NJ)","7","4","1","0.62500","31","26","5"
"1874","Harvard (MA)","9","7","0","0.56250","54","41","13"
"1875","Harvard (MA)","12","6","2","0.65000","52","29","23"
"1876","Harvard (MA)","13","8","1","0.61364","45","29","16"
"1877","Harvard (MA)","9","7","3","0.55263","31","21","10"
"1878","Pennsylvania","14","9","5","0.58929","42","24","18"
"1879","Harvard (MA)","13","9","12","0.55882","46","27","19"
"1880","Harvard (MA)","18","11","4","0.60606","75","53","22"
"1881","Rutgers (NJ)","22","18","8","0.54167","70","47","23"
"1882","Rutgers (NJ)","41","28","2","0.59155","176","111","65"
"1883","Rutgers (NJ)","38","32","1","0.54225","1288","965","323"
"1884","Pennsylvania","47","29","5","0.61111","1728","1184","544"
"1885","Michigan","34","17","4","0.65455","1437","612","825"
"1886","Lehigh (PA)","48","21","4","0.68493","1850","637","1213"
"1887","California","67","35","3","0.65238","2660","935","1725"
"1888","Princeton (NJ)","70","56","6","0.55303","2468","1899","569"
"1889","Brown (RI)","82","51","11","0.60764","2879","1796","1083"
"1890","Brown (RI)","77","76","9","0.50309","3002","2455","547"
"1891","Southern California","94","76","13","0.54918","2813","2189","624"
"1892","Minnesota","93","80","9","0.53571","2972","2394","578"
"1893","Duke (NC)","79","94","9","0.45879","2176","2912","-736"
"1894","Colorado St.","50","62","4","0.44828","1161","1518","-357"
"1895","Boston (MA)","31","44","11","0.42442","692","1031","-339"
"1896","Rhode Island","54","62","12","0.46875","1126","1201","-75"
"1897","Boston (MA)","32","40","6","0.44872","792","785","7"
"1898","Miami (OH)","47","23","4","0.66216","921","644","277"
"1899","New Hampshire","33","32","6","0.50704","571","522","49"
"1900","New Hampshire","22","35","11","0.40441","442","686","-244"
"1901","Marshall (WV)","18","34","3","0.35455","302","917","-615"
"1902","Saint John's (MN)","9","22","4","0.31429","148","460","-312"
"1903","Wichita St. (KS)","14","25","2","0.36585","376","546","-170"
"1904","Oklahoma St.","11","14","1","0.44231","194","394","-200"
"1905","Miami (OH)","7","25","5","0.25676","245","494","-249"
"1906","Rensselaer Tech (NY)","3","7","4","0.35714","92","107","-15"
"1907","Marshall (WV)","5","10","2","0.35294","71","238","-167"
"1908","Fort Hays St. (KS)","5","6","1","0.45833","56","91","-35"
"1909","Fort Hays St. (KS)","1","3","1","0.30000","12","68","-56"
"1910","Texas St.","0","1","0","0.00000","0","19","-19"
"1912","Fort Hays St. (KS)","1","2","0","0.33333","20","132","-112"
"1913","Eureka (IL)","1","6","0","0.14286","39","203","-164"
"1914","Eureka (IL)","3","4","0","0.42857","57","201","-144"
"1915","Texas St.","1","1","1","0.50000","13","20","-7"
"1916","Texas St.","0","2","1","0.16667","0","106","-106"
"1917","Boston (MA)","4","4","0","0.50000","73","136","-63"
"1918","Monmouth (IL)","1","7","0","0.12500","26","137","-111"
"1930","Troy (AL)","1","2","0","0.33333","7","73","-66"
"2013","Grambling St. (LA)","0","1","0","0.00000","0","0","0"
"1898","Nevada","4","1","0","0.80000","121","18","103"
"1899","Nevada","3","2","0","0.60000","85","52","33"
"1900","Nevada","4","2","1","0.64286","78","34","44"
"1904","California","6","1","1","0.81250","75","24","51"
"1901","Nevada","3","3","0","0.50000","64","31","33"
"1902","Nevada","1","2","0","0.33333","21","40","-19"
"1903","Nevada","2","4","2","0.37500","56","40","16"
"1904","Oregon St.","4","2","0","0.66667","119","22","97"
"1905","Oregon St.","6","3","0","0.66667","164","28","136"
"1904","Nevada","3","3","0","0.50000","55","69","-14"
"1905","Oregon","4","2","2","0.62500","65","39","26"
"1915","Nevada","0","6","0","0.00000","22","158","-136"
"1916","Nevada","3","5","0","0.37500","142","160","-18"
"1917","Nevada","1","6","0","0.14286","57","327","-270"
"1915","Pittsburg St. (KS)","4","5","0","0.44444","111","156","-45"
"1916","Pittsburg St. (KS)","7","3","0","0.70000","159","120","39"
"1917","Pittsburg St. (KS)","4","3","2","0.55556","83","88","-5"
"1919","Nevada","8","1","1","0.85000","450","32","418"
"1920","Nevada","7","3","1","0.68182","186","167","19"
"1921","Nevada","4","3","1","0.56250","183","113","70"
"1922","Nevada","5","3","1","0.61111","165","120","45"
"1923","Nevada","2","3","3","0.43750","107","107","0"
"1924","Colorado School of Mines","4","4","1","0.50000","43","91","-48"
"1925","Colorado School of Mines","2","7","0","0.22222","57","181","-124"
"1926","Colorado School of Mines","1","6","0","0.14286","24","177","-153"
"1924","Nevada","3","4","1","0.43750","101","125","-24"
"1926","Idaho","3","4","1","0.43750","75","75","0"
"1927","Idaho","4","1","3","0.68750","123","48","75"
"1928","Idaho","3","4","1","0.43750","93","148","-55"
"1924","North Carolina St.","2","6","2","0.30000","43","147","-104"
"1925","Nevada","4","3","1","0.56250","107","115","-8"
"1926","Nevada","4","4","0","0.50000","116","119","-3"
"1927","Nevada","2","6","1","0.27778","54","209","-155"
"1928","Nevada","0","7","1","0.06250","31","170","-139"
"1936","Santa Clara (CA)","8","1","0","0.88889","139","36","103"
"1937","Santa Clara (CA)","9","0","0","1.00000","163","9","154"
"1938","Santa Clara (CA)","6","2","0","0.75000","97","26","71"
"1939","Santa Clara (CA)","5","1","3","0.72222","117","40","77"
"1940","Santa Clara (CA)","6","1","1","0.81250","154","46","108"
"1941","Santa Clara (CA)","6","3","0","0.66667","170","103","67"
"1942","Santa Clara (CA)","7","2","0","0.77778","101","52","49"
"1945","California","4","5","1","0.45000","93","107","-14"
"1956","Air Force (CO)","6","2","1","0.72222","293","101","192"
"1957","Air Force (CO)","3","6","1","0.35000","125","184","-59"
"1929","Nevada","2","5","1","0.31250","63","180","-117"
"1930","Nevada","2","4","2","0.37500","77","73","4"
"1931","Nevada","2","5","2","0.33333","76","134","-58"
"1932","Nevada","3","3","2","0.50000","41","99","-58"
"1933","Nevada","4","4","0","0.50000","60","144","-84"
"1934","Nevada","1","7","1","0.16667","15","153","-138"
"1935","Nevada","2","6","0","0.25000","57","139","-82"
"1936","Nevada","4","4","0","0.50000","91","103","-12"
"1937","Nevada","2","6","0","0.25000","61","175","-114"
"1938","Nevada","2","3","1","0.41667","65","117","-52"
"1936","Akron (OH)","6","2","1","0.72222","150","87","63"
"1937","Akron (OH)","7","2","0","0.77778","139","53","86"
"1938","Akron (OH)","6","3","0","0.66667","117","94","23"
"1939","Nevada","5","4","0","0.55556","49","101","-52"
"1940","Nevada","4","4","1","0.50000","252","79","173"
"1941","Nevada","3","5","1","0.38889","100","114","-14"
"1942","Nevada","4","3","1","0.56250","81","80","1"
"1943","Nevada","4","1","1","0.75000","114","25","89"
"1944","Nevada","4","4","0","0.50000","92","93","-1"
"1945","Nevada","7","3","0","0.70000","240","147","93"
"1946","Nevada","7","2","0","0.77778","324","82","242"
"1947","Oregon","7","3","0","0.70000","174","121","53"
"1948","Oregon","9","2","0","0.81818","207","103","104"
"1949","Oregon","4","6","0","0.40000","250","219","31"
"1950","Oregon","1","9","0","0.10000","97","214","-117"
"1939","Holy Cross (MA)","7","2","0","0.77778","176","47","129"
"1940","Holy Cross (MA)","4","5","1","0.45000","117","125","-8"
"1941","Holy Cross (MA)","4","4","2","0.50000","103","104","-1"
"1947","Nevada","9","2","0","0.81818","321","154","167"
"1948","Nevada","9","2","0","0.81818","480","133","347"
"1949","Nevada","5","5","0","0.50000","235","212","23"
"1950","Nevada","1","9","0","0.10000","117","363","-246"
"1952","Nevada","2","3","0","0.40000","111","126","-15"
"1953","Nevada","2","3","0","0.40000","87","116","-29"
"1954","Nevada","2","5","0","0.28571","81","181","-100"
"1955","Nevada","2","5","0","0.28571","70","199","-129"
"1956","Nevada","0","7","1","0.06250","122","198","-76"
"1957","Nevada","1","8","0","0.11111","107","229","-122"
"1958","Nevada","3","3","0","0.50000","100","97","3"
"1959","Nevada","4","3","0","0.57143","130","91","39"
"1960","Nevada","3","6","0","0.33333","121","153","-32"
"1961","Nevada","5","4","0","0.55556","153","179","-26"
"1962","Nevada","5","3","1","0.61111","139","87","52"
"1963","Nevada","3","6","0","0.33333","134","182","-48"
"1964","Nevada","1","9","0","0.10000","104","263","-159"
"1965","Nevada","6","4","0","0.60000","210","162","48"
"1966","Nevada","6","3","0","0.66667","217","153","64"
"1967","Nevada","4","4","1","0.50000","150","159","-9"
"1968","Nevada","3","6","1","0.35000","176","183","-7"
"1969","Nevada","5","5","0","0.50000","222","225","-3"
"1970","Nevada","6","3","1","0.65000","280","220","60"
"1971","Nevada","5","5","0","0.50000","181","165","16"
"1972","Nevada","6","5","0","0.54545","276","218","58"
"1973","Nevada","7","4","0","0.63636","295","143","152"
"1974","Nevada","5","6","0","0.45455","209","254","-45"
"1975","Nevada","3","8","0","0.27273","121","285","-164"
"1976","Nevada","8","3","0","0.72727","409","243","166"
"1977","Nevada","8","3","0","0.72727","421","154","267"
"1978","Nevada","11","1","0","0.91667","413","121","292"
"1979","Nevada","8","4","0","0.66667","325","198","127"
"1980","Nevada","6","4","1","0.59091","202","113","89"
"1981","Nevada","7","4","0","0.63636","310","194","116"
"1982","Nevada","6","5","0","0.54545","294","228","66"
"1983","Nevada","9","5","0","0.64286","402","257","145"
"1984","Nevada","7","4","0","0.63636","325","298","27"
"1985","Nevada","11","2","0","0.84615","483","213","270"
"1986","Nevada","13","1","0","0.92857","531","231","300"
"1987","Nevada","5","6","0","0.45455","314","300","14"
"1988","Nevada","7","4","0","0.63636","333","242","91"
"1989","Nevada","7","4","0","0.63636","349","257","92"
"1990","Nevada","13","2","0","0.86667","497","321","176"
"1991","Nevada","12","1","0","0.92308","546","244","302"
"1992","Nevada","7","5","0","0.58333","318","283","35"
"1994","Nevada","9","2","0","0.81818","414","272","142"
"1995","Nevada","9","3","0","0.75000","521","375","146"
"2004","Nevada","5","7","0","0.41667","356","413","-57"
"2005","Nevada","9","3","0","0.75000","410","383","27"
"2006","Nevada","8","5","0","0.61538","391","249","142"
"2007","Nevada","6","7","0","0.46154","435","418","17"
"2008","Nevada","7","6","0","0.53846","489","420","69"
"2009","Nevada","8","5","0","0.61538","497","371","126"
"2010","Nevada","13","1","0","0.92857","574","300","274"
"2011","Nevada","7","6","0","0.53846","412","327","85"
"2012","Nevada","7","6","0","0.53846","492","439","53"
"1993","Nevada","7","4","0","0.63636","419","315","104"
"1994","Nevada-Las Vegas","7","5","0","0.58333","315","329","-14"
"1995","Nevada-Las Vegas","2","9","0","0.18182","222","520","-298"
"1996","Nevada-Las Vegas","1","11","0","0.08333","276","551","-275"
"1997","Nevada-Las Vegas","3","8","0","0.27273","281","332","-51"
"1998","Nevada-Las Vegas","0","11","0","0.00000","156","389","-233"
"2010","Minnesota","2","3","0","0.40000","104","174","-70"
"1996","Nevada","9","3","0","0.75000","515","278","237"
"1997","Nevada","5","6","0","0.45455","353","320","33"
"1998","Nevada","6","5","0","0.54545","371","316","55"
"1999","Nevada","3","8","0","0.27273","283","418","-135"
"1995","Idaho","6","5","0","0.54545","287","209","78"
"1996","Idaho","6","5","0","0.54545","374","296","78"
"1997","Idaho","5","6","0","0.45455","302","263","39"
"1998","Idaho","9","3","0","0.75000","392","317","75"
"1999","Idaho","7","4","0","0.63636","304","283","21"
"2000","Nevada","2","10","0","0.16667","207","464","-257"
"2001","Nevada","3","8","0","0.27273","286","431","-145"
"2002","Nevada","5","7","0","0.41667","331","371","-40"
"2003","Nevada","6","6","0","0.50000","282","338","-56"
"2013","Nevada","4","8","0","0.33333","323","413","-90"
"1968","Nevada-Las Vegas","8","1","0","0.88889","266","103","163"
"1969","Nevada-Las Vegas","6","4","0","0.60000","271","255","16"
"1970","Nevada-Las Vegas","6","4","0","0.60000","313","241","72"
"1971","Nevada-Las Vegas","5","4","1","0.55000","257","171","86"
"1972","Nevada-Las Vegas","1","10","0","0.09091","149","289","-140"
"1973","Nevada-Las Vegas","8","3","0","0.72727","304","151","153"
"1974","Nevada-Las Vegas","12","1","0","0.92308","444","251","193"
"1975","Nevada-Las Vegas","7","4","0","0.63636","332","212","120"
"1976","Southern Methodist (TX)","3","8","0","0.27273","202","339","-137"
"1977","Southern Methodist (TX)","4","7","0","0.36364","226","319","-93"
"1978","Southern Methodist (TX)","4","6","1","0.40909","300","251","49"
"1979","Southern Methodist (TX)","5","6","0","0.45455","226","236","-10"
"1980","Southern Methodist (TX)","8","4","0","0.66667","324","192","132"
"1981","Southern Methodist (TX)","10","1","0","0.90909","365","137","228"
"1963","Utah St.","8","2","0","0.80000","317","99","218"
"1964","Utah St.","5","4","1","0.55000","294","136","158"
"1965","Utah St.","8","2","0","0.80000","271","136","135"
"1966","Utah St.","4","6","0","0.40000","181","163","18"
"1968","Boise St. (ID)","8","2","0","0.80000","324","124","200"
"1969","Boise St. (ID)","9","1","0","0.90000","391","98","293"
"1970","Boise St. (ID)","8","3","0","0.72727","293","129","164"
"1971","Boise St. (ID)","10","2","0","0.83333","351","247","104"
"1972","Boise St. (ID)","7","4","0","0.63636","345","240","105"
"1973","Boise St. (ID)","10","3","0","0.76923","470","221","249"
"1974","Boise St. (ID)","10","2","0","0.83333","497","259","238"
"1975","Boise St. (ID)","9","2","1","0.79167","401","265","136"
"1976","Nevada-Las Vegas","9","3","0","0.75000","359","288","71"
"1977","Nevada-Las Vegas","9","2","0","0.81818","300","243","57"
"1978","Nevada-Las Vegas","7","4","0","0.63636","249","182","67"
"1979","Nevada-Las Vegas","9","1","2","0.83333","370","300","70"
"1980","Nevada-Las Vegas","7","4","0","0.63636","384","257","127"
"1981","Nevada-Las Vegas","6","6","0","0.50000","326","433","-107"
"1982","Nevada-Las Vegas","3","8","0","0.27273","246","332","-86"
"1983","Nevada-Las Vegas","7","4","0","0.63636","255","192","63"
"1984","Nevada-Las Vegas","11","2","0","0.84615","387","255","132"
"1985","Nevada-Las Vegas","5","5","1","0.50000","189","210","-21"
"1986","Nevada-Las Vegas","6","5","0","0.54545","286","241","45"
"1987","Nevada-Las Vegas","5","6","0","0.45455","244","290","-46"
"1988","Nevada-Las Vegas","4","7","0","0.36364","176","313","-137"
"1989","Nevada-Las Vegas","4","7","0","0.36364","233","340","-107"
"1990","Nevada-Las Vegas","4","7","0","0.36364","239","324","-85"
"1991","Nevada-Las Vegas","4","7","0","0.36364","220","360","-140"
"1992","Nevada-Las Vegas","6","5","0","0.54545","243","311","-68"
"1993","Nevada-Las Vegas","3","8","0","0.27273","259","347","-88"
"1993","Nevada","7","4","0","0.63636","419","315","104"
"1994","Nevada-Las Vegas","7","5","0","0.58333","315","329","-14"
"1995","Nevada-Las Vegas","2","9","0","0.18182","222","520","-298"
"1996","Nevada-Las Vegas","1","11","0","0.08333","276","551","-275"
"1997","Nevada-Las Vegas","3","8","0","0.27273","281","332","-51"
"1998","Nevada-Las Vegas","0","11","0","0.00000","156","389","-233"
"2010","Minnesota","2","3","0","0.40000","104","174","-70"
"1976","Southern California","11","1","0","0.91667","386","139","247"
"1977","Southern California","8","4","0","0.66667","357","212","145"
"1978","Southern California","12","1","0","0.92308","318","153","165"
"1979","Southern California","11","0","1","0.95833","389","171","218"
"1980","Southern California","8","2","1","0.77273","265","134","131"
"1981","Southern California","9","3","0","0.75000","294","170","124"
"1982","Southern California","8","3","0","0.72727","302","143","159"
"1993","Southern California","8","5","0","0.61538","348","252","96"
"1994","Southern California","8","3","1","0.70833","356","243","113"
"1995","Southern California","9","2","1","0.79167","355","212","143"
"1996","Southern California","6","6","0","0.50000","325","267","58"
"1997","Southern California","6","5","0","0.54545","233","233","0"
"1999","Nevada-Las Vegas","3","8","0","0.27273","160","324","-164"
"2000","Nevada-Las Vegas","8","5","0","0.61538","370","275","95"
"2001","Nevada-Las Vegas","4","7","0","0.36364","284","270","14"
"2002","Nevada-Las Vegas","5","7","0","0.41667","292","366","-74"
"2003","Nevada-Las Vegas","6","6","0","0.50000","256","272","-16"
"2004","Nevada-Las Vegas","2","9","0","0.18182","229","357","-128"
"2005","Nevada-Las Vegas","2","9","0","0.18182","207","381","-174"
"2006","Nevada-Las Vegas","2","10","0","0.16667","238","382","-144"
"2007","Nevada-Las Vegas","2","10","0","0.16667","218","343","-125"
"2008","Nevada-Las Vegas","5","7","0","0.41667","307","391","-84"
"2009","Nevada-Las Vegas","5","7","0","0.41667","298","389","-91"
"2003","Montana","9","4","0","0.69231","430","266","164"
"2004","Montana","12","3","0","0.80000","535","339","196"
"2005","Montana","8","4","0","0.66667","306","218","88"
"2006","Montana","12","2","0","0.85714","385","225","160"
"2007","Montana","11","1","0","0.91667","377","178","199"
"2008","Montana","14","2","0","0.87500","509","284","225"
"2009","Montana","14","1","0","0.93333","537","285","252"
"2010","Nevada-Las Vegas","2","11","0","0.15385","239","516","-277"
"2011","Nevada-Las Vegas","2","10","0","0.16667","207","485","-278"
"2012","Nevada-Las Vegas","2","11","0","0.15385","286","424","-138"
"2013","Nevada-Las Vegas","7","6","0","0.53846","389","414","-25"
"1894","New Mexico","1","1","1","0.50000","26","8","18"
"1869","Rutgers (NJ)","2","2","0","0.50000","18","18","0"
"1870","Rutgers (NJ)","2","2","0","0.50000","17","17","0"
"1872","Columbia (NY)","5","4","0","0.55556","22","16","6"
"1873","Rutgers (NJ)","7","4","1","0.62500","31","26","5"
"1874","Harvard (MA)","9","7","0","0.56250","54","41","13"
"1875","Harvard (MA)","12","6","2","0.65000","52","29","23"
"1876","Harvard (MA)","13","8","1","0.61364","45","29","16"
"1877","Harvard (MA)","9","7","3","0.55263","31","21","10"
"1878","Pennsylvania","14","9","5","0.58929","42","24","18"
"1879","Harvard (MA)","13","9","12","0.55882","46","27","19"
"1880","Harvard (MA)","18","11","4","0.60606","75","53","22"
"1881","Rutgers (NJ)","22","18","8","0.54167","70","47","23"
"1882","Rutgers (NJ)","41","28","2","0.59155","176","111","65"
"1883","Rutgers (NJ)","38","32","1","0.54225","1288","965","323"
"1884","Pennsylvania","47","29","5","0.61111","1728","1184","544"
"1885","Michigan","34","17","4","0.65455","1437","612","825"
"1886","Lehigh (PA)","48","21","4","0.68493","1850","637","1213"
"1887","California","67","35","3","0.65238","2660","935","1725"
"1888","Princeton (NJ)","70","56","6","0.55303","2468","1899","569"
"1889","Brown (RI)","82","51","11","0.60764","2879","1796","1083"
"1890","Brown (RI)","77","76","9","0.50309","3002","2455","547"
"1891","Southern California","94","76","13","0.54918","2813","2189","624"
"1892","Minnesota","93","80","9","0.53571","2972","2394","578"
"1893","Duke (NC)","79","94","9","0.45879","2176","2912","-736"
"1894","Colorado St.","50","62","4","0.44828","1161","1518","-357"
"1895","Boston (MA)","31","44","11","0.42442","692","1031","-339"
"1896","Rhode Island","54","62","12","0.46875","1126","1201","-75"
"1897","Boston (MA)","32","40","6","0.44872","792","785","7"
"1898","Miami (OH)","47","23","4","0.66216","921","644","277"
"1899","New Hampshire","33","32","6","0.50704","571","522","49"
"1900","New Hampshire","22","35","11","0.40441","442","686","-244"
"1901","Marshall (WV)","18","34","3","0.35455","302","917","-615"
"1902","Saint John's (MN)","9","22","4","0.31429","148","460","-312"
"1903","Wichita St. (KS)","14","25","2","0.36585","376","546","-170"
"1904","Oklahoma St.","11","14","1","0.44231","194","394","-200"
"1905","Miami (OH)","7","25","5","0.25676","245","494","-249"
"1906","Rensselaer Tech (NY)","3","7","4","0.35714","92","107","-15"
"1907","Marshall (WV)","5","10","2","0.35294","71","238","-167"
"1908","Fort Hays St. (KS)","5","6","1","0.45833","56","91","-35"
"1909","Fort Hays St. (KS)","1","3","1","0.30000","12","68","-56"
"1910","Texas St.","0","1","0","0.00000","0","19","-19"
"1912","Fort Hays St. (KS)","1","2","0","0.33333","20","132","-112"
"1913","Eureka (IL)","1","6","0","0.14286","39","203","-164"
"1914","Eureka (IL)","3","4","0","0.42857","57","201","-144"
"1915","Texas St.","1","1","1","0.50000","13","20","-7"
"1916","Texas St.","0","2","1","0.16667","0","106","-106"
"1917","Boston (MA)","4","4","0","0.50000","73","136","-63"
"1918","Monmouth (IL)","1","7","0","0.12500","26","137","-111"
"1930","Troy (AL)","1","2","0","0.33333","7","73","-66"
"2013","Grambling St. (LA)","0","1","0","0.00000","0","0","0"
"1901","New Mexico","0","3","1","0.12500","7","54","-47"
"1903","New Mexico","3","0","1","0.87500","30","0","30"
"1904","New Mexico","1","0","0","1.00000","11","0","11"
"1905","New Mexico","5","1","1","0.78571","90","45","45"
"1906","New Mexico","3","1","0","0.75000","59","30","29"
"1907","New Mexico","1","0","0","1.00000","44","0","44"
"1908","New Mexico","5","1","0","0.83333","107","40","67"
"1909","New Mexico","4","2","0","0.66667","117","77","40"
"1910","New Mexico","0","3","0","0.00000","0","90","-90"
"1903","Texas","5","1","2","0.75000","131","28","103"
"1904","Texas","6","2","0","0.75000","219","88","131"
"1905","Texas","5","4","0","0.55556","98","68","30"
"1911","New Mexico","1","3","1","0.30000","62","22","40"
"1912","New Mexico","0","4","0","0.00000","15","76","-61"
"1913","New Mexico","3","2","0","0.60000","84","27","57"
"1914","New Mexico","3","1","1","0.70000","83","33","50"
"1915","New Mexico","3","1","0","0.75000","97","6","91"
"1916","New Mexico","3","2","0","0.60000","216","70","146"
"1919","Idaho","2","3","0","0.40000","26","91","-65"
"1920","Idaho St.","3","3","0","0.50000","53","92","-39"
"1921","Idaho St.","6","2","0","0.75000","178","58","120"
"1922","Idaho St.","4","3","0","0.57143","247","54","193"
"1923","Idaho St.","3","2","1","0.58333","58","80","-22"
"1924","Idaho St.","5","2","0","0.71429","169","72","97"
"1925","Idaho St.","2","4","0","0.33333","18","46","-28"
"1926","Idaho St.","1","4","0","0.20000","14","80","-66"
"1927","Idaho St.","1","4","1","0.25000","46","88","-42"
"1917","New Mexico","1","2","0","0.33333","47","129","-82"
"1916","Gonzaga (WA)","3","2","0","0.60000","49","51","-2"
"1919","New Mexico","3","0","2","0.80000","136","15","121"
"1920","New Mexico","3","3","0","0.50000","105","91","14"
"1921","New Mexico","2","2","0","0.50000","41","31","10"
"1922","New Mexico","3","4","0","0.42857","58","61","-3"
"1923","New Mexico","3","5","0","0.37500","189","98","91"
"1924","New Mexico","5","1","0","0.83333","103","12","91"
"1925","New Mexico","2","4","1","0.35714","52","77","-25"
"1926","New Mexico","4","2","1","0.64286","121","110","11"
"1927","New Mexico","8","0","1","0.94444","215","28","187"
"1928","New Mexico","5","2","1","0.68750","172","51","121"
"1929","New Mexico","2","4","2","0.37500","133","100","33"
"1930","New Mexico","4","5","0","0.44444","148","133","15"
"1931","New Mexico","3","3","1","0.50000","80","70","10"
"1932","New Mexico","1","6","1","0.18750","24","184","-160"
"1933","New Mexico","3","4","1","0.43750","92","108","-16"
"1912","Howard Payne (TX)","2","3","1","0.41667","152","119","33"
"1913","Howard Payne (TX)","3","4","2","0.44444","79","66","13"
"1923","Missouri","2","3","3","0.43750","31","40","-9"
"1924","Missouri","7","2","0","0.77778","110","41","69"
"1925","Missouri","6","1","1","0.81250","110","44","66"
"1926","Missouri","5","1","2","0.75000","122","33","89"
"1927","Missouri","7","2","0","0.77778","129","90","39"
"1928","Missouri","4","4","0","0.50000","138","102","36"
"1929","Missouri","5","2","1","0.68750","78","28","50"
"1930","Missouri","2","5","2","0.33333","41","132","-91"
"1931","Missouri","2","8","0","0.20000","72","193","-121"
"1934","New Mexico","8","1","0","0.88889","251","73","178"
"1935","New Mexico","6","4","0","0.60000","145","102","43"
"1936","New Mexico","2","7","0","0.22222","71","95","-24"
"1939","Kansas","2","6","0","0.25000","47","107","-60"
"1940","Kansas","2","7","0","0.22222","75","183","-108"
"1941","Kansas","3","6","0","0.33333","74","222","-148"
"1942","Kansas","2","8","0","0.20000","77","248","-171"
"1930","Arizona St.","3","5","1","0.38889","111","94","17"
"1931","Arizona St.","6","2","0","0.75000","170","66","104"
"1932","Arizona St.","4","3","1","0.56250","182","92","90"
"1937","New Mexico","4","4","1","0.50000","69","93","-24"
"1938","New Mexico","8","3","0","0.72727","199","72","127"
"1939","New Mexico","8","2","0","0.80000","167","98","69"
"1940","New Mexico","5","4","0","0.55556","166","94","72"
"1941","New Mexico","5","4","1","0.55000","116","135","-19"
"1949","Montana","5","4","0","0.55556","179","200","-21"
"1950","Montana","5","5","0","0.50000","227","147","80"
"1951","Montana","2","7","0","0.22222","108","266","-158"
"1942","New Mexico","4","5","2","0.45455","134","99","35"
"1943","New Mexico","3","2","0","0.60000","85","59","26"
"1944","New Mexico","1","7","0","0.12500","87","261","-174"
"1945","New Mexico","6","1","1","0.81250","208","61","147"
"1946","New Mexico","5","5","2","0.50000","127","224","-97"
"1947","New Mexico","4","5","1","0.45000","171","182","-11"
"1948","New Mexico","2","9","0","0.18182","146","216","-70"
"1949","New Mexico","2","8","0","0.20000","98","307","-209"
"1932","San Jose St. (CA)","7","0","2","0.88889","116","27","89"
"1933","San Jose St. (CA)","4","4","0","0.50000","102","78","24"
"1934","San Jose St. (CA)","3","3","4","0.50000","90","126","-36"
"1935","San Jose St. (CA)","5","5","1","0.50000","116","101","15"
"1936","San Jose St. (CA)","5","4","0","0.55556","136","93","43"
"1937","San Jose St. (CA)","11","2","1","0.82143","296","79","217"
"1938","San Jose St. (CA)","11","1","0","0.91667","322","56","266"
"1939","San Jose St. (CA)","13","0","0","1.00000","324","29","295"
"1948","West Virginia","9","3","0","0.75000","257","140","117"
"1949","West Virginia","4","6","1","0.40909","227","275","-48"
"1950","New Mexico","2","8","0","0.20000","160","337","-177"
"1951","New Mexico","4","7","0","0.36364","213","262","-49"
"1952","New Mexico","7","2","0","0.77778","119","46","73"
"1953","New Mexico","5","3","1","0.61111","154","103","51"
"1954","New Mexico","5","5","0","0.50000","152","168","-16"
"1955","New Mexico","2","8","0","0.20000","61","213","-152"
"1957","San Jose St. (CA)","3","7","0","0.30000","123","196","-73"
"1958","San Jose St. (CA)","4","5","0","0.44444","174","106","68"
"1959","San Jose St. (CA)","4","6","0","0.40000","192","278","-86"
"1960","San Jose St. (CA)","5","4","0","0.55556","175","176","-1"
"1961","San Jose St. (CA)","6","4","0","0.60000","183","185","-2"
"1962","San Jose St. (CA)","2","8","1","0.22727","133","261","-128"
"1963","San Jose St. (CA)","5","5","0","0.50000","187","194","-7"
"1964","San Jose St. (CA)","4","6","0","0.40000","151","145","6"
"1956","New Mexico","4","6","0","0.40000","167","205","-38"
"1957","New Mexico","4","6","0","0.40000","140","144","-4"
"1958","New Mexico","7","3","0","0.70000","210","185","25"
"1959","New Mexico","7","3","0","0.70000","260","135","125"
"1960","California","2","7","1","0.25000","93","195","-102"
"1961","California","1","8","1","0.15000","118","268","-150"
"1962","California","1","9","0","0.10000","143","247","-104"
"1963","California","4","5","1","0.45000","195","213","-18"
"1964","William & Mary (VA)","4","6","0","0.40000","138","194","-56"
"1965","William & Mary (VA)","6","4","0","0.60000","197","163","34"
"1966","William & Mary (VA)","5","4","1","0.55000","176","144","32"
"1967","William & Mary (VA)","5","4","1","0.55000","196","177","19"
"1968","William & Mary (VA)","3","7","0","0.30000","97","195","-98"
"1960","New Mexico","5","5","0","0.50000","234","182","52"
"1961","New Mexico","7","4","0","0.63636","215","197","18"
"1962","New Mexico","7","2","1","0.75000","210","159","51"
"1963","New Mexico","6","4","0","0.60000","177","143","34"
"1964","New Mexico","9","2","0","0.81818","185","90","95"
"1965","New Mexico","3","7","0","0.30000","127","226","-99"
"1966","New Mexico","2","8","0","0.20000","101","320","-219"
"1967","New Mexico","1","9","0","0.10000","152","433","-281"
"1968","New Mexico","0","10","0","0.00000","120","403","-283"
"1969","New Mexico","4","6","0","0.40000","171","281","-110"
"1970","New Mexico","7","3","0","0.70000","291","222","69"
"1971","New Mexico","6","3","2","0.63636","341","292","49"
"1972","New Mexico","3","8","0","0.27273","208","327","-119"
"1973","New Mexico","4","7","0","0.36364","257","287","-30"
"1974","New Mexico","4","6","1","0.40909","192","263","-71"
"1975","New Mexico","6","5","0","0.54545","291","232","59"
"1976","New Mexico","4","7","0","0.36364","229","235","-6"
"1977","New Mexico","5","7","0","0.41667","273","339","-66"
"1978","New Mexico","7","5","0","0.58333","284","205","79"
"1979","New Mexico","5","7","0","0.41667","211","229","-18"
"1973","Tennessee-Chattanooga","4","7","0","0.36364","131","241","-110"
"1974","Tennessee-Chattanooga","4","7","0","0.36364","181","252","-71"
"1975","Tennessee-Chattanooga","5","5","1","0.50000","176","195","-19"
"1976","Tennessee-Chattanooga","6","4","1","0.59091","232","205","27"
"1977","Tennessee-Chattanooga","9","1","1","0.86364","265","167","98"
"1978","Tennessee-Chattanooga","7","3","1","0.68182","306","192","114"
"1979","Tennessee-Chattanooga","9","2","0","0.81818","349","217","132"
"1980","New Mexico","4","7","0","0.36364","246","364","-118"
"1981","New Mexico","4","7","1","0.37500","225","231","-6"
"1982","New Mexico","10","1","0","0.90909","374","225","149"
"1983","South Carolina","5","6","0","0.45455","231","237","-6"
"1984","South Carolina","10","2","0","0.83333","371","258","113"
"1985","South Carolina","5","6","0","0.45455","269","290","-21"
"1986","South Carolina","3","6","2","0.36364","313","286","27"
"1987","South Carolina","8","4","0","0.66667","341","141","200"
"1988","South Carolina","8","4","0","0.66667","232","224","8"
"1983","New Mexico","6","6","0","0.50000","239","233","6"
"1984","New Mexico","4","8","0","0.33333","251","359","-108"
"1985","New Mexico","3","8","0","0.27273","289","415","-126"
"1986","New Mexico","4","8","0","0.33333","317","338","-21"
"1994","Mississippi","4","7","0","0.36364","246","205","41"
"1984","Cal St.-Long Beach","4","7","0","0.36364","242","301","-59"
"1985","Cal St.-Long Beach","6","6","0","0.50000","320","307","13"
"1986","Cal St.-Long Beach","6","5","0","0.54545","250","260","-10"
"1987","New Mexico","0","11","0","0.00000","209","444","-235"
"1988","New Mexico","2","10","0","0.16667","170","518","-348"
"1989","New Mexico","2","10","0","0.16667","298","378","-80"
"1990","New Mexico","2","10","0","0.16667","279","400","-121"
"1991","New Mexico","3","9","0","0.25000","240","473","-233"
"1981","Southwestern (KS)","5","2","2","0.66667","300","174","126"
"1982","Southwestern (KS)","9","2","0","0.81818","261","130","131"
"1985","Pittsburg St. (KS)","8","2","0","0.80000","299","217","82"
"1986","Pittsburg St. (KS)","11","1","0","0.91667","499","199","300"
"1987","Pittsburg St. (KS)","11","1","0","0.91667","533","108","425"
"1988","Pittsburg St. (KS)","11","1","0","0.91667","423","126","297"
"1989","Pittsburg St. (KS)","12","1","0","0.92308","478","153","325"
"1990","Texas St.","6","5","0","0.54545","268","220","48"
"1991","Texas St.","7","4","0","0.63636","307","179","128"
"1992","New Mexico","3","8","0","0.27273","247","287","-40"
"1993","New Mexico","6","5","0","0.54545","335","256","79"
"1994","New Mexico","5","7","0","0.41667","401","386","15"
"1995","New Mexico","4","7","0","0.36364","256","303","-47"
"1996","New Mexico","6","5","0","0.54545","331","280","51"
"1997","New Mexico","9","4","0","0.69231","404","274","130"
"1998","Texas Christian","7","5","0","0.58333","267","235","32"
"1999","Texas Christian","8","4","0","0.66667","362","213","149"
"2000","Texas Christian","10","1","0","0.90909","410","106","304"
"2001","Alabama","7","5","0","0.58333","318","232","86"
"2002","Alabama","10","3","0","0.76923","367","200","167"
"2003","Texas A&M","4","8","0","0.33333","304","465","-161"
"2004","Texas A&M","7","5","0","0.58333","341","292","49"
"2005","Texas A&M","5","6","0","0.45455","352","343","9"
"2006","Texas A&M","9","4","0","0.69231","362","267","95"
"2007","Texas A&M","7","5","0","0.58333","346","313","33"
"2011","Texas St.","6","6","0","0.50000","306","342","-36"
"2012","Texas St.","4","8","0","0.33333","343","402","-59"
"2013","Texas St.","6","6","0","0.50000","287","328","-41"
"1998","New Mexico","3","9","0","0.25000","274","397","-123"
"1999","New Mexico","4","7","0","0.36364","240","298","-58"
"2000","New Mexico","5","7","0","0.41667","229","249","-20"
"2001","New Mexico","6","5","0","0.54545","304","243","61"
"2002","New Mexico","7","7","0","0.50000","341","358","-17"
"2003","New Mexico","8","5","0","0.61538","391","290","101"
"2004","New Mexico","7","5","0","0.58333","244","224","20"
"2005","New Mexico","6","5","0","0.54545","326","327","-1"
"2006","New Mexico","6","7","0","0.46154","284","312","-28"
"2007","New Mexico","9","4","0","0.69231","321","247","74"
"2008","New Mexico","4","8","0","0.33333","253","273","-20"
"2011","San Diego St. (CA)","8","5","0","0.61538","387","325","62"
"2012","San Diego St. (CA)","9","4","0","0.69231","427","317","110"
"2013","San Diego St. (CA)","8","5","0","0.61538","387","412","-25"
"2009","New Mexico","1","11","0","0.08333","196","431","-235"
"2010","New Mexico","1","11","0","0.08333","190","532","-342"
"2011","New Mexico","0","4","0","0.00000","71","173","-102"
"2011","New Mexico","1","7","0","0.12500","73","327","-254"
"1997","Notre Dame (IN)","7","6","0","0.53846","282","265","17"
"1998","Notre Dame (IN)","9","3","0","0.75000","328","248","80"
"1999","Notre Dame (IN)","5","7","0","0.41667","348","331","17"
"2000","Notre Dame (IN)","9","3","0","0.75000","353","267","86"
"2001","Notre Dame (IN)","5","6","0","0.45455","214","215","-1"
"2012","New Mexico","4","9","0","0.30769","335","393","-58"
"2013","New Mexico","3","9","0","0.25000","393","513","-120"
"1893","New Mexico St.","1","1","0","0.50000","16","18","-2"
"1894","New Mexico St.","2","0","0","1.00000","11","4","7"
"1869","Rutgers (NJ)","2","2","0","0.50000","18","18","0"
"1870","Rutgers (NJ)","2","2","0","0.50000","17","17","0"
"1872","Columbia (NY)","5","4","0","0.55556","22","16","6"
"1873","Rutgers (NJ)","7","4","1","0.62500","31","26","5"
"1874","Harvard (MA)","9","7","0","0.56250","54","41","13"
"1875","Harvard (MA)","12","6","2","0.65000","52","29","23"
"1876","Harvard (MA)","13","8","1","0.61364","45","29","16"
"1877","Harvard (MA)","9","7","3","0.55263","31","21","10"
"1878","Pennsylvania","14","9","5","0.58929","42","24","18"
"1879","Harvard (MA)","13","9","12","0.55882","46","27","19"
"1880","Harvard (MA)","18","11","4","0.60606","75","53","22"
"1881","Rutgers (NJ)","22","18","8","0.54167","70","47","23"
"1882","Rutgers (NJ)","41","28","2","0.59155","176","111","65"
"1883","Rutgers (NJ)","38","32","1","0.54225","1288","965","323"
"1884","Pennsylvania","47","29","5","0.61111","1728","1184","544"
"1885","Michigan","34","17","4","0.65455","1437","612","825"
"1886","Lehigh (PA)","48","21","4","0.68493","1850","637","1213"
"1887","California","67","35","3","0.65238","2660","935","1725"
"1888","Princeton (NJ)","70","56","6","0.55303","2468","1899","569"
"1889","Brown (RI)","82","51","11","0.60764","2879","1796","1083"
"1890","Brown (RI)","77","76","9","0.50309","3002","2455","547"
"1891","Southern California","94","76","13","0.54918","2813","2189","624"
"1892","Minnesota","93","80","9","0.53571","2972","2394","578"
"1893","Duke (NC)","79","94","9","0.45879","2176","2912","-736"
"1894","Colorado St.","50","62","4","0.44828","1161","1518","-357"
"1895","Boston (MA)","31","44","11","0.42442","692","1031","-339"
"1896","Rhode Island","54","62","12","0.46875","1126","1201","-75"
"1897","Boston (MA)","32","40","6","0.44872","792","785","7"
"1898","Miami (OH)","47","23","4","0.66216","921","644","277"
"1899","New Hampshire","33","32","6","0.50704","571","522","49"
"1900","New Hampshire","22","35","11","0.40441","442","686","-244"
"1901","Marshall (WV)","18","34","3","0.35455","302","917","-615"
"1902","Saint John's (MN)","9","22","4","0.31429","148","460","-312"
"1903","Wichita St. (KS)","14","25","2","0.36585","376","546","-170"
"1904","Oklahoma St.","11","14","1","0.44231","194","394","-200"
"1905","Miami (OH)","7","25","5","0.25676","245","494","-249"
"1906","Rensselaer Tech (NY)","3","7","4","0.35714","92","107","-15"
"1907","Marshall (WV)","5","10","2","0.35294","71","238","-167"
"1908","Fort Hays St. (KS)","5","6","1","0.45833","56","91","-35"
"1909","Fort Hays St. (KS)","1","3","1","0.30000","12","68","-56"
"1910","Texas St.","0","1","0","0.00000","0","19","-19"
"1912","Fort Hays St. (KS)","1","2","0","0.33333","20","132","-112"
"1913","Eureka (IL)","1","6","0","0.14286","39","203","-164"
"1914","Eureka (IL)","3","4","0","0.42857","57","201","-144"
"1915","Texas St.","1","1","1","0.50000","13","20","-7"
"1916","Texas St.","0","2","1","0.16667","0","106","-106"
"1917","Boston (MA)","4","4","0","0.50000","73","136","-63"
"1918","Monmouth (IL)","1","7","0","0.12500","26","137","-111"
"1930","Troy (AL)","1","2","0","0.33333","7","73","-66"
"2013","Grambling St. (LA)","0","1","0","0.00000","0","0","0"
"1897","New Mexico St.","1","0","1","0.75000","10","0","10"
"1898","New Mexico St.","2","1","0","0.66667","57","6","51"
"1900","New Mexico St.","3","3","1","0.50000","49","27","22"
"1899","New Mexico St.","1","0","0","1.00000","38","0","38"
"1901","New Mexico St.","2","1","0","0.66667","38","6","32"
"1902","New Mexico St.","0","1","2","0.33333","0","6","-6"
"1903","New Mexico St.","2","0","1","0.83333","34","0","34"
"1904","New Mexico St.","1","2","1","0.37500","42","33","9"
"1905","New Mexico St.","5","0","1","0.91667","128","0","128"
"1906","New Mexico St.","4","0","0","1.00000","71","12","59"
"1907","New Mexico St.","3","0","0","1.00000","88","6","82"
"1908","New Mexico St.","4","2","0","0.66667","179","42","137"
"1909","New Mexico St.","1","3","1","0.30000","19","91","-72"
"1910","New Mexico St.","3","2","0","0.60000","61","23","38"
"1911","New Mexico St.","7","0","0","1.00000","192","6","186"
"1912","New Mexico St.","5","1","0","0.83333","256","24","232"
"1913","New Mexico St.","7","0","1","0.93750","124","24","100"
"1907","West Virginia","6","4","0","0.60000","236","38","198"
"1914","New Mexico St.","4","2","1","0.64286","80","29","51"
"1915","New Mexico St.","5","2","0","0.71429","85","19","66"
"1916","New Mexico St.","2","4","1","0.35714","64","153","-89"
"1902","Idaho","1","3","1","0.30000","23","43","-20"
"1903","Idaho","4","1","0","0.80000","131","5","126"
"1904","Idaho","2","1","0","0.66667","36","12","24"
"1905","Idaho","5","0","0","1.00000","113","2","111"
"1906","Idaho","2","4","0","0.33333","47","49","-2"
"1909","Iowa","2","4","1","0.35714","58","97","-39"
"1910","Idaho","4","2","0","0.66667","112","69","43"
"1911","Idaho","4","3","0","0.57143","98","58","40"
"1912","Idaho","2","2","0","0.50000","26","34","-8"
"1913","Idaho","3","3","0","0.50000","93","56","37"
"1914","Idaho","2","3","1","0.41667","12","45","-33"
"1915","Oklahoma St.","4","5","1","0.45000","161","93","68"
"1916","Oklahoma St.","4","4","0","0.50000","290","95","195"
"1917","New Mexico St.","4","2","0","0.66667","231","75","156"
"1918","Washington","1","1","0","0.50000","6","7","-1"
"1919","New Mexico St.","2","3","1","0.41667","83","69","14"
"1920","New Mexico St.","5","1","1","0.78571","159","62","97"
"1921","New Mexico St.","4","2","0","0.66667","126","37","89"
"1922","New Mexico St.","6","2","0","0.75000","210","53","157"
"1902","Virginia Tech","3","2","1","0.58333","89","23","66"
"1904","North Carolina","5","2","2","0.66667","170","34","136"
"1905","Washington & Lee (VA)","7","2","0","0.77778","145","36","109"
"1906","Washington & Lee (VA)","4","1","1","0.75000","59","14","45"
"1907","Washington & Lee (VA)","3","2","1","0.58333","44","17","27"
"1908","Washington & Lee (VA)","5","1","1","0.78571","144","71","73"
"1909","Tulane (LA)","4","3","2","0.55556","40","50","-10"
"1923","New Mexico St.","9","0","0","1.00000","218","17","201"
"1924","New Mexico St.","7","3","0","0.70000","241","30","211"
"1925","New Mexico St.","5","3","1","0.61111","151","75","76"
"1926","New Mexico St.","5","3","1","0.61111","90","65","25"
"1927","New Mexico St.","3","5","0","0.37500","185","107","78"
"1928","New Mexico St.","5","5","0","0.50000","261","149","112"
"1929","New Mexico St.","3","2","3","0.56250","132","57","75"
"1930","New Mexico St.","5","3","0","0.62500","115","73","42"
"1931","New Mexico St.","6","4","0","0.60000","149","90","59"
"1932","New Mexico St.","4","5","1","0.45000","245","81","164"
"1933","New Mexico St.","2","6","0","0.25000","100","72","28"
"1934","New Mexico St.","4","1","3","0.68750","169","25","144"
"1935","New Mexico St.","7","1","2","0.80000","210","42","168"
"1936","New Mexico St.","6","4","1","0.59091","261","118","143"
"1937","New Mexico St.","7","2","0","0.77778","128","60","68"
"1938","New Mexico St.","7","2","0","0.77778","166","75","91"
"1939","New Mexico St.","3","6","0","0.33333","93","141","-48"
"1940","New Mexico St.","3","6","0","0.33333","95","200","-105"
"1941","New Mexico St.","2","7","0","0.22222","93","228","-135"
"1942","New Mexico St.","1","8","0","0.11111","33","223","-190"
"1940","Northern Arizona","2","6","0","0.25000","92","180","-88"
"1941","Northern Arizona","3","5","0","0.37500","119","143","-24"
"1942","Northern Arizona","1","5","0","0.16667","18","93","-75"
"1943","New Mexico St.","4","0","0","1.00000","107","20","87"
"1946","New Mexico St.","5","5","0","0.50000","155","154","1"
"1947","New Mexico St.","3","6","0","0.33333","140","169","-29"
"1951","Idaho","2","7","0","0.22222","109","182","-73"
"1952","Idaho","4","4","1","0.50000","176","143","33"
"1953","Idaho","1","8","0","0.11111","66","214","-148"
"1948","New Mexico St.","3","7","0","0.30000","138","393","-255"
"1949","New Mexico St.","4","6","0","0.40000","265","315","-50"
"1950","New Mexico St.","2","7","0","0.22222","95","249","-154"
"1951","New Mexico St.","1","9","0","0.10000","115","337","-222"
"1952","New Mexico St.","2","6","1","0.27778","118","255","-137"
"1953","New Mexico St.","2","7","0","0.22222","56","316","-260"
"1954","New Mexico St.","0","9","0","0.00000","87","306","-219"
"1955","New Mexico St.","3","7","0","0.30000","141","226","-85"
"1956","New Mexico St.","1","9","0","0.10000","131","276","-145"
"1957","New Mexico St.","3","7","0","0.30000","157","215","-58"
"1935","Central Arkansas","4","3","0","0.57143","106","84","22"
"1936","Central Arkansas","8","0","0","1.00000","227","40","187"
"1937","Central Arkansas","8","1","0","0.88889","353","62","291"
"1938","Central Arkansas","7","1","0","0.87500","166","47","119"
"1939","Central Arkansas","5","2","2","0.66667","78","19","59"
"1940","Central Arkansas","8","1","1","0.85000","157","52","105"
"1941","Hardin-Simmons (TX)","7","3","1","0.68182","178","88","90"
"1942","Hardin-Simmons (TX)","8","0","1","0.94444","226","58","168"
"1946","Hardin-Simmons (TX)","11","0","0","1.00000","322","48","274"
"1947","Hardin-Simmons (TX)","8","3","0","0.72727","305","87","218"
"1948","Hardin-Simmons (TX)","6","2","3","0.68182","345","212","133"
"1949","Hardin-Simmons (TX)","6","4","1","0.59091","318","189","129"
"1950","Hardin-Simmons (TX)","5","5","0","0.50000","278","180","98"
"1951","Hardin-Simmons (TX)","6","6","0","0.50000","272","216","56"
"1952","Arizona","6","4","0","0.60000","285","155","130"
"1953","Arizona","4","5","1","0.45000","234","181","53"
"1954","Arizona","7","3","0","0.70000","385","215","170"
"1955","Arizona","5","4","1","0.55000","184","169","15"
"1956","Arizona","4","6","0","0.40000","180","182","-2"
"1958","New Mexico St.","4","6","0","0.40000","172","228","-56"
"1959","New Mexico St.","8","3","0","0.72727","360","158","202"
"1960","New Mexico St.","11","0","0","1.00000","394","113","281"
"1961","New Mexico St.","5","4","1","0.55000","341","195","146"
"1962","New Mexico St.","4","6","0","0.40000","191","259","-68"
"1963","New Mexico St.","3","6","1","0.35000","158","209","-51"
"1964","New Mexico St.","6","4","0","0.60000","131","171","-40"
"1965","New Mexico St.","8","2","0","0.80000","236","153","83"
"1966","New Mexico St.","7","3","0","0.70000","321","159","162"
"1967","New Mexico St.","7","2","1","0.75000","339","145","194"
"1968","New Mexico St.","5","5","0","0.50000","228","244","-16"
"1969","New Mexico St.","5","5","0","0.50000","199","235","-36"
"1970","New Mexico St.","4","6","0","0.40000","282","277","5"
"1971","New Mexico St.","5","5","1","0.50000","220","208","12"
"1972","New Mexico St.","2","9","0","0.18182","193","400","-207"
"1973","New Mexico St.","5","6","0","0.45455","244","289","-45"
"1974","New Mexico St.","5","6","0","0.45455","237","199","38"
"1975","New Mexico St.","5","6","0","0.45455","179","300","-121"
"1976","New Mexico St.","4","6","1","0.40909","152","241","-89"
"1977","New Mexico St.","4","7","0","0.36364","238","281","-43"
"1978","New Mexico St.","6","5","0","0.54545","274","296","-22"
"1979","New Mexico St.","2","9","0","0.18182","175","367","-192"
"1980","New Mexico St.","3","7","1","0.31818","212","247","-35"
"1981","New Mexico St.","3","8","0","0.27273","158","286","-128"
"1982","New Mexico St.","3","8","0","0.27273","216","353","-137"
"1983","New Mexico St.","5","6","0","0.45455","211","292","-81"
"1984","New Mexico St.","2","9","0","0.18182","185","336","-151"
"1985","New Mexico St.","1","10","0","0.09091","190","369","-179"
"1986","New Mexico St.","1","10","0","0.09091","189","416","-227"
"1987","New Mexico St.","2","9","0","0.18182","121","328","-207"
"1988","New Mexico St.","1","10","0","0.09091","171","377","-206"
"1989","New Mexico St.","0","11","0","0.00000","162","428","-266"
"1974","Angelo St. (TX)","5","6","0","0.45455","299","258","41"
"1975","Angelo St. (TX)","8","2","1","0.77273","337","76","261"
"1976","Angelo St. (TX)","5","5","1","0.50000","201","185","16"
"1977","Angelo St. (TX)","8","2","0","0.80000","232","129","103"
"1978","Angelo St. (TX)","14","0","0","1.00000","444","139","305"
"1979","Angelo St. (TX)","9","3","0","0.75000","217","154","63"
"1980","Angelo St. (TX)","8","2","1","0.77273","277","117","160"
"1981","Angelo St. (TX)","8","3","0","0.72727","319","231","88"
"1982","Stephen F. Austin (TX)","7","4","0","0.63636","256","188","68"
"1983","Stephen F. Austin (TX)","7","4","0","0.63636","273","206","67"
"1984","Stephen F. Austin (TX)","7","3","1","0.68182","257","166","91"
"1985","Stephen F. Austin (TX)","9","2","0","0.81818","364","184","180"
"1986","Stephen F. Austin (TX)","5","6","0","0.45455","288","266","22"
"1987","Stephen F. Austin (TX)","3","7","1","0.31818","142","182","-40"
"1988","Stephen F. Austin (TX)","10","3","0","0.76923","297","138","159"
"1990","New Mexico St.","1","10","0","0.09091","200","422","-222"
"1991","New Mexico St.","2","9","0","0.18182","224","350","-126"
"1992","New Mexico St.","6","5","0","0.54545","286","330","-44"
"1993","New Mexico St.","5","6","0","0.45455","231","350","-119"
"1994","New Mexico St.","3","8","0","0.27273","235","422","-187"
"1995","New Mexico St.","4","7","0","0.36364","349","389","-40"
"1996","New Mexico St.","1","10","0","0.09091","166","396","-230"
"1997","New Mexico St.","2","9","0","0.18182","221","398","-177"
"1998","New Mexico St.","3","8","0","0.27273","331","424","-93"
"1999","New Mexico St.","6","5","0","0.54545","311","274","37"
"2000","New Mexico St.","3","8","0","0.27273","295","357","-62"
"2001","New Mexico St.","5","7","0","0.41667","286","400","-114"
"2002","New Mexico St.","7","5","0","0.58333","327","328","-1"
"2003","New Mexico St.","3","9","0","0.25000","262","341","-79"
"2004","New Mexico St.","5","6","0","0.45455","273","355","-82"
"2006","Southeast Missouri St.","4","7","0","0.36364","203","307","-104"
"2007","Southeast Missouri St.","3","8","0","0.27273","225","387","-162"
"2008","Southeast Missouri St.","4","8","0","0.33333","262","364","-102"
"2009","Southeast Missouri St.","2","9","0","0.18182","240","299","-59"
"2010","Southeast Missouri St.","9","3","0","0.75000","323","258","65"
"2011","Southeast Missouri St.","3","8","0","0.27273","255","413","-158"
"2012","Southeast Missouri St.","3","8","0","0.27273","283","366","-83"
"2013","Southeast Missouri St.","3","9","0","0.25000","262","441","-179"
"1997","Kentucky","5","6","0","0.45455","348","362","-14"
"1998","Kentucky","7","5","0","0.58333","431","375","56"
"1999","Kentucky","6","6","0","0.50000","328","343","-15"
"2000","Kentucky","2","9","0","0.18182","254","383","-129"
"2003","Southeastern Louisiana","5","7","0","0.41667","369","382","-13"
"2004","Southeastern Louisiana","7","4","0","0.63636","425","271","154"
"2005","New Mexico St.","0","12","0","0.00000","198","465","-267"
"2006","New Mexico St.","4","8","0","0.33333","374","369","5"
"2007","New Mexico St.","4","9","0","0.30769","312","471","-159"
"2008","New Mexico St.","3","9","0","0.25000","266","409","-143"
"2007","UCLA","0","1","0","0.00000","16","17","-1"
"2009","New Mexico St.","3","10","0","0.23077","149","411","-262"
"2010","New Mexico St.","2","10","0","0.16667","188","474","-286"
"2011","New Mexico St.","4","9","0","0.30769","319","478","-159"
"2012","New Mexico St.","1","11","0","0.08333","224","473","-249"
"2004","Kent St. (OH)","5","6","0","0.45455","335","264","71"
"2005","Kent St. (OH)","1","10","0","0.09091","180","331","-151"
"2006","Kent St. (OH)","6","6","0","0.50000","214","241","-27"
"2007","Kent St. (OH)","3","9","0","0.25000","259","350","-91"
"2008","Kent St. (OH)","4","8","0","0.33333","308","380","-72"
"2009","Kent St. (OH)","5","7","0","0.41667","231","269","-38"
"2010","Kent St. (OH)","5","7","0","0.41667","256","275","-19"
"2013","New Mexico St.","2","10","0","0.16667","251","535","-284"
"1888","North Carolina","1","1","0","0.50000","50","25","25"
"1894","Kansas","4","3","1","0.56250","130","72","58"
"1895","Kansas","6","1","0","0.85714","192","14","178"
"1896","Kansas","7","3","0","0.70000","136","40","96"
"1869","Rutgers (NJ)","2","2","0","0.50000","18","18","0"
"1870","Rutgers (NJ)","2","2","0","0.50000","17","17","0"
"1872","Columbia (NY)","5","4","0","0.55556","22","16","6"
"1873","Rutgers (NJ)","7","4","1","0.62500","31","26","5"
"1874","Harvard (MA)","9","7","0","0.56250","54","41","13"
"1875","Harvard (MA)","12","6","2","0.65000","52","29","23"
"1876","Harvard (MA)","13","8","1","0.61364","45","29","16"
"1877","Harvard (MA)","9","7","3","0.55263","31","21","10"
"1878","Pennsylvania","14","9","5","0.58929","42","24","18"
"1879","Harvard (MA)","13","9","12","0.55882","46","27","19"
"1880","Harvard (MA)","18","11","4","0.60606","75","53","22"
"1881","Rutgers (NJ)","22","18","8","0.54167","70","47","23"
"1882","Rutgers (NJ)","41","28","2","0.59155","176","111","65"
"1883","Rutgers (NJ)","38","32","1","0.54225","1288","965","323"
"1884","Pennsylvania","47","29","5","0.61111","1728","1184","544"
"1885","Michigan","34","17","4","0.65455","1437","612","825"
"1886","Lehigh (PA)","48","21","4","0.68493","1850","637","1213"
"1887","California","67","35","3","0.65238","2660","935","1725"
"1888","Princeton (NJ)","70","56","6","0.55303","2468","1899","569"
"1889","Brown (RI)","82","51","11","0.60764","2879","1796","1083"
"1890","Brown (RI)","77","76","9","0.50309","3002","2455","547"
"1891","Southern California","94","76","13","0.54918","2813","2189","624"
"1892","Minnesota","93","80","9","0.53571","2972","2394","578"
"1893","Duke (NC)","79","94","9","0.45879","2176","2912","-736"
"1894","Colorado St.","50","62","4","0.44828","1161","1518","-357"
"1895","Boston (MA)","31","44","11","0.42442","692","1031","-339"
"1896","Rhode Island","54","62","12","0.46875","1126","1201","-75"
"1897","Boston (MA)","32","40","6","0.44872","792","785","7"
"1898","Miami (OH)","47","23","4","0.66216","921","644","277"
"1899","New Hampshire","33","32","6","0.50704","571","522","49"
"1900","New Hampshire","22","35","11","0.40441","442","686","-244"
"1901","Marshall (WV)","18","34","3","0.35455","302","917","-615"
"1902","Saint John's (MN)","9","22","4","0.31429","148","460","-312"
"1903","Wichita St. (KS)","14","25","2","0.36585","376","546","-170"
"1904","Oklahoma St.","11","14","1","0.44231","194","394","-200"
"1905","Miami (OH)","7","25","5","0.25676","245","494","-249"
"1906","Rensselaer Tech (NY)","3","7","4","0.35714","92","107","-15"
"1907","Marshall (WV)","5","10","2","0.35294","71","238","-167"
"1908","Fort Hays St. (KS)","5","6","1","0.45833","56","91","-35"
"1909","Fort Hays St. (KS)","1","3","1","0.30000","12","68","-56"
"1910","Texas St.","0","1","0","0.00000","0","19","-19"
"1912","Fort Hays St. (KS)","1","2","0","0.33333","20","132","-112"
"1913","Eureka (IL)","1","6","0","0.14286","39","203","-164"
"1914","Eureka (IL)","3","4","0","0.42857","57","201","-144"
"1915","Texas St.","1","1","1","0.50000","13","20","-7"
"1916","Texas St.","0","2","1","0.16667","0","106","-106"
"1917","Boston (MA)","4","4","0","0.50000","73","136","-63"
"1918","Monmouth (IL)","1","7","0","0.12500","26","137","-111"
"1930","Troy (AL)","1","2","0","0.33333","7","73","-66"
"2013","Grambling St. (LA)","0","1","0","0.00000","0","0","0"
"1891","North Carolina","0","2","0","0.00000","10","10","0"
"1894","North Carolina","6","3","0","0.66667","178","71","107"
"1895","North Carolina","7","1","1","0.83333","146","17","129"
"1896","West Virginia","3","7","2","0.33333","14","101","-87"
"1897","Pittsburgh (PA)","1","3","0","0.25000","13","91","-78"
"1913","North Carolina","5","4","0","0.55556","91","76","15"
"1914","North Carolina","10","1","0","0.90909","359","52","307"
"1915","North Carolina","4","3","1","0.56250","105","98","7"
"1896","North Carolina","3","4","1","0.43750","106","100","6"
"1891","Rutgers (NJ)","8","6","0","0.57143","265","137","128"
"1896","Cincinnati (OH)","4","3","1","0.56250","88","68","20"
"1897","North Carolina","7","3","0","0.70000","150","53","97"
"1898","North Carolina","9","0","0","1.00000","187","8","179"
"1899","North Carolina","7","3","1","0.68182","173","58","115"
"1900","North Carolina","4","1","3","0.68750","163","22","141"
"1901","North Carolina","7","2","0","0.77778","198","45","153"
"1902","North Carolina","5","1","3","0.72222","122","34","88"
"1903","North Carolina","6","3","0","0.66667","137","72","65"
"1907","New York (NY)","5","2","0","0.71429","69","69","0"
"1908","New York (NY)","2","3","2","0.42857","27","35","-8"
"1909","New York (NY)","6","1","1","0.81250","141","20","121"
"1910","New York (NY)","2","4","1","0.35714","47","59","-12"
"1911","New York (NY)","1","3","3","0.35714","16","42","-26"
"1912","New York (NY)","2","6","0","0.25000","32","174","-142"
"1915","Kansas","6","2","0","0.75000","153","79","74"
"1916","Kansas","4","3","1","0.56250","68","72","-4"
"1917","Kansas","6","2","0","0.75000","126","46","80"
"1902","Virginia Tech","3","2","1","0.58333","89","23","66"
"1904","North Carolina","5","2","2","0.66667","170","34","136"
"1905","Washington & Lee (VA)","7","2","0","0.77778","145","36","109"
"1906","Washington & Lee (VA)","4","1","1","0.75000","59","14","45"
"1907","Washington & Lee (VA)","3","2","1","0.58333","44","17","27"
"1908","Washington & Lee (VA)","5","1","1","0.78571","144","71","73"
"1909","Tulane (LA)","4","3","2","0.55556","40","50","-10"
"1923","New Mexico St.","9","0","0","1.00000","218","17","201"
"1924","New Mexico St.","7","3","0","0.70000","241","30","211"
"1925","New Mexico St.","5","3","1","0.61111","151","75","76"
"1903","Cornell (NY)","6","3","1","0.65000","120","103","17"
"1905","North Carolina","4","3","1","0.56250","82","90","-8"
"1906","Colgate (NY)","4","2","2","0.62500","102","56","46"
"1907","Colgate (NY)","4","4","1","0.50000","108","61","47"
"1910","Oregon","4","1","0","0.80000","172","11","161"
"1911","Oregon","3","2","0","0.60000","59","51","8"
"1904","North Carolina St.","3","1","2","0.66667","89","11","78"
"1905","Colorado","8","1","0","0.88889","359","28","331"
"1906","North Carolina","1","4","2","0.28571","18","83","-65"
"1907","Auburn (AL)","6","2","1","0.72222","185","30","155"
"1909","Washington St.","4","1","0","0.80000","159","17","142"
"1907","North Carolina","4","4","1","0.50000","93","97","-4"
"1908","North Carolina","3","3","3","0.50000","62","71","-9"
"1909","North Carolina St.","6","1","0","0.85714","115","24","91"
"1910","North Carolina St.","4","0","2","0.83333","125","12","113"
"1911","North Carolina St.","5","3","0","0.62500","84","34","50"
"1912","North Carolina St.","4","3","0","0.57143","54","105","-51"
"1913","North Carolina St.","6","1","0","0.85714","155","27","128"
"1909","North Carolina","5","2","0","0.71429","54","18","36"
"1910","North Carolina","3","6","0","0.33333","70","67","3"
"1912","Massachusetts","2","5","2","0.33333","76","126","-50"
"1913","Massachusetts","4","3","0","0.57143","96","41","55"
"1914","Massachusetts","2","5","0","0.28571","36","84","-48"
"1915","Massachusetts","4","2","2","0.62500","113","54","59"
"1908","Georgia","5","2","1","0.68750","71","45","26"
"1909","Virginia Tech","6","1","0","0.85714","148","27","121"
"1910","Virginia Tech","6","2","0","0.75000","109","18","91"
"1911","North Carolina","6","1","1","0.81250","66","31","35"
"1912","Virginia Tech","5","4","0","0.55556","202","92","110"
"1913","Virginia Tech","7","1","1","0.83333","175","60","115"
"1914","Virginia Tech","6","2","1","0.72222","143","33","110"
"1915","Virginia Tech","4","4","0","0.50000","91","109","-18"
"1920","Louisiana St.","5","3","1","0.61111","206","63","143"
"1921","Louisiana St.","6","1","1","0.81250","180","56","124"
"1925","South Carolina","7","3","0","0.70000","150","27","123"
"1926","South Carolina","6","4","0","0.60000","159","62","97"
"1928","William & Mary (VA)","6","3","2","0.63636","218","54","164"
"1929","William & Mary (VA)","8","2","0","0.80000","250","77","173"
"1930","William & Mary (VA)","7","2","1","0.75000","247","39","208"
"1936","William & Mary (VA)","1","8","0","0.11111","51","112","-61"
"1937","William & Mary (VA)","4","5","0","0.44444","129","103","26"
"1938","William & Mary (VA)","3","7","0","0.30000","105","154","-49"
"1912","North Carolina","3","4","1","0.43750","85","168","-83"
"1916","North Carolina","5","4","0","0.55556","134","93","41"
"1919","North Carolina","4","3","1","0.56250","49","94","-45"
"1922","Virginia","4","4","1","0.50000","102","60","42"
"1912","Stevens Tech (NJ)","1","9","0","0.10000","56","205","-149"
"1913","Stevens Tech (NJ)","2","6","0","0.25000","49","149","-100"
"1914","Stevens Tech (NJ)","1","7","1","0.16667","43","268","-225"
"1920","North Carolina","2","6","0","0.25000","16","91","-75"
"1921","Tulane (LA)","4","6","0","0.40000","84","97","-13"
"1921","North Carolina","5","2","2","0.66667","85","75","10"
"1922","North Carolina","9","1","0","0.90000","200","72","128"
"1923","North Carolina","5","3","1","0.61111","77","85","-8"
"1924","North Carolina","4","5","0","0.44444","38","57","-19"
"1925","North Carolina","7","1","1","0.83333","123","20","103"
"1926","North Carolina","4","5","0","0.44444","59","74","-15"
"1927","North Carolina","4","6","0","0.40000","86","107","-21"
"1928","North Carolina","5","3","2","0.60000","186","115","71"
"1929","North Carolina","9","1","0","0.90000","346","60","286"
"1930","North Carolina","5","3","2","0.60000","153","103","50"
"1931","North Carolina","4","3","3","0.55000","114","92","22"
"1932","North Carolina","3","5","2","0.40000","84","142","-58"
"1933","North Carolina","4","5","0","0.44444","71","90","-19"
"1927","Bucknell (PA)","6","3","1","0.65000","200","104","96"
"1928","Bucknell (PA)","5","2","3","0.65000","124","48","76"
"1929","Bucknell (PA)","8","2","0","0.80000","236","37","199"
"1930","Bucknell (PA)","6","3","0","0.66667","163","59","104"
"1931","Bucknell (PA)","6","0","3","0.83333","148","47","101"
"1932","Bucknell (PA)","4","4","1","0.50000","82","100","-18"
"1933","Bucknell (PA)","7","2","0","0.77778","203","57","146"
"1934","North Carolina","7","1","1","0.83333","125","34","91"
"1935","North Carolina","8","1","0","0.88889","270","44","226"
"1936","Cornell (NY)","3","5","0","0.37500","145","132","13"
"1937","Cornell (NY)","5","2","1","0.68750","146","82","64"
"1938","Cornell (NY)","5","1","1","0.78571","110","45","65"
"1939","Cornell (NY)","8","0","0","1.00000","197","52","145"
"1940","Cornell (NY)","6","2","0","0.75000","201","38","163"
"1941","Cornell (NY)","5","3","0","0.62500","88","65","23"
"1942","Cornell (NY)","3","5","1","0.38889","95","148","-53"
"1943","Cornell (NY)","6","4","0","0.60000","158","138","20"
"1944","Cornell (NY)","5","4","0","0.55556","131","130","1"
"1945","North Carolina","5","5","0","0.50000","113","149","-36"
"1946","North Carolina","8","2","1","0.77273","271","129","142"
"1947","North Carolina","8","2","0","0.80000","210","93","117"
"1948","North Carolina","9","1","1","0.86364","261","94","167"
"1949","North Carolina","7","4","0","0.63636","190","205","-15"
"1950","North Carolina","3","5","2","0.40000","101","122","-21"
"1951","North Carolina","2","8","0","0.20000","120","224","-104"
"1952","North Carolina","2","6","0","0.25000","110","206","-96"
"1936","North Carolina","8","2","0","0.80000","190","100","90"
"1937","North Carolina","7","1","1","0.83333","173","39","134"
"1938","North Carolina","6","2","1","0.72222","117","37","80"
"1939","North Carolina","8","1","1","0.85000","228","52","176"
"1940","North Carolina","6","4","0","0.60000","159","98","61"
"1941","North Carolina","3","7","0","0.30000","130","172","-42"
"1946","Florida","0","9","0","0.00000","104","264","-160"
"1947","Florida","4","5","1","0.45000","125","156","-31"
"1948","Florida","5","5","0","0.50000","213","206","7"
"1949","Florida","4","5","1","0.45000","180","218","-38"
"1952","Tulane (LA)","5","5","0","0.50000","188","146","42"
"1953","Tulane (LA)","1","8","1","0.15000","129","228","-99"
"1942","North Carolina","5","2","2","0.66667","149","102","47"
"1946","Oklahoma","8","3","0","0.72727","309","120","189"
"1947","Maryland","7","2","2","0.72727","207","121","86"
"1948","Maryland","6","4","0","0.60000","207","132","75"
"1949","Maryland","9","1","0","0.90000","266","82","184"
"1950","Maryland","7","2","1","0.75000","274","120","154"
"1951","Maryland","10","0","0","1.00000","381","75","306"
"1952","Maryland","7","2","0","0.77778","218","85","133"
"1953","Maryland","10","1","0","0.90909","298","38","260"
"1954","Maryland","7","2","1","0.75000","280","67","213"
"1955","Maryland","10","1","0","0.90909","217","77","140"
"1956","North Carolina","0","9","1","0.05000","99","183","-84"
"1957","North Carolina","6","4","0","0.60000","142","129","13"
"1958","North Carolina","6","4","0","0.60000","195","109","86"
"1943","North Carolina","6","3","0","0.66667","173","93","80"
"1946","Western Carolina (NC)","6","3","1","0.65000","135","87","48"
"1947","Western Carolina (NC)","3","5","1","0.38889","93","123","-30"
"1948","Western Carolina (NC)","7","3","0","0.70000","198","79","119"
"1949","Western Carolina (NC)","8","3","0","0.72727","186","99","87"
"1950","Western Carolina (NC)","3","6","0","0.33333","102","174","-72"
"1951","Western Carolina (NC)","3","6","0","0.33333","102","183","-81"
"1952","Western Carolina (NC)","2","8","0","0.20000","76","215","-139"
"1953","Western Carolina (NC)","1","9","0","0.10000","84","152","-68"
"1954","Western Carolina (NC)","4","5","1","0.45000","217","164","53"
"1955","Western Carolina (NC)","1","8","1","0.15000","60","196","-136"
"1936","Davidson (NC)","5","4","0","0.55556","144","97","47"
"1937","Davidson (NC)","2","8","0","0.20000","56","142","-86"
"1938","Davidson (NC)","4","6","0","0.40000","70","163","-93"
"1939","Davidson (NC)","2","7","0","0.22222","81","166","-85"
"1940","Davidson (NC)","5","5","0","0.50000","153","205","-52"
"1941","Davidson (NC)","1","6","3","0.25000","63","176","-113"
"1942","Davidson (NC)","2","6","1","0.27778","68","167","-99"
"1943","Davidson (NC)","0","5","0","0.00000","15","122","-107"
"1944","North Carolina","1","7","1","0.16667","33","173","-140"
"1953","North Carolina","4","6","0","0.40000","173","187","-14"
"1954","North Carolina","4","5","1","0.45000","140","222","-82"
"1955","North Carolina","3","7","0","0.30000","117","218","-101"
"1959","North Carolina","5","5","0","0.50000","198","142","56"
"1960","North Carolina","3","7","0","0.30000","117","161","-44"
"1961","North Carolina","5","5","0","0.50000","121","141","-20"
"1962","North Carolina","3","7","0","0.30000","112","206","-94"
"1963","North Carolina","9","2","0","0.81818","197","103","94"
"1964","North Carolina","5","5","0","0.50000","178","135","43"
"1965","North Carolina","4","6","0","0.40000","146","195","-49"
"1966","North Carolina","2","8","0","0.20000","90","196","-106"
"1967","North Carolina","2","8","0","0.20000","104","182","-78"
"1968","North Carolina","3","7","0","0.30000","178","272","-94"
"1969","North Carolina","5","5","0","0.50000","200","164","36"
"1970","North Carolina","8","4","0","0.66667","372","227","145"
"1971","North Carolina","9","3","0","0.75000","288","152","136"
"1972","North Carolina","11","1","0","0.91667","324","210","114"
"1973","North Carolina","4","7","0","0.36364","242","266","-24"
"1974","North Carolina","7","5","0","0.58333","364","279","85"
"1975","North Carolina","3","7","1","0.31818","207","272","-65"
"1976","North Carolina","9","3","0","0.75000","243","220","23"
"1977","North Carolina","8","3","1","0.70833","251","102","149"
"1978","Virginia Tech","4","7","0","0.36364","162","225","-63"
"1979","Virginia Tech","5","6","0","0.45455","224","222","2"
"1980","Virginia Tech","8","4","0","0.66667","249","129","120"
"1981","Virginia Tech","7","4","0","0.63636","232","128","104"
"1982","Virginia Tech","7","4","0","0.63636","211","141","70"
"1983","Virginia Tech","9","2","0","0.81818","301","91","210"
"1984","Virginia Tech","8","4","0","0.66667","253","150","103"
"1985","Virginia Tech","6","5","0","0.54545","274","219","55"
"1986","Virginia Tech","10","1","1","0.87500","286","208","78"
"1987","Wake Forest (NC)","7","4","0","0.63636","201","185","16"
"1988","Wake Forest (NC)","6","4","1","0.59091","282","238","44"
"1989","Wake Forest (NC)","2","8","1","0.22727","194","319","-125"
"1990","Wake Forest (NC)","3","8","0","0.27273","247","351","-104"
"1991","Wake Forest (NC)","3","8","0","0.27273","195","300","-105"
"1992","Wake Forest (NC)","8","4","0","0.66667","266","260","6"
"1974","Miami (OH)","10","0","1","0.95455","303","86","217"
"1975","Miami (OH)","11","1","0","0.91667","306","141","165"
"1976","Miami (OH)","3","8","0","0.27273","160","208","-48"
"1977","Miami (OH)","10","1","0","0.90909","262","173","89"
"1978","North Carolina","5","6","0","0.45455","199","218","-19"
"1979","North Carolina","8","3","1","0.70833","290","167","123"
"1980","North Carolina","11","1","0","0.91667","297","130","167"
"1981","North Carolina","10","2","0","0.83333","375","150","225"
"1982","North Carolina","8","4","0","0.66667","348","149","199"
"1983","North Carolina","8","4","0","0.66667","337","216","121"
"1984","North Carolina","5","5","1","0.50000","234","274","-40"
"1985","North Carolina","5","6","0","0.45455","224","223","1"
"1986","North Carolina","7","4","1","0.62500","305","279","26"
"1987","North Carolina","5","6","0","0.45455","214","207","7"
"1988","Kent St. (OH)","5","6","0","0.45455","256","250","6"
"1989","Kent St. (OH)","0","11","0","0.00000","179","377","-198"
"1990","Kent St. (OH)","2","9","0","0.18182","177","328","-151"
"1983","Appalachian St. (NC)","6","5","0","0.54545","212","265","-53"
"1985","Tulane (LA)","1","10","0","0.09091","166","334","-168"
"1986","Tulane (LA)","4","7","0","0.36364","265","334","-69"
"1987","Tulane (LA)","6","6","0","0.50000","370","376","-6"
"1988","North Carolina","1","10","0","0.09091","217","391","-174"
"1989","North Carolina","1","10","0","0.09091","138","297","-159"
"1990","North Carolina","6","4","1","0.59091","227","186","41"
"1991","North Carolina","7","4","0","0.63636","282","199","83"
"1992","North Carolina","9","3","0","0.75000","289","233","56"
"1993","North Carolina","10","3","0","0.76923","431","253","178"
"1994","North Carolina","8","4","0","0.66667","374","267","107"
"1995","North Carolina","7","5","0","0.58333","284","220","64"
"1996","North Carolina","10","2","0","0.83333","357","123","234"
"1997","North Carolina","10","1","0","0.90909","306","143","163"
"1998","Texas","9","3","0","0.75000","437","337","100"
"1999","Texas","9","5","0","0.64286","450","295","155"
"2000","Texas","9","3","0","0.75000","455","232","223"
"2001","Texas","11","2","0","0.84615","517","207","310"
"2002","Texas","11","2","0","0.84615","439","212","227"
"2003","Texas","10","3","0","0.76923","533","280","253"
"2004","Texas","11","1","0","0.91667","423","215","208"
"2005","Texas","13","0","0","1.00000","652","213","439"
"2006","Texas","10","3","0","0.76923","467","238","229"
"2007","Texas","10","3","0","0.76923","484","329","155"
"2008","Texas","12","1","0","0.92308","551","244","307"
"2009","Texas","13","1","0","0.92857","550","234","316"
"2010","Texas","5","7","0","0.41667","285","284","1"
"2011","Texas","8","5","0","0.61538","365","289","76"
"2012","Texas","9","4","0","0.69231","464","380","84"
"2013","Texas","8","5","0","0.61538","381","336","45"
"1987","Louisiana Tech","3","8","0","0.27273","108","197","-89"
"1997","North Carolina","1","0","0","1.00000","42","3","39"
"1998","North Carolina","7","5","0","0.58333","288","283","5"
"1999","North Carolina","3","8","0","0.27273","186","272","-86"
"2000","North Carolina","6","5","0","0.54545","269","284","-15"
"2001","North Carolina","8","5","0","0.61538","337","271","66"
"2002","North Carolina","3","9","0","0.25000","223","421","-198"
"2003","North Carolina","2","10","0","0.16667","317","459","-142"
"2004","North Carolina","6","6","0","0.50000","319","382","-63"
"2005","North Carolina","5","6","0","0.45455","198","288","-90"
"2006","North Carolina","3","9","0","0.25000","216","366","-150"
"1995","Miami (FL)","8","3","0","0.72727","294","201","93"
"1996","Miami (FL)","9","3","0","0.75000","368","210","158"
"1997","Miami (FL)","5","6","0","0.45455","314","285","29"
"1998","Miami (FL)","9","3","0","0.75000","448","298","150"
"1999","Miami (FL)","9","4","0","0.69231","432","220","212"
"2000","Miami (FL)","11","1","0","0.91667","506","190","316"
"2007","North Carolina","4","8","0","0.33333","254","294","-40"
"2008","North Carolina","0","5","0","0.00000","360","275","85"
"2009","North Carolina","0","5","0","0.00000","309","222","87"
"2010","North Carolina","8","5","0","0.61538","329","302","27"
"2011","North Carolina","7","6","0","0.53846","364","323","41"
"2008","Southern Mississippi","7","6","0","0.53846","398","313","85"
"2009","Southern Mississippi","7","6","0","0.53846","428","336","92"
"2010","Southern Mississippi","8","5","0","0.61538","479","384","95"
"2011","Southern Mississippi","12","2","0","0.85714","516","291","225"
"2012","North Carolina","8","4","0","0.66667","487","308","179"
"2013","North Carolina","7","6","0","0.53846","425","318","107"
"1892","North Carolina St.","1","0","0","1.00000","14","6","8"
"1896","North Carolina St.","1","0","0","1.00000","6","0","6"
"1897","North Carolina St.","1","2","0","0.33333","19","58","-39"
"1893","North Carolina St.","2","0","0","1.00000","25","6","19"
"1894","North Carolina St.","0","2","0","0.00000","0","60","-60"
"1895","North Carolina St.","2","2","1","0.50000","76","82","-6"
"1888","Wake Forest (NC)","1","1","0","0.50000","32","33","-1"
"1889","Wake Forest (NC)","2","2","0","0.50000","58","76","-18"
"1898","North Carolina St.","1","1","0","0.50000","21","34","-13"
"1899","North Carolina St.","1","2","2","0.40000","29","55","-26"
"1900","North Carolina St.","0","5","0","0.00000","7","69","-62"
"1901","North Carolina St.","1","2","0","0.33333","27","75","-48"
"1902","Georgia Tech","0","6","2","0.12500","23","122","-99"
"1902","North Carolina St.","3","4","2","0.44444","81","42","39"
"1903","North Carolina St.","4","4","0","0.50000","142","74","68"
"1904","North Carolina St.","3","1","2","0.66667","89","11","78"
"1905","Colorado","8","1","0","0.88889","359","28","331"
"1906","North Carolina","1","4","2","0.28571","18","83","-65"
"1907","Auburn (AL)","6","2","1","0.72222","185","30","155"
"1909","Washington St.","4","1","0","0.80000","159","17","142"
"1903","Sewanee (TN)","7","1","0","0.87500","179","10","169"
"1904","Sewanee (TN)","7","1","0","0.87500","180","37","143"
"1905","North Carolina St.","4","1","1","0.75000","65","10","55"
"1905","Drake (IA)","4","4","0","0.50000","151","141","10"
"1906","North Carolina St.","3","1","4","0.62500","100","10","90"
"1907","North Carolina St.","6","0","1","0.92857","81","13","68"
"1908","North Carolina St.","6","1","0","0.85714","157","11","146"
"1908","North Carolina","3","3","3","0.50000","62","71","-9"
"1909","North Carolina St.","6","1","0","0.85714","115","24","91"
"1910","North Carolina St.","4","0","2","0.83333","125","12","113"
"1911","North Carolina St.","5","3","0","0.62500","84","34","50"
"1912","North Carolina St.","4","3","0","0.57143","54","105","-51"
"1913","North Carolina St.","6","1","0","0.85714","155","27","128"
"1914","North Carolina St.","3","3","1","0.50000","119","53","66"
"1915","North Carolina St.","4","3","1","0.56250","90","121","-31"
"1916","North Carolina St.","2","5","0","0.28571","24","191","-167"
"1917","North Carolina St.","6","2","1","0.72222","112","71","41"
"1921","North Carolina St.","3","3","3","0.50000","61","98","-37"
"1922","North Carolina St.","4","6","0","0.40000","101","92","9"
"1923","North Carolina St.","3","7","0","0.30000","56","134","-78"
"1918","North Carolina St.","1","3","0","0.25000","54","174","-120"
"1915","Davidson (NC)","4","3","1","0.56250","156","108","48"
"1916","Davidson (NC)","5","3","1","0.61111","160","54","106"
"1917","Davidson (NC)","6","4","0","0.60000","253","116","137"
"1918","Davidson (NC)","2","1","1","0.62500","35","7","28"
"1919","North Carolina St.","7","2","0","0.77778","351","75","276"
"1920","North Carolina St.","7","3","0","0.70000","284","112","172"
"1924","North Carolina St.","2","6","2","0.30000","43","147","-104"
"1925","Nevada","4","3","1","0.56250","107","115","-8"
"1926","Nevada","4","4","0","0.50000","116","119","-3"
"1927","Nevada","2","6","1","0.27778","54","209","-155"
"1928","Nevada","0","7","1","0.06250","31","170","-139"
"1936","Santa Clara (CA)","8","1","0","0.88889","139","36","103"
"1937","Santa Clara (CA)","9","0","0","1.00000","163","9","154"
"1938","Santa Clara (CA)","6","2","0","0.75000","97","26","71"
"1939","Santa Clara (CA)","5","1","3","0.72222","117","40","77"
"1940","Santa Clara (CA)","6","1","1","0.81250","154","46","108"
"1941","Santa Clara (CA)","6","3","0","0.66667","170","103","67"
"1942","Santa Clara (CA)","7","2","0","0.77778","101","52","49"
"1945","California","4","5","1","0.45000","93","107","-14"
"1956","Air Force (CO)","6","2","1","0.72222","293","101","192"
"1957","Air Force (CO)","3","6","1","0.35000","125","184","-59"
"1925","North Carolina St.","3","5","1","0.38889","51","74","-23"
"1926","North Carolina St.","4","6","0","0.40000","66","102","-36"
"1927","North Carolina St.","9","1","0","0.90000","216","69","147"
"1928","North Carolina St.","4","5","1","0.45000","157","100","57"
"1929","North Carolina St.","1","8","0","0.11111","44","207","-163"
"1934","Virginia","3","6","0","0.33333","70","151","-81"
"1935","Virginia","1","5","4","0.30000","39","133","-94"
"1936","Virginia","2","7","0","0.22222","73","222","-149"
"1930","North Carolina St.","2","8","0","0.20000","54","125","-71"
"1932","Hanover (IN)","4","3","1","0.56250","98","96","2"
"1933","Hanover (IN)","6","2","0","0.75000","138","57","81"
"1934","Hanover (IN)","7","2","0","0.77778","130","79","51"
"1935","Hanover (IN)","2","5","1","0.31250","71","248","-177"
"1936","Hanover (IN)","1","6","0","0.14286","21","87","-66"
"1937","Hanover (IN)","5","3","0","0.62500","65","87","-22"
"1938","Hanover (IN)","5","2","0","0.71429","84","65","19"
"1939","Hanover (IN)","4","4","0","0.50000","43","78","-35"
"1940","Hanover (IN)","1","8","0","0.11111","59","230","-171"
"1941","Hanover (IN)","1","7","0","0.12500","25","178","-153"
"1942","Hanover (IN)","2","5","0","0.28571","96","208","-112"
"1931","North Carolina St.","3","6","0","0.33333","60","104","-44"
"1932","North Carolina St.","6","1","2","0.77778","97","29","68"
"1933","North Carolina St.","1","5","3","0.27778","23","62","-39"
"1936","Duquesne (PA)","8","2","0","0.80000","140","28","112"
"1937","Duquesne (PA)","6","4","0","0.60000","151","52","99"
"1938","Duquesne (PA)","4","6","0","0.40000","96","114","-18"
"1931","Notre Dame (IN)","6","2","1","0.72222","215","40","175"
"1932","Notre Dame (IN)","7","2","0","0.77778","255","31","224"
"1933","Notre Dame (IN)","3","5","1","0.38889","32","80","-48"
"1934","North Carolina St.","2","6","1","0.27778","44","112","-68"
"1935","North Carolina St.","6","4","0","0.60000","87","76","11"
"1936","North Carolina St.","3","7","0","0.30000","79","84","-5"
"1932","Davidson (NC)","4","4","1","0.50000","82","52","30"
"1933","Davidson (NC)","6","2","1","0.72222","109","70","39"
"1934","Davidson (NC)","4","4","1","0.50000","105","123","-18"
"1935","Davidson (NC)","4","3","2","0.55556","69","80","-11"
"1937","North Carolina St.","5","3","1","0.61111","91","92","-1"
"1938","North Carolina St.","3","7","1","0.31818","59","100","-41"
"1939","North Carolina St.","2","8","0","0.20000","49","191","-142"
"1940","North Carolina St.","3","6","0","0.33333","120","161","-41"
"1941","North Carolina St.","4","5","2","0.45455","122","143","-21"
"1942","North Carolina St.","4","4","2","0.50000","70","142","-72"
"1943","North Carolina St.","3","6","0","0.33333","78","227","-149"
"1944","South Carolina","3","4","2","0.44444","135","106","29"
"1942","Appalachian St. (NC)","5","2","1","0.68750","140","67","73"
"1944","North Carolina St.","7","2","0","0.77778","173","63","110"
"1945","North Carolina St.","3","6","0","0.33333","131","144","-13"
"1946","North Carolina St.","8","3","0","0.72727","226","101","125"
"1947","North Carolina St.","5","3","1","0.61111","92","57","35"
"1948","North Carolina St.","3","6","1","0.35000","107","128","-21"
"1949","North Carolina St.","3","7","0","0.30000","134","192","-58"
"1950","North Carolina St.","5","4","1","0.55000","92","119","-27"
"1951","North Carolina St.","3","7","0","0.30000","141","203","-62"
"1937","Elon (NC)","7","1","0","0.87500","144","57","87"
"1938","Elon (NC)","6","3","0","0.66667","118","78","40"
"1939","Elon (NC)","5","5","0","0.50000","132","126","6"
"1940","Elon (NC)","5","2","1","0.68750","115","56","59"
"1941","Elon (NC)","8","1","0","0.88889","215","70","145"
"1952","North Carolina St.","3","7","0","0.30000","91","336","-245"
"1953","North Carolina St.","1","9","0","0.10000","80","265","-185"
"1954","North Carolina St.","2","8","0","0.20000","104","193","-89"
"1955","North Carolina St.","4","5","1","0.45000","206","193","13"
"1956","North Carolina St.","3","7","0","0.30000","94","169","-75"
"1957","North Carolina St.","7","1","2","0.80000","155","67","88"
"1958","North Carolina St.","2","7","1","0.25000","120","160","-40"
"1959","North Carolina St.","1","9","0","0.10000","117","201","-84"
"1960","North Carolina St.","6","3","1","0.65000","148","113","35"
"1961","North Carolina St.","4","6","0","0.40000","129","149","-20"
"1962","North Carolina St.","3","6","1","0.35000","108","139","-31"
"1963","North Carolina St.","8","3","0","0.72727","188","107","81"
"1964","North Carolina St.","5","5","0","0.50000","119","194","-75"
"1965","North Carolina St.","6","4","0","0.60000","134","110","24"
"1966","North Carolina St.","5","5","0","0.50000","191","168","23"
"1967","North Carolina St.","9","2","0","0.81818","214","94","120"
"1968","North Carolina St.","6","4","0","0.60000","205","185","20"
"1969","North Carolina St.","3","6","1","0.35000","183","201","-18"
"1970","North Carolina St.","3","7","1","0.31818","90","179","-89"
"1971","North Carolina St.","3","8","0","0.27273","147","274","-127"
"1969","William & Mary (VA)","3","7","0","0.30000","146","250","-104"
"1970","William & Mary (VA)","5","7","0","0.41667","218","335","-117"
"1971","William & Mary (VA)","5","6","0","0.45455","278","241","37"
"1972","North Carolina St.","8","3","1","0.70833","409","240","169"
"1973","North Carolina St.","9","3","0","0.75000","396","251","145"
"1974","North Carolina St.","9","2","1","0.79167","317","241","76"
"1975","North Carolina St.","7","4","1","0.62500","260","210","50"
"1977","Arkansas","11","1","0","0.91667","389","101","288"
"1978","Arkansas","9","2","1","0.79167","336","147","189"
"1979","Arkansas","10","2","0","0.83333","284","132","152"
"1980","Arkansas","7","5","0","0.58333","272","236","36"
"1981","Arkansas","8","4","0","0.66667","325","219","106"
"1982","Arkansas","9","2","1","0.79167","303","139","164"
"1983","Arkansas","6","5","0","0.54545","204","172","32"
"1984","Minnesota","4","7","0","0.36364","194","316","-122"
"1985","Minnesota","6","5","0","0.54545","273","227","46"
"1986","Notre Dame (IN)","5","6","0","0.45455","299","219","80"
"1987","Notre Dame (IN)","8","4","0","0.66667","339","218","121"
"1988","Notre Dame (IN)","12","0","0","1.00000","393","156","237"
"1989","Notre Dame (IN)","12","1","0","0.92308","427","189","238"
"1990","Notre Dame (IN)","9","3","0","0.75000","359","259","100"
"1991","Notre Dame (IN)","10","3","0","0.76923","465","289","176"
"1992","Notre Dame (IN)","10","1","1","0.87500","437","181","256"
"1993","Notre Dame (IN)","11","1","0","0.91667","427","215","212"
"1994","Notre Dame (IN)","6","5","1","0.54167","342","280","62"
"1995","Notre Dame (IN)","9","3","0","0.75000","392","247","145"
"1996","Notre Dame (IN)","8","3","0","0.72727","407","181","226"
"1999","South Carolina","0","11","0","0.00000","87","278","-191"
"2000","South Carolina","8","4","0","0.66667","283","181","102"
"2001","South Carolina","9","3","0","0.75000","310","230","80"
"2002","South Carolina","5","7","0","0.41667","225","262","-37"
"2003","South Carolina","5","7","0","0.41667","268","314","-46"
"2004","South Carolina","6","5","0","0.54545","243","229","14"
"1976","North Carolina St.","3","7","1","0.31818","205","258","-53"
"1977","North Carolina St.","8","4","0","0.66667","259","181","78"
"1978","North Carolina St.","9","3","0","0.75000","280","208","72"
"1979","North Carolina St.","7","4","0","0.63636","258","213","45"
"1980","North Carolina St.","6","5","0","0.54545","222","212","10"
"1981","North Carolina St.","4","7","0","0.36364","182","223","-41"
"1982","North Carolina St.","6","5","0","0.54545","206","255","-49"
"1978","Miami (OH)","8","2","1","0.77273","228","161","67"
"1979","Miami (OH)","6","5","0","0.54545","223","142","81"
"1980","Miami (OH)","5","6","0","0.45455","241","192","49"
"1981","Miami (OH)","8","2","1","0.77273","199","154","45"
"1982","Miami (OH)","7","4","0","0.63636","195","121","74"
"1983","North Carolina St.","3","8","0","0.27273","236","246","-10"
"1984","North Carolina St.","3","8","0","0.27273","263","311","-48"
"1985","North Carolina St.","3","8","0","0.27273","186","305","-119"
"1978","Furman (SC)","8","3","0","0.72727","322","195","127"
"1979","Furman (SC)","5","6","0","0.45455","281","313","-32"
"1980","Furman (SC)","9","1","1","0.86364","284","177","107"
"1981","Furman (SC)","8","3","0","0.72727","293","210","83"
"1982","Furman (SC)","9","3","0","0.75000","290","158","132"
"1983","Furman (SC)","10","2","1","0.80769","422","137","285"
"1984","Furman (SC)","8","3","0","0.72727","363","180","183"
"1985","Furman (SC)","12","2","0","0.85714","520","231","289"
"1986","North Carolina St.","8","3","1","0.70833","328","274","54"
"1987","North Carolina St.","4","7","0","0.36364","212","302","-90"
"1988","North Carolina St.","8","3","1","0.70833","312","165","147"
"1989","North Carolina St.","7","5","0","0.58333","290","230","60"
"1990","North Carolina St.","7","5","0","0.58333","298","189","109"
"1991","North Carolina St.","9","3","0","0.75000","304","222","82"
"1992","North Carolina St.","9","3","1","0.73077","335","211","124"
"1993","North Carolina St.","7","5","0","0.58333","278","327","-49"
"1994","North Carolina St.","9","3","0","0.75000","305","275","30"
"1995","North Carolina St.","3","8","0","0.27273","260","354","-94"
"1996","North Carolina St.","3","8","0","0.27273","268","401","-133"
"1997","North Carolina St.","6","5","0","0.54545","325","268","57"
"1998","North Carolina St.","7","5","0","0.58333","366","352","14"
"1999","North Carolina St.","6","6","0","0.50000","244","302","-58"
"2000","North Carolina St.","8","4","0","0.66667","379","338","41"
"2001","North Carolina St.","7","5","0","0.58333","319","257","62"
"2002","North Carolina St.","11","3","0","0.78571","460","238","222"
"2003","North Carolina St.","8","5","0","0.61538","489","385","104"
"2004","North Carolina St.","5","6","0","0.45455","264","218","46"
"2005","North Carolina St.","7","5","0","0.58333","249","212","37"
"2006","North Carolina St.","3","9","0","0.25000","210","262","-52"
"1997","Boston College (MA)","4","7","0","0.36364","237","314","-77"
"1998","Boston College (MA)","4","7","0","0.36364","273","311","-38"
"1999","Boston College (MA)","8","4","0","0.66667","297","308","-11"
"2000","Boston College (MA)","7","5","0","0.58333","378","277","101"
"2001","Boston College (MA)","8","4","0","0.66667","337","227","110"
"2002","Boston College (MA)","9","4","0","0.69231","392","253","139"
"2003","Boston College (MA)","8","5","0","0.61538","370","331","39"
"2004","Boston College (MA)","9","3","0","0.75000","296","203","93"
"2005","Boston College (MA)","9","3","0","0.75000","310","191","119"
"2006","Boston College (MA)","9","3","0","0.75000","313","180","133"
"2007","North Carolina St.","5","7","0","0.41667","249","339","-90"
"2008","North Carolina St.","6","7","0","0.46154","305","342","-37"
"2009","North Carolina St.","5","7","0","0.41667","364","374","-10"
"2010","North Carolina St.","9","4","0","0.69231","414","277","137"
"2011","North Carolina St.","8","5","0","0.61538","367","321","46"
"2012","North Carolina St.","7","5","0","0.58333","341","295","46"
"2012","North Carolina St.","0","1","0","0.00000","24","38","-14"
"2011","Northern Illinois","11","3","0","0.78571","536","424","112"
"2012","Northern Illinois","12","1","0","0.92308","530","247","283"
"2013","North Carolina St.","3","9","0","0.25000","274","362","-88"
"1913","North Texas","0","1","0","0.00000","0","13","-13"
"1914","North Texas","3","3","0","0.50000","56","87","-31"
"1915","North Texas","5","1","1","0.78571","160","6","154"
"1916","North Texas","4","3","1","0.56250","125","74","51"
"1917","North Texas","6","1","0","0.85714","146","42","104"
"1918","North Texas","1","2","1","0.37500","39","58","-19"
"1919","North Texas","5","3","0","0.62500","233","64","169"
"1920","North Texas","7","1","0","0.87500","227","44","183"
"1921","North Texas","3","3","0","0.50000","135","57","78"
"1922","North Texas","5","2","1","0.68750","85","156","-71"
"1923","North Texas","3","5","0","0.37500","63","157","-94"
"1924","North Texas","5","3","1","0.61111","72","64","8"
"1925","North Texas","6","4","0","0.60000","128","131","-3"
"1926","North Texas","5","3","1","0.61111","99","104","-5"
"1927","North Texas","1","6","2","0.22222","31","224","-193"
"1928","North Texas","4","5","0","0.44444","88","171","-83"
"1929","North Texas","4","3","2","0.55556","179","76","103"
"1930","North Texas","5","4","1","0.55000","86","136","-50"
"1931","North Texas","8","3","0","0.72727","176","72","104"
"1932","North Texas","8","1","1","0.85000","180","26","154"
"1933","North Texas","3","4","2","0.44444","49","50","-1"
"1934","North Texas","5","4","1","0.55000","57","86","-29"
"1935","North Texas","5","3","1","0.61111","134","103","31"
"1936","North Texas","6","2","1","0.72222","120","38","82"
"1937","North Texas","4","4","2","0.50000","74","83","-9"
"1938","North Texas","7","4","0","0.63636","184","92","92"
"1939","North Texas","6","1","0","0.85714","116","42","74"
"1940","North Texas","6","3","0","0.66667","199","79","120"
"1941","North Texas","7","1","0","0.87500","165","77","88"
"1942","North Texas","3","5","0","0.37500","123","129","-6"
"1946","North Texas","7","3","1","0.68182","127","102","25"
"1947","North Texas","10","2","0","0.83333","256","77","179"
"1948","North Texas","6","4","0","0.60000","249","133","116"
"1949","North Texas","8","4","0","0.66667","336","192","144"
"1950","North Texas","7","2","1","0.75000","266","174","92"
"1951","North Texas","8","4","0","0.66667","434","132","302"
"1952","North Texas","7","3","0","0.70000","276","137","139"
"1953","North Texas","3","6","1","0.35000","167","167","0"
"1954","North Texas","4","6","0","0.40000","151","176","-25"
"1955","North Texas","5","4","1","0.55000","197","159","38"
"1956","North Texas","7","2","1","0.75000","188","131","57"
"1957","North Texas","5","5","0","0.50000","191","150","41"
"1958","North Texas","7","2","1","0.75000","197","93","104"
"1959","North Texas","9","2","0","0.81818","303","103","200"
"1960","North Texas","2","6","1","0.27778","107","208","-101"
"1961","North Texas","5","4","1","0.55000","162","206","-44"
"1962","North Texas","6","4","0","0.60000","174","182","-8"
"1963","North Texas","3","6","0","0.33333","109","195","-86"
"1964","North Texas","2","7","1","0.25000","78","172","-94"
"1965","North Texas","3","7","0","0.30000","181","312","-131"
"1966","North Texas","8","2","0","0.80000","298","141","157"
"1967","North Texas","7","1","1","0.83333","278","148","130"
"1968","North Texas","8","2","0","0.80000","297","184","113"
"1969","North Texas","7","3","0","0.70000","316","174","142"
"1970","North Texas","3","8","0","0.27273","173","227","-54"
"1971","North Texas","3","8","0","0.27273","155","321","-166"
"1972","North Texas","1","10","0","0.09091","148","354","-206"
"1962","Southern Methodist (TX)","2","8","0","0.20000","88","130","-42"
"1963","Southern Methodist (TX)","4","7","0","0.36364","141","175","-34"
"1964","Southern Methodist (TX)","1","9","0","0.10000","55","177","-122"
"1965","Southern Methodist (TX)","4","5","1","0.45000","123","167","-44"
"1966","Southern Methodist (TX)","8","3","0","0.72727","210","170","40"
"1967","Southern Methodist (TX)","3","7","0","0.30000","135","214","-79"
"1968","Southern Methodist (TX)","8","3","0","0.72727","311","273","38"
"1969","Southern Methodist (TX)","3","7","0","0.30000","186","230","-44"
"1970","Southern Methodist (TX)","5","6","0","0.45455","153","228","-75"
"1971","Southern Methodist (TX)","4","7","0","0.36364","151","227","-76"
"1972","Southern Methodist (TX)","7","4","0","0.63636","269","154","115"
"1973","North Texas","5","5","1","0.50000","153","243","-90"
"1974","North Texas","2","7","2","0.27273","134","248","-114"
"1975","North Texas","7","4","0","0.63636","200","210","-10"
"1976","North Texas","7","4","0","0.63636","232","145","87"
"1977","North Texas","10","1","0","0.90909","320","179","141"
"1978","North Texas","9","2","0","0.81818","275","150","125"
"1979","Iowa","5","6","0","0.45455","239","216","23"
"1980","Iowa","4","7","0","0.36364","154","238","-84"
"1981","Iowa","8","4","0","0.66667","260","157","103"
"1982","Iowa","8","4","0","0.66667","229","230","-1"
"1983","Iowa","9","3","0","0.75000","380","189","191"
"1984","Iowa","8","4","1","0.65385","359","201","158"
"1985","Iowa","10","2","0","0.83333","440","187","253"
"1986","Iowa","9","3","0","0.75000","391","214","177"
"1987","Iowa","10","3","0","0.76923","380","250","130"
"1988","Iowa","6","4","3","0.57692","336","233","103"
"1989","Iowa","5","6","0","0.45455","197","278","-81"
"1990","Iowa","8","4","0","0.66667","427","288","139"
"1991","Iowa","10","1","1","0.87500","343","179","164"
"1992","Iowa","5","7","0","0.41667","243","278","-35"
"1993","Iowa","6","6","0","0.50000","214","293","-79"
"1994","Iowa","5","5","1","0.50000","307","324","-17"
"1995","Iowa","8","4","0","0.66667","368","259","109"
"1996","Iowa","9","3","0","0.75000","339","243","96"
"1997","Iowa","7","5","0","0.58333","411","159","252"
"1998","Iowa","3","8","0","0.27273","172","287","-115"
"1979","North Texas","5","6","0","0.45455","182","235","-53"
"1980","North Texas","6","5","0","0.54545","268","252","16"
"1981","Texas Tech","1","9","1","0.13636","198","298","-100"
"1982","Texas Tech","4","7","0","0.36364","157","234","-77"
"1983","Texas Tech","3","7","1","0.31818","160","253","-93"
"1984","Texas Tech","4","7","0","0.36364","200","212","-12"
"1985","Texas Tech","4","7","0","0.36364","249","240","9"
"1989","Appalachian St. (NC)","9","3","0","0.75000","306","177","129"
"1990","Appalachian St. (NC)","6","5","0","0.54545","171","266","-95"
"1991","Appalachian St. (NC)","8","4","0","0.66667","215","202","13"
"1992","Appalachian St. (NC)","7","5","0","0.58333","262","237","25"
"1993","Appalachian St. (NC)","4","7","0","0.36364","207","252","-45"
"1994","Appalachian St. (NC)","9","4","0","0.69231","363","209","154"
"1995","Appalachian St. (NC)","12","1","0","0.92308","375","251","124"
"1996","Appalachian St. (NC)","7","4","0","0.63636","223","196","27"
"1997","Appalachian St. (NC)","7","4","0","0.63636","294","215","79"
"1998","Appalachian St. (NC)","10","3","0","0.76923","356","222","134"
"1999","Appalachian St. (NC)","9","3","0","0.75000","369","219","150"
"2000","Appalachian St. (NC)","10","4","0","0.71429","441","278","163"
"2001","Appalachian St. (NC)","9","4","0","0.69231","411","278","133"
"2002","Appalachian St. (NC)","8","4","0","0.66667","314","273","41"
"2003","Appalachian St. (NC)","7","4","0","0.63636","252","219","33"
"2004","Appalachian St. (NC)","6","5","0","0.54545","366","358","8"
"2005","Appalachian St. (NC)","12","3","0","0.80000","455","282","173"
"2006","Appalachian St. (NC)","14","1","0","0.93333","528","223","305"
"2007","Appalachian St. (NC)","13","2","0","0.86667","641","400","241"
"2008","Appalachian St. (NC)","11","3","0","0.78571","522","303","219"
"2009","Appalachian St. (NC)","11","3","0","0.78571","465","313","152"
"2010","Appalachian St. (NC)","10","3","0","0.76923","446","307","139"
"2011","Appalachian St. (NC)","8","4","0","0.66667","344","286","58"
"2012","Appalachian St. (NC)","8","4","0","0.66667","395","352","43"
"1973","Mississippi St.","4","5","2","0.45455","219","255","-36"
"1974","Mississippi St.","9","3","0","0.75000","327","224","103"
"1975","Mississippi St.","2","9","0","0.18182","165","166","-1"
"1976","Mississippi St.","0","11","0","0.00000","269","178","91"
"1977","Mississippi St.","0","11","0","0.00000","193","227","-34"
"1978","Mississippi St.","6","5","0","0.54545","232","205","27"
"1981","North Texas","2","9","0","0.18182","111","235","-124"
"1982","North Texas","2","9","0","0.18182","179","283","-104"
"1983","North Texas","8","4","0","0.66667","276","137","139"
"1984","North Texas","2","9","0","0.18182","86","211","-125"
"1985","North Texas","4","6","1","0.40909","150","203","-53"
"1986","North Texas","6","4","0","0.60000","222","204","18"
"1987","North Texas","7","5","0","0.58333","242","247","-5"
"1988","North Texas","8","4","0","0.66667","330","174","156"
"1989","North Texas","5","6","0","0.45455","217","253","-36"
"1990","North Texas","6","5","0","0.54545","223","211","12"
"1991","North Texas","3","7","1","0.31818","137","325","-188"
"1992","North Texas","4","7","0","0.36364","243","264","-21"
"1993","North Texas","4","7","0","0.36364","328","365","-37"
"1994","North Texas","7","4","1","0.62500","343","261","82"
"1995","North Texas","2","9","0","0.18182","200","424","-224"
"1996","North Texas","5","6","0","0.45455","161","293","-132"
"1997","North Texas","4","7","0","0.36364","232","331","-99"
"1998","North Texas","3","8","0","0.27273","173","297","-124"
"1999","North Texas","2","9","0","0.18182","118","291","-173"
"2000","North Texas","3","8","0","0.27273","162","300","-138"
"2001","North Texas","5","7","0","0.41667","275","293","-18"
"2002","North Texas","8","5","0","0.61538","249","192","57"
"2003","North Texas","9","4","0","0.69231","358","285","73"
"2004","North Texas","7","5","0","0.58333","309","358","-49"
"2005","North Texas","2","9","0","0.18182","157","346","-189"
"2006","North Texas","3","9","0","0.25000","154","304","-150"
"2007","North Texas","2","10","0","0.16667","298","541","-243"
"2008","North Texas","1","11","0","0.08333","240","571","-331"
"2009","North Texas","2","10","0","0.16667","319","427","-108"
"2010","North Texas","1","6","0","0.14286","118","194","-76"
"2010","North Texas","2","3","0","0.40000","169","162","7"
"1995","Iowa St.","3","8","0","0.27273","264","409","-145"
"1996","Iowa St.","2","9","0","0.18182","314","401","-87"
"1997","Iowa St.","1","10","0","0.09091","214","493","-279"
"1998","Iowa St.","3","8","0","0.27273","221","328","-107"
"1999","Iowa St.","4","7","0","0.36364","247","272","-25"
"2000","Iowa St.","9","3","0","0.75000","343","322","21"
"2001","Iowa St.","7","5","0","0.58333","309","245","64"
"2002","Iowa St.","7","7","0","0.50000","404","396","8"
"2003","Iowa St.","2","10","0","0.16667","173","437","-264"
"2004","Iowa St.","7","5","0","0.58333","246","259","-13"
"2005","Iowa St.","7","5","0","0.58333","339","230","109"
"2006","Iowa St.","4","8","0","0.33333","226","369","-143"
"2011","North Texas","5","7","0","0.41667","298","368","-70"
"2012","North Texas","4","8","0","0.33333","251","334","-83"
"2013","North Texas","9","4","0","0.69231","414","231","183"
"1899","Northern Illinois","1","0","2","0.66667","21","5","16"
"1900","Northern Illinois","2","2","2","0.50000","50","50","0"
"1901","Northern Illinois","6","1","0","0.85714","110","18","92"
"1902","Northern Illinois","5","1","1","0.78571","74","16","58"
"1903","Northern Illinois","3","2","0","0.60000","44","41","3"
"1907","Illinois St.","8","0","2","0.90000","104","10","94"
"1904","Northern Illinois","5","0","0","1.00000","90","17","73"
"1905","Northern Illinois","3","1","1","0.70000","25","12","13"
"1906","Northern Illinois","4","2","1","0.64286","38","23","15"
"1907","Northern Illinois","1","4","1","0.25000","67","62","5"
"1908","Northern Illinois","1","5","1","0.21429","31","81","-50"
"1909","Northern Illinois","2","6","0","0.25000","74","171","-97"
"1910","Northern Illinois","4","2","1","0.64286","68","39","29"
"1911","Northern Illinois","8","1","2","0.81818","196","84","112"
"1912","Northern Illinois","3","5","0","0.37500","214","167","47"
"1913","Northern Illinois","3","3","3","0.50000","56","236","-180"
"1914","Northern Illinois","7","0","1","0.93750","140","13","127"
"1915","Northern Illinois","2","5","1","0.31250","81","210","-129"
"1916","Northern Illinois","6","1","1","0.81250","105","19","86"
"1920","Northern Illinois","3","5","0","0.37500","153","93","60"
"1921","Northern Illinois","3","5","0","0.37500","191","178","13"
"1922","Northern Illinois","5","4","1","0.55000","137","97","40"
"1923","Northern Illinois","1","4","3","0.31250","73","170","-97"
"1924","Northern Illinois","4","4","0","0.50000","156","85","71"
"1925","Northern Illinois","6","1","0","0.85714","52","5","47"
"1922","Mississippi","4","5","1","0.45000","87","183","-96"
"1923","Mississippi","4","6","0","0.40000","81","145","-64"
"1926","Northern Illinois","5","1","1","0.78571","71","26","45"
"1927","Northern Illinois","1","4","1","0.25000","49","92","-43"
"1928","Northern Illinois","0","6","1","0.07143","12","139","-127"
"1929","Northern Illinois","6","1","1","0.81250","124","24","100"
"1930","Northern Illinois","6","2","1","0.72222","152","60","92"
"1931","Northern Illinois","5","3","0","0.62500","76","59","17"
"1932","Northern Illinois","4","2","1","0.64286","76","27","49"
"1933","Northern Illinois","5","4","0","0.55556","113","58","55"
"1934","Northern Illinois","5","1","2","0.75000","109","42","67"
"1935","Northern Illinois","7","1","1","0.83333","204","20","184"
"1936","Northern Illinois","4","3","1","0.56250","60","59","1"
"1937","Northern Illinois","3","2","3","0.56250","53","40","13"
"1938","Northern Illinois","6","1","1","0.81250","133","34","99"
"1939","Northern Illinois","5","2","1","0.68750","94","44","50"
"1940","Northern Illinois","6","3","0","0.66667","115","117","-2"
"1941","Northern Illinois","7","1","1","0.83333","166","44","122"
"1942","Northern Illinois","4","2","2","0.62500","75","82","-7"
"1943","Northern Illinois","4","1","1","0.75000","117","53","64"
"1944","Northern Illinois","7","0","0","1.00000","113","48","65"
"1945","Northern Illinois","4","3","0","0.57143","113","64","49"
"1946","Northern Illinois","9","2","0","0.81818","207","99","108"
"1947","Northern Illinois","4","3","3","0.55000","131","97","34"
"1948","Northern Illinois","6","4","0","0.60000","174","142","32"
"1949","Northern Illinois","7","2","1","0.75000","273","157","116"
"1950","Northern Illinois","3","6","0","0.33333","192","255","-63"
"1951","Northern Illinois","9","0","0","1.00000","223","101","122"
"1952","Northern Illinois","3","6","0","0.33333","110","194","-84"
"1953","Northern Illinois","1","8","0","0.11111","74","255","-181"
"1954","Northern Illinois","2","7","0","0.22222","79","187","-108"
"1955","Northern Illinois","0","8","1","0.05556","31","233","-202"
"1956","Northern Illinois","1","8","0","0.11111","46","188","-142"
"1957","Northern Illinois","2","7","0","0.22222","131","268","-137"
"1958","Northern Illinois","4","5","0","0.44444","184","184","0"
"1959","Northern Illinois","7","2","0","0.77778","246","124","122"
"1960","Northern Illinois","7","2","0","0.77778","217","126","91"
"1961","Northern Illinois","4","4","1","0.50000","159","129","30"
"1962","Northern Illinois","8","2","0","0.80000","274","87","187"
"1963","Northern Illinois","10","0","0","1.00000","337","97","240"
"1964","Northern Illinois","7","2","0","0.77778","190","131","59"
"1965","Northern Illinois","9","1","0","0.90000","290","147","143"
"1966","Northern Illinois","8","2","0","0.80000","293","153","140"
"1967","Northern Illinois","5","5","0","0.50000","162","198","-36"
"1968","Northern Illinois","2","8","0","0.20000","154","258","-104"
"1966","Buffalo (NY)","5","5","0","0.50000","220","172","48"
"1967","Buffalo (NY)","6","4","0","0.60000","241","191","50"
"1968","Buffalo (NY)","7","3","0","0.70000","185","183","2"
"1969","Northern Illinois","3","7","0","0.30000","191","284","-93"
"1970","Northern Illinois","3","7","0","0.30000","168","281","-113"
"1971","Northern Illinois","5","5","1","0.50000","202","232","-30"
"1972","Northern Illinois","7","4","0","0.63636","198","141","57"
"1973","Northern Illinois","6","5","0","0.54545","327","270","57"
"1974","Northern Illinois","4","7","0","0.36364","186","261","-75"
"1975","Northern Illinois","3","8","0","0.27273","193","230","-37"
"1976","Northern Illinois","1","10","0","0.09091","56","366","-310"
"1977","Northern Illinois","3","8","0","0.27273","138","249","-111"
"1978","Northern Illinois","5","6","0","0.45455","232","284","-52"
"1979","Northern Illinois","5","5","1","0.50000","177","206","-29"
"1969","Miami (OH)","7","3","0","0.70000","231","139","92"
"1970","Miami (OH)","7","3","0","0.70000","187","112","75"
"1971","Miami (OH)","7","3","0","0.70000","207","117","90"
"1972","Miami (OH)","7","3","0","0.70000","232","116","116"
"1973","Miami (OH)","11","0","0","1.00000","223","76","147"
"1974","Colorado","5","6","0","0.45455","226","307","-81"
"1975","Colorado","9","3","0","0.75000","331","251","80"
"1976","Colorado","8","4","0","0.66667","305","225","80"
"1977","Colorado","7","3","1","0.68182","266","174","92"
"1978","Colorado","6","5","0","0.54545","230","206","24"
"1980","Northern Illinois","7","4","0","0.63636","216","175","41"
"1981","Northern Illinois","3","8","0","0.27273","160","217","-57"
"1982","Northern Illinois","5","5","0","0.50000","137","136","1"
"1983","Northern Illinois","10","2","0","0.83333","314","203","111"
"1984","Indiana","0","11","0","0.00000","185","338","-153"
"1985","Indiana","4","7","0","0.36364","251","340","-89"
"1986","Indiana","6","6","0","0.50000","273","227","46"
"1987","Indiana","8","4","0","0.66667","283","238","45"
"1988","Indiana","8","3","1","0.70833","396","235","161"
"1989","Indiana","5","6","0","0.45455","289","262","27"
"1990","Indiana","6","5","1","0.54167","329","238","91"
"1991","Indiana","7","4","1","0.62500","305","224","81"
"1992","Indiana","5","6","0","0.45455","177","197","-20"
"1993","Indiana","8","4","0","0.66667","259","197","62"
"1994","Indiana","7","4","0","0.63636","294","285","9"
"1995","Indiana","2","9","0","0.18182","159","326","-167"
"1996","Indiana","3","8","0","0.27273","242","291","-49"
"1969","Louisville (KY)","5","4","1","0.55000","206","273","-67"
"1970","Louisville (KY)","8","3","1","0.70833","252","208","44"
"1971","Louisville (KY)","6","3","1","0.65000","190","111","79"
"1972","Louisville (KY)","9","1","0","0.90000","309","91","218"
"1973","Indiana","2","9","0","0.18182","151","271","-120"
"1974","Indiana","1","10","0","0.09091","166","292","-126"
"1975","Indiana","2","8","1","0.22727","104","254","-150"
"1976","Indiana","5","6","0","0.45455","130","254","-124"
"1977","Indiana","5","5","1","0.50000","205","228","-23"
"1978","Indiana","4","7","0","0.36364","228","290","-62"
"1979","Indiana","8","4","0","0.66667","314","252","62"
"1980","Indiana","6","5","0","0.54545","255","235","20"
"1981","Indiana","3","8","0","0.27273","144","293","-149"
"1982","Indiana","5","6","0","0.45455","203","250","-47"
"1984","Northern Illinois","4","6","1","0.40909","153","188","-35"
"1985","Northern Illinois","4","7","0","0.36364","174","259","-85"
"1986","Northern Illinois","2","9","0","0.18182","144","308","-164"
"1987","Northern Illinois","5","5","1","0.50000","305","262","43"
"1988","Northern Illinois","7","4","0","0.63636","155","185","-30"
"1989","Northern Illinois","9","2","0","0.81818","344","269","75"
"1990","Northern Illinois","6","5","0","0.54545","333","260","73"
"1991","Oregon St.","1","10","0","0.09091","125","365","-240"
"1992","Oregon St.","1","9","1","0.13636","163","363","-200"
"1993","Oregon St.","4","7","0","0.36364","224","294","-70"
"1994","Oregon St.","4","7","0","0.36364","223","239","-16"
"1995","Oregon St.","1","10","0","0.09091","136","237","-101"
"1996","Oregon St.","2","9","0","0.18182","216","388","-172"
"1991","Northern Illinois","2","9","0","0.18182","143","364","-221"
"1992","Northern Illinois","5","6","0","0.45455","203","193","10"
"1993","Northern Illinois","4","7","0","0.36364","227","334","-107"
"1994","Northern Illinois","4","7","0","0.36364","301","294","7"
"1995","Northern Illinois","3","8","0","0.27273","220","420","-200"
"1996","Northern Illinois","1","10","0","0.09091","157","400","-243"
"1997","Northern Illinois","0","11","0","0.00000","129","382","-253"
"1998","Northern Illinois","2","9","0","0.18182","160","329","-169"
"1999","Northern Illinois","5","6","0","0.45455","289","289","0"
"2000","Northern Illinois","6","5","0","0.54545","409","280","129"
"2001","Northern Illinois","6","5","0","0.54545","303","292","11"
"2002","Northern Illinois","8","4","0","0.66667","375","298","77"
"2003","Northern Illinois","10","2","0","0.83333","386","258","128"
"2004","Northern Illinois","9","3","0","0.75000","421","304","117"
"2005","Northern Illinois","7","5","0","0.58333","389","274","115"
"2006","Northern Illinois","7","6","0","0.53846","331","275","56"
"2007","Northern Illinois","2","10","0","0.16667","229","370","-141"
"1994","Saginaw Valley St. (MI)","6","4","0","0.60000","294","220","74"
"1995","Saginaw Valley St. (MI)","7","3","0","0.70000","359","234","125"
"1996","Saginaw Valley St. (MI)","7","3","0","0.70000","269","157","112"
"1997","Saginaw Valley St. (MI)","9","2","0","0.81818","457","209","248"
"1998","Saginaw Valley St. (MI)","9","2","0","0.81818","467","222","245"
"1999","Emporia St. (KS)","5","6","0","0.45455","299","247","52"
"2000","Emporia St. (KS)","6","5","0","0.54545","293","236","57"
"2001","Southern Illinois","1","10","0","0.09091","167","339","-172"
"2002","Southern Illinois","4","8","0","0.33333","414","360","54"
"2003","Southern Illinois","10","2","0","0.83333","437","229","208"
"2004","Southern Illinois","10","2","0","0.83333","511","158","353"
"2005","Southern Illinois","9","4","0","0.69231","449","298","151"
"2006","Southern Illinois","9","4","0","0.69231","448","256","192"
"2007","Southern Illinois","12","2","0","0.85714","530","243","287"
"2008","Northern Illinois","6","7","0","0.46154","314","234","80"
"2009","Northern Illinois","7","6","0","0.53846","372","281","91"
"2010","Northern Illinois","10","3","0","0.76923","492","248","244"
"2011","Minnesota","3","9","0","0.25000","221","380","-159"
"2012","Minnesota","6","7","0","0.46154","287","321","-34"
"2013","Minnesota","4","2","0","0.66667","191","124","67"
"2010","Northern Illinois","1","0","0","1.00000","40","17","23"
"2011","Northern Illinois","11","3","0","0.78571","536","424","112"
"2012","Northern Illinois","12","1","0","0.92308","530","247","283"
"2013","North Carolina St.","3","9","0","0.25000","274","362","-88"
"2012","Northern Illinois","0","1","0","0.00000","10","31","-21"
"2013","Northern Illinois","12","2","0","0.85714","555","351","204"
"1869","Rutgers (NJ)","2","2","0","0.50000","18","18","0"
"1870","Rutgers (NJ)","2","2","0","0.50000","17","17","0"
"1872","Columbia (NY)","5","4","0","0.55556","22","16","6"
"1873","Rutgers (NJ)","7","4","1","0.62500","31","26","5"
"1874","Harvard (MA)","9","7","0","0.56250","54","41","13"
"1875","Harvard (MA)","12","6","2","0.65000","52","29","23"
"1876","Harvard (MA)","13","8","1","0.61364","45","29","16"
"1877","Harvard (MA)","9","7","3","0.55263","31","21","10"
"1878","Pennsylvania","14","9","5","0.58929","42","24","18"
"1879","Harvard (MA)","13","9","12","0.55882","46","27","19"
"1880","Harvard (MA)","18","11","4","0.60606","75","53","22"
"1881","Rutgers (NJ)","22","18","8","0.54167","70","47","23"
"1882","Rutgers (NJ)","41","28","2","0.59155","176","111","65"
"1883","Rutgers (NJ)","38","32","1","0.54225","1288","965","323"
"1884","Pennsylvania","47","29","5","0.61111","1728","1184","544"
"1885","Michigan","34","17","4","0.65455","1437","612","825"
"1886","Lehigh (PA)","48","21","4","0.68493","1850","637","1213"
"1887","California","67","35","3","0.65238","2660","935","1725"
"1888","Princeton (NJ)","70","56","6","0.55303","2468","1899","569"
"1889","Brown (RI)","82","51","11","0.60764","2879","1796","1083"
"1890","Brown (RI)","77","76","9","0.50309","3002","2455","547"
"1891","Southern California","94","76","13","0.54918","2813","2189","624"
"1892","Minnesota","93","80","9","0.53571","2972","2394","578"
"1893","Duke (NC)","79","94","9","0.45879","2176","2912","-736"
"1894","Colorado St.","50","62","4","0.44828","1161","1518","-357"
"1895","Boston (MA)","31","44","11","0.42442","692","1031","-339"
"1896","Rhode Island","54","62","12","0.46875","1126","1201","-75"
"1897","Boston (MA)","32","40","6","0.44872","792","785","7"
"1898","Miami (OH)","47","23","4","0.66216","921","644","277"
"1899","New Hampshire","33","32","6","0.50704","571","522","49"
"1900","New Hampshire","22","35","11","0.40441","442","686","-244"
"1901","Marshall (WV)","18","34","3","0.35455","302","917","-615"
"1902","Saint John's (MN)","9","22","4","0.31429","148","460","-312"
"1903","Wichita St. (KS)","14","25","2","0.36585","376","546","-170"
"1904","Oklahoma St.","11","14","1","0.44231","194","394","-200"
"1905","Miami (OH)","7","25","5","0.25676","245","494","-249"
"1906","Rensselaer Tech (NY)","3","7","4","0.35714","92","107","-15"
"1907","Marshall (WV)","5","10","2","0.35294","71","238","-167"
"1908","Fort Hays St. (KS)","5","6","1","0.45833","56","91","-35"
"1909","Fort Hays St. (KS)","1","3","1","0.30000","12","68","-56"
"1910","Texas St.","0","1","0","0.00000","0","19","-19"
"1912","Fort Hays St. (KS)","1","2","0","0.33333","20","132","-112"
"1913","Eureka (IL)","1","6","0","0.14286","39","203","-164"
"1914","Eureka (IL)","3","4","0","0.42857","57","201","-144"
"1915","Texas St.","1","1","1","0.50000","13","20","-7"
"1916","Texas St.","0","2","1","0.16667","0","106","-106"
"1917","Boston (MA)","4","4","0","0.50000","73","136","-63"
"1918","Monmouth (IL)","1","7","0","0.12500","26","137","-111"
"1930","Troy (AL)","1","2","0","0.33333","7","73","-66"
"2013","Grambling St. (LA)","0","1","0","0.00000","0","0","0"
"1893","Northwestern (IL)","2","5","3","0.35000","92","176","-84"
"1894","Northwestern (IL)","4","5","0","0.44444","72","228","-156"
"1895","Northwestern (IL)","6","5","0","0.54545","192","132","60"
"1896","Northwestern (IL)","6","1","2","0.77778","156","46","110"
"1897","Northwestern (IL)","5","4","1","0.55000","71","59","12"
"1898","Northwestern (IL)","9","4","1","0.67857","246","129","117"
"1896","Beloit (WI)","2","3","2","0.42857","86","58","28"
"1897","Beloit (WI)","4","3","0","0.57143","105","58","47"
"1899","Northwestern (IL)","6","6","0","0.50000","120","172","-52"
"1900","Northwestern (IL)","7","2","3","0.70833","133","43","90"
"1901","Northwestern (IL)","8","2","1","0.77273","156","77","79"
"1902","Northwestern (IL)","6","6","0","0.50000","83","117","-34"
"1901","Dartmouth (NH)","9","1","0","0.90000","267","53","214"
"1902","Dartmouth (NH)","6","2","1","0.72222","105","39","66"
"1903","Northwestern (IL)","10","1","3","0.82143","229","67","162"
"1904","Northwestern (IL)","8","2","0","0.80000","312","55","257"
"1905","Northwestern (IL)","8","2","1","0.77273","214","122","92"
"1908","Northwestern (IL)","2","2","0","0.50000","72","90","-18"
"1909","Northwestern (IL)","1","3","1","0.30000","25","95","-70"
"1910","Purdue (IN)","1","5","0","0.16667","19","65","-46"
"1911","Purdue (IN)","3","4","0","0.42857","58","48","10"
"1912","Purdue (IN)","4","2","1","0.64286","176","70","106"
"1910","Northwestern (IL)","1","3","1","0.30000","10","45","-35"
"1911","Northwestern (IL)","3","4","0","0.42857","60","70","-10"
"1912","Northwestern (IL)","2","3","1","0.41667","32","87","-55"
"1913","Allegheny (PA)","7","1","0","0.87500","338","26","312"
"1914","Allegheny (PA)","6","0","1","0.92857","182","20","162"
"1915","Allegheny (PA)","5","3","0","0.62500","152","91","61"
"1916","Allegheny (PA)","4","2","1","0.64286","81","79","2"
"1917","Allegheny (PA)","6","0","1","0.92857","159","12","147"
"1919","Allegheny (PA)","2","3","1","0.41667","28","32","-4"
"1910","Alma (MI)","4","2","0","0.66667","109","46","63"
"1911","Alma (MI)","4","4","0","0.50000","130","53","77"
"1913","Northwestern (IL)","1","6","0","0.14286","36","242","-206"
"1914","Northwestern (IL)","1","6","0","0.14286","13","176","-163"
"1915","Northwestern (IL)","2","5","0","0.28571","69","112","-43"
"1916","Northwestern (IL)","6","1","0","0.85714","144","55","89"
"1917","Northwestern (IL)","5","2","0","0.71429","145","85","60"
"1918","Northwestern (IL)","2","2","1","0.50000","75","61","14"
"1920","Denver (CO)","2","4","0","0.33333","26","82","-56"
"1921","Denver (CO)","4","2","1","0.64286","133","78","55"
"1922","Denver (CO)","6","1","1","0.81250","107","48","59"
"1924","Kentucky","4","5","0","0.44444","129","99","30"
"1925","Kentucky","6","3","0","0.66667","92","97","-5"
"1926","Kentucky","2","6","1","0.27778","84","91","-7"
"1919","Northwestern (IL)","2","5","0","0.28571","49","111","-62"
"1920","Kansas St.","3","3","3","0.50000","93","55","38"
"1921","Kansas St.","5","3","0","0.62500","84","64","20"
"1922","Kansas St.","5","1","2","0.75000","154","61","93"
"1923","Kansas St.","4","2","2","0.62500","107","72","35"
"1924","Kansas St.","3","4","1","0.43750","68","79","-11"
"1925","Kansas St.","5","2","1","0.68750","70","43","27"
"1926","Kansas St.","5","3","0","0.62500","85","42","43"
"1927","Kansas St.","3","5","0","0.37500","101","146","-45"
"1928","Florida","8","1","0","0.88889","336","44","292"
"1929","Florida","8","2","0","0.80000","187","73","114"
"1930","Florida","6","3","1","0.65000","199","60","139"
"1931","Florida","2","6","2","0.30000","73","168","-95"
"1932","Florida","3","6","0","0.33333","108","136","-28"
"1933","Michigan St.","4","2","2","0.62500","73","49","24"
"1934","Michigan St.","8","1","0","0.88889","153","56","97"
"1935","Michigan St.","6","2","0","0.75000","207","57","150"
"1936","Michigan St.","6","1","2","0.77778","143","40","103"
"1937","Michigan St.","8","2","0","0.80000","117","42","75"
"1938","Michigan St.","6","3","0","0.66667","133","59","74"
"1939","Michigan St.","4","4","1","0.50000","102","92","10"
"1940","Michigan St.","3","4","1","0.43750","108","76","32"
"1941","Michigan St.","5","3","1","0.61111","150","77","73"
"1942","Michigan St.","4","3","2","0.55556","120","99","21"
"1944","Michigan St.","6","1","0","0.85714","167","31","136"
"1945","Michigan St.","5","3","1","0.61111","120","128","-8"
"1946","Michigan St.","5","5","0","0.50000","181","202","-21"
"1920","Northwestern (IL)","3","4","0","0.42857","66","90","-24"
"1921","Northwestern (IL)","1","6","0","0.14286","34","120","-86"
"1923","Denver (CO)","6","3","0","0.66667","117","99","18"
"1924","Denver (CO)","4","2","2","0.62500","36","35","1"
"1922","Northwestern (IL)","3","3","1","0.50000","119","92","27"
"1923","Northwestern (IL)","2","6","0","0.25000","90","112","-22"
"1924","Northwestern (IL)","4","4","0","0.50000","109","66","43"
"1925","Northwestern (IL)","5","3","0","0.62500","81","69","12"
"1926","Northwestern (IL)","7","1","0","0.87500","179","22","157"
"1927","Wisconsin","4","4","0","0.50000","96","75","21"
"1928","Wisconsin","7","1","1","0.83333","163","38","125"
"1929","Wisconsin","4","5","0","0.44444","88","78","10"
"1930","Wisconsin","6","2","1","0.72222","227","40","187"
"1931","Wisconsin","5","4","1","0.55000","105","110","-5"
"1934","Richmond (VA)","8","1","0","0.88889","126","32","94"
"1935","Richmond (VA)","3","3","3","0.50000","64","65","-1"
"1936","Richmond (VA)","4","4","2","0.50000","61","81","-20"
"1937","Richmond (VA)","5","4","1","0.55000","78","103","-25"
"1938","Richmond (VA)","6","3","1","0.65000","91","59","32"
"1939","Richmond (VA)","7","1","2","0.80000","155","20","135"
"1940","Richmond (VA)","6","3","0","0.66667","141","80","61"
"1941","Richmond (VA)","2","7","0","0.22222","57","184","-127"
"1927","Northwestern (IL)","4","4","0","0.50000","129","98","31"
"1928","Northwestern (IL)","5","3","0","0.62500","65","43","22"
"1929","Northwestern (IL)","6","3","0","0.66667","172","95","77"
"1930","Northwestern (IL)","7","1","0","0.87500","182","36","146"
"1931","Northwestern (IL)","7","1","1","0.83333","138","40","98"
"1932","Northwestern (IL)","3","4","1","0.43750","116","76","40"
"1933","Northwestern (IL)","1","5","2","0.25000","25","42","-17"
"1934","Northwestern (IL)","3","5","0","0.37500","64","120","-56"
"1929","Oklahoma St.","4","3","2","0.55556","107","79","28"
"1930","Oklahoma St.","7","2","1","0.75000","124","40","84"
"1931","Oklahoma St.","8","2","1","0.77273","183","52","131"
"1932","Oklahoma St.","9","1","2","0.83333","178","48","130"
"1933","Oklahoma St.","6","2","1","0.72222","132","57","75"
"1934","Kansas St.","7","2","1","0.75000","149","81","68"
"1935","Northwestern (IL)","4","3","1","0.56250","90","79","11"
"1936","Northwestern (IL)","7","1","0","0.87500","132","73","59"
"1937","Northwestern (IL)","4","4","0","0.50000","68","40","28"
"1938","Northwestern (IL)","4","2","2","0.62500","93","32","61"
"1939","Northwestern (IL)","3","4","1","0.43750","47","67","-20"
"1940","Northwestern (IL)","6","2","0","0.75000","170","64","106"
"1941","Northwestern (IL)","5","3","0","0.62500","173","67","106"
"1942","Northwestern (IL)","1","9","0","0.10000","96","209","-113"
"1943","Northwestern (IL)","6","2","0","0.75000","189","64","125"
"1944","Northwestern (IL)","1","7","1","0.16667","102","160","-58"
"1945","Northwestern (IL)","4","4","1","0.50000","127","148","-21"
"1946","Northwestern (IL)","4","4","1","0.50000","156","136","20"
"1947","California","9","1","0","0.90000","275","111","164"
"1948","California","10","1","0","0.90909","291","100","191"
"1949","California","10","1","0","0.90909","319","131","188"
"1950","California","9","1","1","0.86364","224","90","134"
"1951","California","8","2","0","0.80000","307","166","141"
"1952","California","7","3","0","0.70000","247","127","120"
"1953","California","4","4","2","0.50000","220","170","50"
"1954","California","5","5","0","0.50000","249","177","72"
"1955","California","2","7","1","0.25000","107","216","-109"
"1956","California","3","7","0","0.30000","135","181","-46"
"1947","Northwestern (IL)","3","6","0","0.33333","129","196","-67"
"1948","Northwestern (IL)","8","2","0","0.80000","191","91","100"
"1949","Northwestern (IL)","4","5","0","0.44444","137","156","-19"
"1950","Northwestern (IL)","6","3","0","0.66667","155","143","12"
"1951","Northwestern (IL)","5","4","0","0.55556","112","124","-12"
"1952","Northwestern (IL)","2","6","1","0.27778","166","252","-86"
"1953","Northwestern (IL)","3","6","0","0.33333","166","205","-39"
"1954","Northwestern (IL)","2","7","0","0.22222","101","142","-41"
"1955","Northwestern (IL)","0","8","1","0.05556","66","241","-175"
"1957","Western Illinois","5","4","0","0.55556","154","150","4"
"1958","Western Illinois","6","1","1","0.81250","222","109","113"
"1959","Western Illinois","9","0","0","1.00000","303","104","199"
"1966","Maryland","4","6","0","0.40000","180","204","-24"
"1977","Miami (FL)","3","8","0","0.27273","125","245","-120"
"1978","Miami (FL)","6","5","0","0.54545","194","193","1"
"1979","Army (NY)","2","8","1","0.22727","96","308","-212"
"1983","Central Florida","5","6","0","0.45455","283","306","-23"
"1984","Central Florida","1","6","0","0.14286","154","270","-116"
"2001","Chowan (NC)","3","7","0","0.30000","241","281","-40"
"2002","Chowan (NC)","0","10","0","0.00000","69","274","-205"
"1951","Miami (OH)","7","3","0","0.70000","225","159","66"
"1952","Miami (OH)","8","1","0","0.88889","284","108","176"
"1953","Miami (OH)","7","1","1","0.83333","327","52","275"
"1954","Miami (OH)","8","1","0","0.88889","294","82","212"
"1955","Miami (OH)","9","0","0","1.00000","226","47","179"
"1956","Northwestern (IL)","4","4","1","0.50000","107","112","-5"
"1957","Northwestern (IL)","0","9","0","0.00000","57","271","-214"
"1958","Northwestern (IL)","5","4","0","0.55556","199","148","51"
"1959","Northwestern (IL)","6","3","0","0.66667","174","134","40"
"1960","Northwestern (IL)","5","4","0","0.55556","107","103","4"
"1961","Northwestern (IL)","4","5","0","0.44444","131","105","26"
"1962","Northwestern (IL)","7","2","0","0.77778","237","158","79"
"1963","Northwestern (IL)","5","4","0","0.55556","162","124","38"
"1964","Notre Dame (IN)","9","1","0","0.90000","287","77","210"
"1965","Notre Dame (IN)","7","2","1","0.75000","270","73","197"
"1966","Notre Dame (IN)","9","0","1","0.95000","362","38","324"
"1967","Notre Dame (IN)","8","2","0","0.80000","337","124","213"
"1968","Notre Dame (IN)","7","2","1","0.75000","376","170","206"
"1969","Notre Dame (IN)","8","2","1","0.77273","351","134","217"
"1970","Notre Dame (IN)","10","1","0","0.90909","354","108","246"
"1971","Notre Dame (IN)","8","2","0","0.80000","225","86","139"
"1972","Notre Dame (IN)","8","3","0","0.72727","289","192","97"
"1973","Notre Dame (IN)","11","0","0","1.00000","382","89","293"
"1974","Notre Dame (IN)","10","2","0","0.83333","318","147","171"
"1964","Northwestern (IL)","3","6","0","0.33333","95","164","-69"
"1965","Northwestern (IL)","4","6","0","0.40000","141","208","-67"
"1966","Northwestern (IL)","3","6","1","0.35000","137","213","-76"
"1967","Northwestern (IL)","3","7","0","0.30000","149","213","-64"
"1968","Northwestern (IL)","1","9","0","0.10000","109","325","-216"
"1969","Northwestern (IL)","3","7","0","0.30000","137","306","-169"
"1970","Northwestern (IL)","6","4","0","0.60000","233","161","72"
"1971","Northwestern (IL)","7","4","0","0.63636","211","183","28"
"1972","Northwestern (IL)","2","9","0","0.18182","146","290","-144"
"1973","Purdue (IN)","5","6","0","0.45455","200","213","-13"
"1974","Purdue (IN)","4","6","1","0.40909","223","261","-38"
"1975","Purdue (IN)","4","7","0","0.36364","128","220","-92"
"1976","Purdue (IN)","5","6","0","0.45455","188","233","-45"
"1956","Miami (OH)","7","1","1","0.83333","159","83","76"
"1957","Miami (OH)","6","3","0","0.66667","163","137","26"
"1958","Miami (OH)","6","3","0","0.66667","193","96","97"
"1959","Miami (OH)","5","4","0","0.55556","158","94","64"
"1960","Miami (OH)","5","5","0","0.50000","139","159","-20"
"1961","Miami (OH)","6","4","0","0.60000","153","115","38"
"1962","Miami (OH)","8","2","1","0.77273","241","175","66"
"1963","Yale (CT)","6","3","0","0.66667","135","78","57"
"1964","Yale (CT)","6","2","1","0.72222","195","120","75"
"1965","Indiana","2","8","0","0.20000","134","225","-91"
"1966","Indiana","1","8","1","0.15000","104","229","-125"
"1967","Indiana","9","2","0","0.81818","197","159","38"
"1968","Indiana","6","4","0","0.60000","250","262","-12"
"1969","Indiana","4","6","0","0.40000","252","242","10"
"1970","Indiana","1","9","0","0.10000","102","300","-198"
"1971","Indiana","3","8","0","0.27273","152","260","-108"
"1972","Indiana","5","6","0","0.45455","204","272","-68"
"1973","Northwestern (IL)","4","7","0","0.36364","188","299","-111"
"1974","Northwestern (IL)","3","8","0","0.27273","140","385","-245"
"1975","Northwestern (IL)","3","8","0","0.27273","149","318","-169"
"1976","Northwestern (IL)","1","10","0","0.09091","134","311","-177"
"1977","Northwestern (IL)","1","10","0","0.09091","102","337","-235"
"1990","Mount Saint Joseph (OH)","1","9","0","0.10000","160","330","-170"
"1991","Mount Saint Joseph (OH)","4","6","0","0.40000","204","249","-45"
"1992","Mount Saint Joseph (OH)","4","5","0","0.44444","135","269","-134"
"1978","Northwestern (IL)","0","10","1","0.04545","92","440","-348"
"1979","Northwestern (IL)","1","10","0","0.09091","115","386","-271"
"1980","Northwestern (IL)","0","11","0","0.00000","151","444","-293"
"1981","Northwestern (IL)","0","11","0","0.00000","82","505","-423"
"1982","Northwestern (IL)","3","8","0","0.27273","206","379","-173"
"1983","Northwestern (IL)","2","9","0","0.18182","101","398","-297"
"1984","Northwestern (IL)","2","9","0","0.18182","138","349","-211"
"1985","Northwestern (IL)","3","8","0","0.27273","170","332","-162"
"1989","Stanford (CA)","3","8","0","0.27273","187","258","-71"
"1990","Stanford (CA)","5","6","0","0.45455","263","284","-21"
"1991","Stanford (CA)","8","4","0","0.66667","368","246","122"
"1986","Northwestern (IL)","4","7","0","0.36364","217","251","-34"
"1987","Northwestern (IL)","2","8","1","0.22727","186","328","-142"
"1988","Northwestern (IL)","2","8","1","0.22727","192","350","-158"
"1989","Northwestern (IL)","0","11","0","0.00000","241","497","-256"
"1990","Northwestern (IL)","2","9","0","0.18182","210","370","-160"
"1991","Northwestern (IL)","3","8","0","0.27273","160","306","-146"
"1992","Northwestern (IL)","3","8","0","0.27273","170","373","-203"
"1993","Northwestern (IL)","2","9","0","0.18182","185","335","-150"
"1994","Northwestern (IL)","4","6","1","0.40909","210","351","-141"
"1995","Northwestern (IL)","10","2","0","0.83333","311","181","130"
"1996","Northwestern (IL)","9","3","0","0.75000","336","278","58"
"1997","Northwestern (IL)","5","7","0","0.41667","243","288","-45"
"1998","Northwestern (IL)","3","9","0","0.25000","214","337","-123"
"1999","Colorado","7","5","0","0.58333","405","311","94"
"2000","Colorado","3","8","0","0.27273","252","284","-32"
"2001","Colorado","10","3","0","0.76923","412","318","94"
"2002","Colorado","9","5","0","0.64286","398","325","73"
"2003","Colorado","5","7","0","0.41667","319","398","-79"
"2004","Colorado","8","5","0","0.61538","304","332","-28"
"2005","Colorado","7","5","0","0.58333","295","288","7"
"1990","Miami (OH)","5","5","1","0.50000","200","225","-25"
"1991","Miami (OH)","6","4","1","0.59091","214","140","74"
"1992","Miami (OH)","6","4","1","0.59091","210","204","6"
"1993","Miami (OH)","4","7","0","0.36364","186","248","-62"
"1994","Miami (OH)","6","4","1","0.59091","262","260","2"
"1995","Miami (OH)","8","2","1","0.77273","326","165","161"
"1996","Miami (OH)","6","5","0","0.54545","273","168","105"
"1997","Miami (OH)","8","3","0","0.72727","412","226","186"
"1998","Miami (OH)","10","1","0","0.90909","317","142","175"
"1999","Northwestern (IL)","3","8","0","0.27273","141","301","-160"
"2000","Northwestern (IL)","8","4","0","0.66667","441","400","41"
"2001","Northwestern (IL)","4","7","0","0.36364","320","378","-58"
"2002","Northwestern (IL)","3","9","0","0.25000","272","493","-221"
"2003","Northwestern (IL)","6","7","0","0.46154","263","326","-63"
"2004","Northwestern (IL)","6","6","0","0.50000","295","342","-47"
"2005","Northwestern (IL)","7","5","0","0.58333","388","407","-19"
"2006","Northwestern (IL)","4","8","0","0.33333","198","314","-116"
"2007","Northwestern (IL)","6","6","0","0.50000","310","372","-62"
"2008","Northwestern (IL)","9","4","0","0.69231","317","262","55"
"2009","Northwestern (IL)","8","5","0","0.61538","337","318","19"
"2010","Northwestern (IL)","7","6","0","0.53846","343","377","-34"
"2011","Northwestern (IL)","6","7","0","0.46154","376","360","16"
"2012","Northwestern (IL)","10","3","0","0.76923","412","293","119"
"2013","Northwestern (IL)","5","7","0","0.41667","314","325","-11"
"1869","Rutgers (NJ)","2","2","0","0.50000","18","18","0"
"1870","Rutgers (NJ)","2","2","0","0.50000","17","17","0"
"1872","Columbia (NY)","5","4","0","0.55556","22","16","6"
"1873","Rutgers (NJ)","7","4","1","0.62500","31","26","5"
"1874","Harvard (MA)","9","7","0","0.56250","54","41","13"
"1875","Harvard (MA)","12","6","2","0.65000","52","29","23"
"1876","Harvard (MA)","13","8","1","0.61364","45","29","16"
"1877","Harvard (MA)","9","7","3","0.55263","31","21","10"
"1878","Pennsylvania","14","9","5","0.58929","42","24","18"
"1879","Harvard (MA)","13","9","12","0.55882","46","27","19"
"1880","Harvard (MA)","18","11","4","0.60606","75","53","22"
"1881","Rutgers (NJ)","22","18","8","0.54167","70","47","23"
"1882","Rutgers (NJ)","41","28","2","0.59155","176","111","65"
"1883","Rutgers (NJ)","38","32","1","0.54225","1288","965","323"
"1884","Pennsylvania","47","29","5","0.61111","1728","1184","544"
"1885","Michigan","34","17","4","0.65455","1437","612","825"
"1886","Lehigh (PA)","48","21","4","0.68493","1850","637","1213"
"1887","California","67","35","3","0.65238","2660","935","1725"
"1888","Princeton (NJ)","70","56","6","0.55303","2468","1899","569"
"1889","Brown (RI)","82","51","11","0.60764","2879","1796","1083"
"1890","Brown (RI)","77","76","9","0.50309","3002","2455","547"
"1891","Southern California","94","76","13","0.54918","2813","2189","624"
"1892","Minnesota","93","80","9","0.53571","2972","2394","578"
"1893","Duke (NC)","79","94","9","0.45879","2176","2912","-736"
"1894","Colorado St.","50","62","4","0.44828","1161","1518","-357"
"1895","Boston (MA)","31","44","11","0.42442","692","1031","-339"
"1896","Rhode Island","54","62","12","0.46875","1126","1201","-75"
"1897","Boston (MA)","32","40","6","0.44872","792","785","7"
"1898","Miami (OH)","47","23","4","0.66216","921","644","277"
"1899","New Hampshire","33","32","6","0.50704","571","522","49"
"1900","New Hampshire","22","35","11","0.40441","442","686","-244"
"1901","Marshall (WV)","18","34","3","0.35455","302","917","-615"
"1902","Saint John's (MN)","9","22","4","0.31429","148","460","-312"
"1903","Wichita St. (KS)","14","25","2","0.36585","376","546","-170"
"1904","Oklahoma St.","11","14","1","0.44231","194","394","-200"
"1905","Miami (OH)","7","25","5","0.25676","245","494","-249"
"1906","Rensselaer Tech (NY)","3","7","4","0.35714","92","107","-15"
"1907","Marshall (WV)","5","10","2","0.35294","71","238","-167"
"1908","Fort Hays St. (KS)","5","6","1","0.45833","56","91","-35"
"1909","Fort Hays St. (KS)","1","3","1","0.30000","12","68","-56"
"1910","Texas St.","0","1","0","0.00000","0","19","-19"
"1912","Fort Hays St. (KS)","1","2","0","0.33333","20","132","-112"
"1913","Eureka (IL)","1","6","0","0.14286","39","203","-164"
"1914","Eureka (IL)","3","4","0","0.42857","57","201","-144"
"1915","Texas St.","1","1","1","0.50000","13","20","-7"
"1916","Texas St.","0","2","1","0.16667","0","106","-106"
"1917","Boston (MA)","4","4","0","0.50000","73","136","-63"
"1918","Monmouth (IL)","1","7","0","0.12500","26","137","-111"
"1930","Troy (AL)","1","2","0","0.33333","7","73","-66"
"2013","Grambling St. (LA)","0","1","0","0.00000","0","0","0"
"1894","Notre Dame (IN)","3","1","1","0.70000","80","31","49"
"1895","Notre Dame (IN)","3","1","0","0.75000","70","20","50"
"1896","Notre Dame (IN)","4","3","0","0.57143","182","50","132"
"1897","Notre Dame (IN)","4","1","1","0.75000","165","40","125"
"1898","Notre Dame (IN)","4","2","0","0.66667","155","34","121"
"1899","Notre Dame (IN)","6","3","1","0.65000","169","55","114"
"1900","Notre Dame (IN)","6","3","1","0.65000","261","73","188"
"1901","Notre Dame (IN)","8","1","1","0.85000","145","19","126"
"1902","Missouri","5","3","0","0.62500","99","80","19"
"1902","Notre Dame (IN)","6","2","1","0.72222","203","51","152"
"1903","Notre Dame (IN)","8","0","1","0.94444","291","0","291"
"1904","Notre Dame (IN)","5","3","0","0.62500","94","127","-33"
"1905","Notre Dame (IN)","5","4","0","0.55556","312","80","232"
"1906","Notre Dame (IN)","6","1","0","0.85714","107","12","95"
"1907","Notre Dame (IN)","6","0","1","0.92857","137","20","117"
"1908","Wisconsin","5","1","0","0.83333","101","39","62"
"1909","Wisconsin","3","1","1","0.70000","61","54","7"
"1910","Wisconsin","1","2","2","0.40000","19","46","-27"
"1911","Denver (CO)","5","2","1","0.68750","81","22","59"
"1906","Washington","4","1","4","0.66667","49","35","14"
"1907","Washington","4","4","2","0.50000","96","48","48"
"1908","Notre Dame (IN)","8","1","0","0.88889","326","20","306"
"1906","Arkansas","2","4","2","0.37500","45","71","-26"
"1907","Arkansas","3","4","1","0.43750","73","110","-37"
"1909","Notre Dame (IN)","7","0","1","0.93750","236","14","222"
"1910","Notre Dame (IN)","4","1","1","0.75000","192","25","167"
"1911","Notre Dame (IN)","6","0","2","0.87500","222","9","213"
"1912","Notre Dame (IN)","7","0","0","1.00000","389","27","362"
"1906","Alma (MI)","3","2","3","0.56250","21","21","0"
"1907","Alma (MI)","5","1","1","0.78571","103","19","84"
"1909","Wabash (IN)","3","4","1","0.43750","93","109","-16"
"1910","Wabash (IN)","4","0","0","1.00000","118","0","118"
"1911","Wabash (IN)","3","3","1","0.50000","50","43","7"
"1912","Wabash (IN)","5","2","0","0.71429","261","65","196"
"1913","Notre Dame (IN)","7","0","0","1.00000","268","41","227"
"1914","Notre Dame (IN)","6","2","0","0.75000","288","61","227"
"1915","Notre Dame (IN)","7","1","0","0.87500","230","29","201"
"1916","Notre Dame (IN)","8","1","0","0.88889","292","30","262"
"1917","Notre Dame (IN)","6","1","1","0.81250","145","9","136"
"1918","Notre Dame (IN)","3","1","2","0.66667","133","39","94"
"1919","Notre Dame (IN)","9","0","0","1.00000","229","47","182"
"1920","Notre Dame (IN)","9","0","0","1.00000","251","44","207"
"1921","Notre Dame (IN)","10","1","0","0.90909","375","41","334"
"1922","Notre Dame (IN)","8","1","1","0.85000","222","27","195"
"1923","Notre Dame (IN)","9","1","0","0.90000","275","37","238"
"1924","Notre Dame (IN)","10","0","0","1.00000","285","54","231"
"1925","Notre Dame (IN)","7","2","1","0.75000","200","64","136"
"1926","Notre Dame (IN)","9","1","0","0.90000","210","38","172"
"1927","Notre Dame (IN)","7","1","1","0.83333","158","57","101"
"1928","Notre Dame (IN)","5","4","0","0.55556","99","107","-8"
"1929","Notre Dame (IN)","9","0","0","1.00000","145","38","107"
"1930","Notre Dame (IN)","10","0","0","1.00000","265","74","191"
"1931","Notre Dame (IN)","6","2","1","0.72222","215","40","175"
"1932","Notre Dame (IN)","7","2","0","0.77778","255","31","224"
"1933","Notre Dame (IN)","3","5","1","0.38889","32","80","-48"
"1934","North Carolina St.","2","6","1","0.27778","44","112","-68"
"1935","North Carolina St.","6","4","0","0.60000","87","76","11"
"1936","North Carolina St.","3","7","0","0.30000","79","84","-5"
"1927","Duquesne (PA)","4","4","1","0.50000","82","78","4"
"1928","Duquesne (PA)","8","1","0","0.88889","118","32","86"
"1929","Duquesne (PA)","9","0","1","0.95000","154","53","101"
"1930","Duquesne (PA)","7","3","0","0.70000","131","56","75"
"1931","Duquesne (PA)","3","5","3","0.40909","56","85","-29"
"1932","Duquesne (PA)","7","2","1","0.75000","132","58","74"
"1933","Duquesne (PA)","10","1","0","0.90909","206","33","173"
"1934","Notre Dame (IN)","6","3","0","0.66667","108","56","52"
"1935","Notre Dame (IN)","7","1","1","0.83333","143","62","81"
"1936","Notre Dame (IN)","6","2","1","0.72222","128","69","59"
"1937","Notre Dame (IN)","6","2","1","0.72222","77","49","28"
"1938","Notre Dame (IN)","8","1","0","0.88889","149","39","110"
"1939","Notre Dame (IN)","7","2","0","0.77778","100","73","27"
"1940","Notre Dame (IN)","7","2","0","0.77778","168","67","101"
"1939","Boston College (MA)","9","2","0","0.81818","219","46","173"
"1940","Boston College (MA)","11","0","0","1.00000","339","65","274"
"1941","Notre Dame (IN)","8","0","1","0.94444","189","64","125"
"1942","Notre Dame (IN)","7","2","2","0.72727","184","99","85"
"1943","Notre Dame (IN)","9","1","0","0.90000","340","69","271"
"1946","Notre Dame (IN)","8","0","1","0.94444","271","24","247"
"1947","Notre Dame (IN)","9","0","0","1.00000","291","52","239"
"1948","Notre Dame (IN)","9","0","1","0.95000","320","93","227"
"1949","Notre Dame (IN)","10","0","0","1.00000","360","86","274"
"1950","Notre Dame (IN)","4","4","1","0.50000","139","140","-1"
"1951","Notre Dame (IN)","7","2","1","0.75000","241","122","119"
"1952","Notre Dame (IN)","7","2","1","0.75000","183","108","75"
"1953","Notre Dame (IN)","9","0","1","0.95000","317","139","178"
"1944","Notre Dame (IN)","8","2","0","0.80000","272","118","154"
"1945","Cornell (NY)","5","4","0","0.55556","169","166","3"
"1946","Cornell (NY)","5","3","1","0.61111","135","115","20"
"1947","San Francisco (CA)","7","3","0","0.70000","275","143","132"
"1945","Notre Dame (IN)","7","2","1","0.75000","255","122","133"
"1946","Saint Bonaventure (NY)","6","2","0","0.75000","179","69","110"
"1947","Saint Bonaventure (NY)","6","3","0","0.66667","174","84","90"
"1948","Saint Bonaventure (NY)","7","1","1","0.83333","130","59","71"
"1949","Saint Bonaventure (NY)","6","3","0","0.66667","211","110","101"
"1950","New York (NY)","1","5","1","0.21429","88","157","-69"
"1951","New York (NY)","1","7","0","0.12500","79","327","-248"
"1952","New York (NY)","2","5","1","0.31250","72","189","-117"
"1954","Dayton (OH)","5","5","0","0.50000","147","165","-18"
"1955","Dayton (OH)","3","6","1","0.35000","107","178","-71"
"1963","Notre Dame (IN)","2","7","0","0.22222","108","159","-51"
"1954","Notre Dame (IN)","9","1","0","0.90000","261","115","146"
"1955","Notre Dame (IN)","8","2","0","0.80000","210","112","98"
"1956","Notre Dame (IN)","2","8","0","0.20000","130","289","-159"
"1957","Notre Dame (IN)","7","3","0","0.70000","200","136","64"
"1958","Notre Dame (IN)","6","4","0","0.60000","206","173","33"
"1948","San Francisco (CA)","2","7","0","0.22222","123","216","-93"
"1949","San Francisco (CA)","7","3","0","0.70000","260","144","116"
"1950","San Francisco (CA)","7","4","0","0.63636","291","181","110"
"1951","San Francisco (CA)","9","0","0","1.00000","286","72","214"
"1959","Notre Dame (IN)","5","5","0","0.50000","171","180","-9"
"1960","Notre Dame (IN)","2","8","0","0.20000","111","188","-77"
"1961","Notre Dame (IN)","5","5","0","0.50000","175","182","-7"
"1962","Notre Dame (IN)","5","5","0","0.50000","159","192","-33"
"1951","Miami (OH)","7","3","0","0.70000","225","159","66"
"1952","Miami (OH)","8","1","0","0.88889","284","108","176"
"1953","Miami (OH)","7","1","1","0.83333","327","52","275"
"1954","Miami (OH)","8","1","0","0.88889","294","82","212"
"1955","Miami (OH)","9","0","0","1.00000","226","47","179"
"1956","Northwestern (IL)","4","4","1","0.50000","107","112","-5"
"1957","Northwestern (IL)","0","9","0","0.00000","57","271","-214"
"1958","Northwestern (IL)","5","4","0","0.55556","199","148","51"
"1959","Northwestern (IL)","6","3","0","0.66667","174","134","40"
"1960","Northwestern (IL)","5","4","0","0.55556","107","103","4"
"1961","Northwestern (IL)","4","5","0","0.44444","131","105","26"
"1962","Northwestern (IL)","7","2","0","0.77778","237","158","79"
"1963","Northwestern (IL)","5","4","0","0.55556","162","124","38"
"1964","Notre Dame (IN)","9","1","0","0.90000","287","77","210"
"1965","Notre Dame (IN)","7","2","1","0.75000","270","73","197"
"1966","Notre Dame (IN)","9","0","1","0.95000","362","38","324"
"1967","Notre Dame (IN)","8","2","0","0.80000","337","124","213"
"1968","Notre Dame (IN)","7","2","1","0.75000","376","170","206"
"1969","Notre Dame (IN)","8","2","1","0.77273","351","134","217"
"1970","Notre Dame (IN)","10","1","0","0.90909","354","108","246"
"1971","Notre Dame (IN)","8","2","0","0.80000","225","86","139"
"1972","Notre Dame (IN)","8","3","0","0.72727","289","192","97"
"1973","Notre Dame (IN)","11","0","0","1.00000","382","89","293"
"1974","Notre Dame (IN)","10","2","0","0.83333","318","147","171"
"1955","Arizona St.","8","2","1","0.77273","343","107","236"
"1956","Arizona St.","9","1","0","0.90000","306","83","223"
"1957","Arizona St.","10","0","0","1.00000","397","66","331"
"1958","Missouri","5","4","1","0.55000","164","141","23"
"1959","Missouri","6","5","0","0.54545","125","124","1"
"1960","Missouri","11","0","0","1.00000","295","93","202"
"1961","Missouri","7","2","1","0.75000","124","57","67"
"1962","Missouri","8","1","2","0.81818","204","62","142"
"1963","Missouri","7","3","0","0.70000","151","86","65"
"1964","Missouri","6","3","1","0.65000","142","88","54"
"1965","Missouri","8","2","1","0.77273","223","101","122"
"1966","Missouri","6","3","1","0.65000","121","116","5"
"1967","Missouri","7","3","0","0.70000","134","76","58"
"1968","Missouri","8","3","0","0.72727","308","136","172"
"1969","Missouri","9","2","0","0.81818","365","191","174"
"1970","Missouri","5","6","0","0.45455","243","223","20"
"1975","Notre Dame (IN)","8","3","0","0.72727","244","144","100"
"1976","Notre Dame (IN)","9","3","0","0.75000","294","158","136"
"1977","Notre Dame (IN)","11","1","0","0.91667","420","139","281"
"1978","Notre Dame (IN)","9","3","0","0.75000","293","197","96"
"1979","Notre Dame (IN)","7","4","0","0.63636","243","197","46"
"1980","Notre Dame (IN)","9","2","1","0.79167","248","128","120"
"1981","Notre Dame (IN)","5","6","0","0.45455","232","160","72"
"1982","Notre Dame (IN)","6","4","1","0.59091","206","174","32"
"1983","Notre Dame (IN)","7","5","0","0.58333","316","177","139"
"1984","Notre Dame (IN)","7","5","0","0.58333","299","239","60"
"1985","Notre Dame (IN)","5","6","0","0.45455","230","234","-4"
"1986","Akron (OH)","7","4","0","0.63636","291","188","103"
"1987","Akron (OH)","4","7","0","0.36364","204","273","-69"
"1988","Akron (OH)","5","6","0","0.45455","233","214","19"
"1989","Akron (OH)","6","4","1","0.59091","296","241","55"
"1990","Akron (OH)","3","7","1","0.31818","233","263","-30"
"1991","Akron (OH)","5","6","0","0.45455","257","308","-51"
"1992","Akron (OH)","7","3","1","0.68182","218","186","32"
"1993","Akron (OH)","5","6","0","0.45455","192","222","-30"
"1994","Akron (OH)","1","10","0","0.09091","145","404","-259"
"1969","William & Mary (VA)","3","7","0","0.30000","146","250","-104"
"1970","William & Mary (VA)","5","7","0","0.41667","218","335","-117"
"1971","William & Mary (VA)","5","6","0","0.45455","278","241","37"
"1972","North Carolina St.","8","3","1","0.70833","409","240","169"
"1973","North Carolina St.","9","3","0","0.75000","396","251","145"
"1974","North Carolina St.","9","2","1","0.79167","317","241","76"
"1975","North Carolina St.","7","4","1","0.62500","260","210","50"
"1977","Arkansas","11","1","0","0.91667","389","101","288"
"1978","Arkansas","9","2","1","0.79167","336","147","189"
"1979","Arkansas","10","2","0","0.83333","284","132","152"
"1980","Arkansas","7","5","0","0.58333","272","236","36"
"1981","Arkansas","8","4","0","0.66667","325","219","106"
"1982","Arkansas","9","2","1","0.79167","303","139","164"
"1983","Arkansas","6","5","0","0.54545","204","172","32"
"1984","Minnesota","4","7","0","0.36364","194","316","-122"
"1985","Minnesota","6","5","0","0.54545","273","227","46"
"1986","Notre Dame (IN)","5","6","0","0.45455","299","219","80"
"1987","Notre Dame (IN)","8","4","0","0.66667","339","218","121"
"1988","Notre Dame (IN)","12","0","0","1.00000","393","156","237"
"1989","Notre Dame (IN)","12","1","0","0.92308","427","189","238"
"1990","Notre Dame (IN)","9","3","0","0.75000","359","259","100"
"1991","Notre Dame (IN)","10","3","0","0.76923","465","289","176"
"1992","Notre Dame (IN)","10","1","1","0.87500","437","181","256"
"1993","Notre Dame (IN)","11","1","0","0.91667","427","215","212"
"1994","Notre Dame (IN)","6","5","1","0.54167","342","280","62"
"1995","Notre Dame (IN)","9","3","0","0.75000","392","247","145"
"1996","Notre Dame (IN)","8","3","0","0.72727","407","181","226"
"1999","South Carolina","0","11","0","0.00000","87","278","-191"
"2000","South Carolina","8","4","0","0.66667","283","181","102"
"2001","South Carolina","9","3","0","0.75000","310","230","80"
"2002","South Carolina","5","7","0","0.41667","225","262","-37"
"2003","South Carolina","5","7","0","0.41667","268","314","-46"
"2004","South Carolina","6","5","0","0.54545","243","229","14"
"1997","Notre Dame (IN)","7","6","0","0.53846","282","265","17"
"1998","Notre Dame (IN)","9","3","0","0.75000","328","248","80"
"1999","Notre Dame (IN)","5","7","0","0.41667","348","331","17"
"2000","Notre Dame (IN)","9","3","0","0.75000","353","267","86"
"2001","Notre Dame (IN)","5","6","0","0.45455","214","215","-1"
"2012","New Mexico","4","9","0","0.30769","335","393","-58"
"2013","New Mexico","3","9","0","0.25000","393","513","-120"
"1995","Stanford (CA)","7","4","1","0.62500","344","307","37"
"1996","Stanford (CA)","7","5","0","0.58333","247","229","18"
"1997","Stanford (CA)","5","6","0","0.45455","276","317","-41"
"1998","Stanford (CA)","3","8","0","0.27273","261","365","-104"
"1999","Stanford (CA)","8","4","0","0.66667","418","364","54"
"2000","Stanford (CA)","5","6","0","0.45455","261","294","-33"
"2001","Stanford (CA)","9","3","0","0.75000","422","339","83"
"2002","Notre Dame (IN)","10","3","0","0.76923","290","217","73"
"2003","Notre Dame (IN)","5","7","0","0.41667","243","315","-72"
"2004","Notre Dame (IN)","6","5","0","0.54545","268","251","17"
"2005","Washington","2","9","0","0.18182","237","337","-100"
"2006","Washington","5","7","0","0.41667","262","311","-49"
"2007","Washington","4","9","0","0.30769","380","411","-31"
"2008","Washington","0","12","0","0.00000","159","463","-304"
"2004","Notre Dame (IN)","0","1","0","0.00000","21","38","-17"
"2012","San Jose St. (CA)","1","0","0","1.00000","29","20","9"
"2005","Notre Dame (IN)","9","3","0","0.75000","440","294","146"
"2006","Notre Dame (IN)","10","3","0","0.76923","403","310","93"
"2007","Notre Dame (IN)","3","9","0","0.25000","197","345","-148"
"2008","Notre Dame (IN)","7","6","0","0.53846","321","288","33"
"2009","Notre Dame (IN)","6","6","0","0.50000","361","311","50"
"2012","Kansas","1","11","0","0.08333","219","433","-214"
"2013","Kansas","3","9","0","0.25000","184","382","-198"
"1991","Grand Valley St. (MI)","9","3","0","0.75000","313","166","147"
"1992","Grand Valley St. (MI)","8","3","0","0.72727","249","219","30"
"1993","Grand Valley St. (MI)","6","3","2","0.63636","271","227","44"
"1994","Grand Valley St. (MI)","8","4","0","0.66667","387","239","148"
"1995","Grand Valley St. (MI)","8","3","0","0.72727","407","211","196"
"1996","Grand Valley St. (MI)","8","3","0","0.72727","272","165","107"
"1997","Grand Valley St. (MI)","9","2","0","0.81818","330","237","93"
"1998","Grand Valley St. (MI)","9","3","0","0.75000","462","322","140"
"1999","Grand Valley St. (MI)","5","5","0","0.50000","259","273","-14"
"2000","Grand Valley St. (MI)","7","4","0","0.63636","337","284","53"
"2001","Grand Valley St. (MI)","13","1","0","0.92857","707","231","476"
"2002","Grand Valley St. (MI)","14","0","0","1.00000","654","231","423"
"2003","Grand Valley St. (MI)","14","1","0","0.93333","551","200","351"
"2004","Central Michigan","4","7","0","0.36364","260","378","-118"
"2005","Central Michigan","6","5","0","0.54545","260","260","0"
"2006","Central Michigan","10","4","0","0.71429","412","322","90"
"2007","Cincinnati (OH)","10","3","0","0.76923","472","244","228"
"2008","Cincinnati (OH)","11","3","0","0.78571","362","282","80"
"2009","Cincinnati (OH)","12","0","0","1.00000","478","249","229"
"2010","Notre Dame (IN)","8","5","0","0.61538","342","263","79"
"2011","Notre Dame (IN)","8","5","0","0.61538","380","269","111"
"2012","Notre Dame (IN)","12","1","0","0.92308","335","166","169"
"2013","Notre Dame (IN)","9","4","0","0.69231","354","291","63"
"1869","Rutgers (NJ)","2","2","0","0.50000","18","18","0"
"1870","Rutgers (NJ)","2","2","0","0.50000","17","17","0"
"1872","Columbia (NY)","5","4","0","0.55556","22","16","6"
"1873","Rutgers (NJ)","7","4","1","0.62500","31","26","5"
"1874","Harvard (MA)","9","7","0","0.56250","54","41","13"
"1875","Harvard (MA)","12","6","2","0.65000","52","29","23"
"1876","Harvard (MA)","13","8","1","0.61364","45","29","16"
"1877","Harvard (MA)","9","7","3","0.55263","31","21","10"
"1878","Pennsylvania","14","9","5","0.58929","42","24","18"
"1879","Harvard (MA)","13","9","12","0.55882","46","27","19"
"1880","Harvard (MA)","18","11","4","0.60606","75","53","22"
"1881","Rutgers (NJ)","22","18","8","0.54167","70","47","23"
"1882","Rutgers (NJ)","41","28","2","0.59155","176","111","65"
"1883","Rutgers (NJ)","38","32","1","0.54225","1288","965","323"
"1884","Pennsylvania","47","29","5","0.61111","1728","1184","544"
"1885","Michigan","34","17","4","0.65455","1437","612","825"
"1886","Lehigh (PA)","48","21","4","0.68493","1850","637","1213"
"1887","California","67","35","3","0.65238","2660","935","1725"
"1888","Princeton (NJ)","70","56","6","0.55303","2468","1899","569"
"1889","Brown (RI)","82","51","11","0.60764","2879","1796","1083"
"1890","Brown (RI)","77","76","9","0.50309","3002","2455","547"
"1891","Southern California","94","76","13","0.54918","2813","2189","624"
"1892","Minnesota","93","80","9","0.53571","2972","2394","578"
"1893","Duke (NC)","79","94","9","0.45879","2176","2912","-736"
"1894","Colorado St.","50","62","4","0.44828","1161","1518","-357"
"1895","Boston (MA)","31","44","11","0.42442","692","1031","-339"
"1896","Rhode Island","54","62","12","0.46875","1126","1201","-75"
"1897","Boston (MA)","32","40","6","0.44872","792","785","7"
"1898","Miami (OH)","47","23","4","0.66216","921","644","277"
"1899","New Hampshire","33","32","6","0.50704","571","522","49"
"1900","New Hampshire","22","35","11","0.40441","442","686","-244"
"1901","Marshall (WV)","18","34","3","0.35455","302","917","-615"
"1902","Saint John's (MN)","9","22","4","0.31429","148","460","-312"
"1903","Wichita St. (KS)","14","25","2","0.36585","376","546","-170"
"1904","Oklahoma St.","11","14","1","0.44231","194","394","-200"
"1905","Miami (OH)","7","25","5","0.25676","245","494","-249"
"1906","Rensselaer Tech (NY)","3","7","4","0.35714","92","107","-15"
"1907","Marshall (WV)","5","10","2","0.35294","71","238","-167"
"1908","Fort Hays St. (KS)","5","6","1","0.45833","56","91","-35"
"1909","Fort Hays St. (KS)","1","3","1","0.30000","12","68","-56"
"1910","Texas St.","0","1","0","0.00000","0","19","-19"
"1912","Fort Hays St. (KS)","1","2","0","0.33333","20","132","-112"
"1913","Eureka (IL)","1","6","0","0.14286","39","203","-164"
"1914","Eureka (IL)","3","4","0","0.42857","57","201","-144"
"1915","Texas St.","1","1","1","0.50000","13","20","-7"
"1916","Texas St.","0","2","1","0.16667","0","106","-106"
"1917","Boston (MA)","4","4","0","0.50000","73","136","-63"
"1918","Monmouth (IL)","1","7","0","0.12500","26","137","-111"
"1930","Troy (AL)","1","2","0","0.33333","7","73","-66"
"2013","Grambling St. (LA)","0","1","0","0.00000","0","0","0"
"1895","Ohio","2","3","0","0.40000","78","128","-50"
"1896","Ohio","4","3","1","0.56250","86","122","-36"
"1897","Ohio","1","0","0","1.00000","36","6","30"
"1898","Ohio","1","3","0","0.25000","11","45","-34"
"1897","Ohio","6","2","0","0.75000","114","20","94"
"1899","Ohio","2","2","0","0.50000","78","77","1"
"1903","Ohio","2","5","0","0.28571","45","159","-114"
"1900","Ohio","2","4","1","0.35714","39","85","-46"
"1895","Virginia Tech","4","2","0","0.66667","69","76","-7"
"1896","Virginia Tech","5","2","1","0.68750","158","50","108"
"1901","Ohio","6","3","2","0.63636","108","88","20"
"1902","Ohio","0","6","1","0.07143","0","165","-165"
"1904","Ohio","2","4","1","0.35714","57","83","-26"
"1905","Ohio","2","5","2","0.33333","48","141","-93"
"1906","Ohio","7","1","0","0.87500","158","28","130"
"1907","Ohio","3","4","1","0.43750","76","139","-63"
"1908","Ohio","3","5","0","0.37500","100","65","35"
"1909","Ohio","2","4","2","0.37500","26","106","-80"
"1910","Ohio","0","6","1","0.07143","0","125","-125"
"1911","Ohio","3","3","2","0.50000","88","44","44"
"1912","Ohio","1","7","1","0.16667","48","168","-120"
"1913","Ohio","2","5","1","0.31250","55","159","-104"
"1914","Ohio","4","4","0","0.50000","119","99","20"
"1915","Ohio","7","2","0","0.77778","168","49","119"
"1916","Ohio","5","2","1","0.68750","154","109","45"
"1917","Ohio","3","5","0","0.37500","85","114","-29"
"1918","Drake (IA)","3","2","0","0.60000","84","117","-33"
"1919","Drake (IA)","4","3","0","0.57143","68","46","22"
"1920","Drake (IA)","4","5","1","0.45000","170","128","42"
"1921","Tennessee","6","2","1","0.72222","102","35","67"
"1922","Tennessee","8","2","0","0.80000","239","45","194"
"1923","Tennessee","5","4","1","0.55000","82","167","-85"
"1924","Tennessee","3","5","0","0.37500","83","135","-52"
"1925","Tennessee","5","2","1","0.68750","129","73","56"
"1918","Ohio","4","0","1","0.90000","140","19","121"
"1919","Ohio","3","5","0","0.37500","147","101","46"
"1920","Ohio","4","3","0","0.57143","155","44","111"
"1921","Ohio","4","4","1","0.50000","112","99","13"
"1922","Ohio","5","3","0","0.62500","100","48","52"
"1923","Ohio","3","5","1","0.38889","64","88","-24"
"1924","Ohio","4","4","0","0.50000","64","59","5"
"1925","Ohio","6","2","0","0.75000","96","40","56"
"1926","Ohio","5","2","1","0.68750","111","17","94"
"1927","Ohio","4","2","2","0.62500","85","69","16"
"1928","Ohio","6","3","0","0.66667","254","66","188"
"1929","Ohio","9","0","0","1.00000","305","7","298"
"1930","Ohio","8","0","1","0.94444","266","26","240"
"1931","Ohio","7","1","0","0.87500","172","14","158"
"1932","Ohio","7","2","0","0.77778","172","29","143"
"1933","Ohio","6","2","1","0.72222","277","28","249"
"1934","Ohio","4","4","1","0.50000","116","67","49"
"1935","Ohio","8","0","0","1.00000","170","36","134"
"1936","Ohio","5","2","1","0.68750","67","76","-9"
"1937","Ohio","5","3","1","0.61111","168","52","116"
"1938","Ohio","7","2","0","0.77778","161","89","72"
"1939","Ohio","6","3","0","0.66667","116","82","34"
"1940","Ohio","5","2","2","0.66667","89","32","57"
"1941","Ohio","5","2","1","0.68750","108","42","66"
"1942","Ohio","5","3","0","0.62500","144","107","37"
"1945","Ohio","3","4","0","0.42857","100","106","-6"
"1946","Ohio","6","3","0","0.66667","206","97","109"
"1947","Ohio","3","5","1","0.38889","80","116","-36"
"1948","Ohio","3","6","0","0.33333","98","179","-81"
"1944","Ohio St.","9","0","0","1.00000","287","79","208"
"1945","Ohio St.","7","2","0","0.77778","194","71","123"
"1949","Ohio","4","4","1","0.50000","114","120","-6"
"1950","Ohio","6","4","0","0.60000","165","161","4"
"1951","Ohio","5","4","1","0.55000","167","141","26"
"1952","Ohio","6","2","1","0.72222","180","160","20"
"1953","Ohio","6","2","1","0.72222","245","86","159"
"1954","Ohio","6","3","0","0.66667","175","158","17"
"1955","Ohio","5","4","0","0.55556","160","134","26"
"1956","Ohio","2","7","0","0.22222","136","211","-75"
"1957","Ohio","2","6","1","0.27778","134","156","-22"
"1958","Ohio","5","4","0","0.55556","159","102","57"
"1959","Ohio","7","2","0","0.77778","215","101","114"
"1960","Ohio","10","0","0","1.00000","269","34","235"
"1961","Ohio","5","3","1","0.61111","129","116","13"
"1962","Ohio","8","3","0","0.72727","261","112","149"
"1963","Ohio","6","4","0","0.60000","135","103","32"
"1964","Ohio","5","4","1","0.55000","122","99","23"
"1965","Ohio","0","10","0","0.00000","77","210","-133"
"1966","Ohio","5","5","0","0.50000","149","183","-34"
"1967","Ohio","6","4","0","0.60000","223","173","50"
"1968","Ohio","10","1","0","0.90909","418","228","190"
"1969","Ohio","5","4","1","0.55000","256","222","34"
"1970","Ohio","4","5","0","0.44444","178","261","-83"
"1971","Ohio","5","5","0","0.50000","240","173","67"
"1972","Ohio","3","8","0","0.27273","185","321","-136"
"1973","Ohio","5","5","0","0.50000","156","231","-75"
"1974","Ohio","6","5","0","0.54545","249","211","38"
"1975","Ohio","5","5","1","0.50000","164","143","21"
"1976","Ohio","7","4","0","0.63636","253","175","78"
"1977","Ohio","1","10","0","0.09091","241","361","-120"
"1978","Ohio","3","8","0","0.27273","120","246","-126"
"1979","Ohio","6","5","0","0.54545","238","174","64"
"1980","Ohio","6","5","0","0.54545","222","196","26"
"1981","Ohio","5","6","0","0.45455","228","257","-29"
"1982","Ohio","6","5","0","0.54545","160","259","-99"
"1983","Ohio","4","7","0","0.36364","163","270","-107"
"1984","Ohio","4","6","1","0.40909","134","264","-130"
"1985","Ohio","2","9","0","0.18182","181","305","-124"
"1986","Ohio","1","10","0","0.09091","196","329","-133"
"1987","Ohio","1","10","0","0.09091","127","271","-144"
"1988","Ohio","4","6","1","0.40909","195","288","-93"
"1989","Ohio","1","9","1","0.13636","191","348","-157"
"1979","Morehead St. (KY)","5","4","1","0.55000","96","121","-25"
"1980","Morehead St. (KY)","4","7","0","0.36364","178","229","-51"
"1989","Maine","9","3","0","0.75000","433","232","201"
"1990","Ohio","1","9","1","0.13636","162","342","-180"
"1991","Ohio","2","8","1","0.22727","176","308","-132"
"1992","Ohio","1","10","0","0.09091","145","253","-108"
"1993","Ohio","4","7","0","0.36364","134","282","-148"
"1994","Ohio","0","11","0","0.00000","82","259","-177"
"1995","Ohio","2","8","1","0.22727","161","320","-159"
"1996","Ohio","6","6","0","0.50000","302","237","65"
"1997","Ohio","8","3","0","0.72727","301","177","124"
"1998","Ohio","5","6","0","0.45455","269","303","-34"
"1999","Ohio","5","6","0","0.45455","271","287","-16"
"2000","Ohio","7","4","0","0.63636","343","208","135"
"2001","Wake Forest (NC)","6","5","0","0.54545","292","311","-19"
"2002","Wake Forest (NC)","7","6","0","0.53846","356","327","29"
"2003","Wake Forest (NC)","5","7","0","0.41667","335","347","-12"
"2004","Wake Forest (NC)","4","7","0","0.36364","230","253","-23"
"2005","Wake Forest (NC)","4","7","0","0.36364","269","316","-47"
"2006","Wake Forest (NC)","11","3","0","0.78571","302","215","87"
"2007","Wake Forest (NC)","9","4","0","0.69231","362","289","73"
"2008","Wake Forest (NC)","8","5","0","0.61538","273","238","35"
"2009","Wake Forest (NC)","5","7","0","0.41667","316","315","1"
"2010","Wake Forest (NC)","3","9","0","0.25000","273","430","-157"
"2011","Wake Forest (NC)","6","7","0","0.46154","338","356","-18"
"2012","Wake Forest (NC)","5","7","0","0.41667","222","382","-160"
"2013","Wake Forest (NC)","4","8","0","0.33333","220","289","-69"
"2001","Ohio","1","10","0","0.09091","198","323","-125"
"2002","Ohio","4","8","0","0.33333","299","374","-75"
"2003","Ohio","2","10","0","0.16667","263","372","-109"
"2004","Ohio","4","7","0","0.36364","221","271","-50"
"1998","Nebraska","9","4","0","0.69231","403","206","197"
"1999","Nebraska","12","1","0","0.92308","442","171","271"
"2000","Nebraska","10","2","0","0.83333","522","230","292"
"2001","Nebraska","11","2","0","0.84615","463","226","237"
"2002","Nebraska","7","7","0","0.50000","383","335","48"
"2003","Nebraska","9","3","0","0.75000","305","185","120"
"2005","Ohio","4","7","0","0.36364","192","336","-144"
"2006","Ohio","9","5","0","0.64286","276","253","23"
"2007","Ohio","6","6","0","0.50000","366","359","7"
"2008","Ohio","4","8","0","0.33333","289","327","-38"
"2009","Ohio","9","5","0","0.64286","347","298","49"
"2010","Ohio","8","5","0","0.61538","357","309","48"
"2011","Ohio","10","4","0","0.71429","427","310","117"
"2012","Ohio","9","4","0","0.69231","412","322","90"
"2013","Ohio","7","6","0","0.53846","356","357","-1"
"1889","Ohio St.","1","0","0","1.00000","20","14","6"
"1890","Ohio St.","0","3","0","0.00000","10","96","-86"
"1891","Ohio St.","2","2","0","0.50000","18","80","-62"
"1892","Ohio St.","5","3","0","0.62500","260","144","116"
"1893","Ohio St.","4","5","0","0.44444","196","178","18"
"1894","Ohio St.","6","5","0","0.54545","168","114","54"
"1895","Ohio St.","4","4","2","0.50000","56","102","-46"
"1898","Ohio St.","3","5","1","0.38889","80","122","-42"
"1896","Ohio St.","5","5","1","0.50000","122","104","18"
"1897","Ohio St.","1","7","1","0.16667","18","168","-150"
"1899","Ohio St.","9","0","1","0.95000","184","5","179"
"1900","Ohio St.","8","1","1","0.85000","213","26","187"
"1901","Ohio St.","5","3","1","0.61111","94","56","38"
"1902","Ohio St.","6","2","2","0.70000","172","136","36"
"1903","Ohio St.","8","3","0","0.72727","265","87","178"
"1899","Hamilton (NY)","8","2","1","0.77273","282","67","215"
"1900","Syracuse (NY)","7","2","1","0.75000","208","60","148"
"1901","Syracuse (NY)","7","1","0","0.87500","185","27","158"
"1902","Syracuse (NY)","6","2","1","0.72222","172","93","79"
"1903","Hamilton (NY)","6","3","0","0.66667","136","91","45"
"1904","Ohio St.","6","5","0","0.54545","219","123","96"
"1905","Ohio St.","8","2","2","0.75000","197","63","134"
"1908","Colgate (NY)","4","3","0","0.57143","78","25","53"
"1909","Kentucky","9","1","0","0.90000","261","29","232"
"1910","Kentucky","7","2","0","0.77778","140","29","111"
"1911","Miami (OH)","2","4","2","0.37500","57","45","12"
"1912","Kentucky","7","2","0","0.77778","250","41","209"
"1913","West Virginia","3","4","2","0.44444","109","137","-28"
"1914","Tulane (LA)","3","3","1","0.50000","145","147","-2"
"1906","Ohio St.","8","1","0","0.88889","153","14","139"
"1907","Ohio St.","7","2","1","0.75000","160","49","111"
"1908","Ohio St.","6","4","0","0.60000","118","92","26"
"1909","Ohio St.","7","3","0","0.70000","219","76","143"
"1908","Syracuse (NY)","6","3","1","0.65000","171","39","132"
"1909","Yale (CT)","10","0","0","1.00000","209","0","209"
"1910","Ohio St.","6","1","3","0.75000","182","27","155"
"1913","Yale (CT)","5","2","3","0.65000","126","34","92"
"1916","Iowa","4","3","0","0.57143","121","156","-35"
"1917","Iowa","3","6","0","0.33333","91","160","-69"
"1918","Iowa","6","2","1","0.72222","123","36","87"
"1919","Iowa","5","2","0","0.71429","90","44","46"
"1920","Iowa","5","2","0","0.71429","142","54","88"
"1921","Iowa","7","0","0","1.00000","185","36","149"
"1922","Iowa","7","0","0","1.00000","208","33","175"
"1923","Iowa","5","3","0","0.62500","124","55","69"
"1924","Duke (NC)","4","5","0","0.44444","129","99","30"
"1925","Southern California","11","2","0","0.84615","456","55","401"
"1926","Southern California","8","2","0","0.80000","317","52","265"
"1927","Southern California","8","1","1","0.85000","287","64","223"
"1928","Southern California","9","0","1","0.95000","267","59","208"
"1929","Southern California","10","2","0","0.83333","492","69","423"
"1930","Southern California","8","2","0","0.80000","382","66","316"
"1931","Southern California","10","1","0","0.90909","363","52","311"
"1932","Southern California","10","0","0","1.00000","201","13","188"
"1933","Southern California","10","1","1","0.87500","257","30","227"
"1934","Southern California","4","6","1","0.40909","120","110","10"
"1935","Southern California","5","7","0","0.41667","155","124","31"
"1936","Southern California","4","2","3","0.61111","129","65","64"
"1937","Southern California","4","4","2","0.50000","136","98","38"
"1938","Southern California","9","2","0","0.81818","172","65","107"
"1939","Southern California","8","0","2","0.90000","181","33","148"
"1940","Southern California","3","4","2","0.44444","88","98","-10"
"1911","Ohio St.","5","3","2","0.60000","47","40","7"
"1915","Fordham (NY)","4","4","0","0.50000","72","85","-13"
"1911","Wisconsin","5","1","1","0.78571","111","14","97"
"1912","Ohio St.","6","3","0","0.66667","244","122","122"
"1917","Wisconsin","4","2","1","0.64286","85","30","55"
"1919","Wisconsin","5","2","0","0.71429","91","41","50"
"1920","Wisconsin","6","1","0","0.85714","141","29","112"
"1921","Wisconsin","5","1","1","0.78571","141","13","128"
"1922","Wisconsin","4","2","1","0.64286","101","22","79"
"1913","Ohio St.","4","2","1","0.64286","154","27","127"
"1914","Ohio St.","5","2","0","0.71429","108","55","53"
"1915","Ohio St.","5","1","1","0.78571","105","39","66"
"1916","Ohio St.","7","0","0","1.00000","258","29","229"
"1917","Ohio St.","8","0","1","0.94444","292","6","286"
"1918","Ohio St.","3","3","0","0.50000","134","41","93"
"1919","Ohio St.","6","1","0","0.85714","176","12","164"
"1920","Ohio St.","7","1","0","0.87500","150","48","102"
"1921","Ohio St.","5","2","0","0.71429","110","14","96"
"1922","Ohio St.","3","4","0","0.42857","43","57","-14"
"1923","Ohio St.","3","4","1","0.43750","124","99","25"
"1924","Ohio St.","2","3","3","0.43750","40","45","-5"
"1925","Ohio St.","4","3","1","0.56250","55","45","10"
"1926","Ohio St.","7","1","0","0.87500","196","43","153"
"1927","Ohio St.","4","4","0","0.50000","131","92","39"
"1928","Ohio St.","5","2","1","0.68750","135","35","100"
"1922","Iowa St.","2","6","0","0.25000","51","124","-73"
"1923","Iowa St.","4","3","1","0.56250","121","93","28"
"1924","Iowa St.","4","3","1","0.56250","87","68","19"
"1925","Iowa St.","4","3","1","0.56250","107","93","14"
"1929","Ohio St.","4","3","1","0.56250","95","69","26"
"1930","Ohio St.","5","2","1","0.68750","139","48","91"
"1931","Ohio St.","6","3","0","0.66667","194","74","120"
"1932","Ohio St.","4","1","3","0.68750","90","41","49"
"1933","Ohio St.","7","1","0","0.87500","161","26","135"
"1919","Tulsa (OK)","8","0","1","0.94444","591","27","564"
"1920","Tulsa (OK)","10","0","1","0.95455","621","21","600"
"1921","Tulsa (OK)","6","3","0","0.66667","257","95","162"
"1922","Arkansas","4","5","0","0.44444","143","136","7"
"1923","Arkansas","7","2","1","0.75000","178","40","138"
"1924","Arkansas","7","2","1","0.75000","227","69","158"
"1925","Arkansas","4","4","1","0.50000","95","62","33"
"1926","Arkansas","5","5","0","0.50000","179","88","91"
"1927","Arkansas","8","1","0","0.88889","218","76","142"
"1928","Arkansas","7","2","0","0.77778","251","63","188"
"1929","Texas Christian","9","0","1","0.95000","249","33","216"
"1930","Texas Christian","9","2","1","0.79167","298","49","249"
"1931","Texas Christian","8","2","1","0.77273","119","41","78"
"1932","Texas Christian","10","0","1","0.95455","283","23","260"
"1933","Texas Christian","9","2","1","0.79167","208","49","159"
"1934","Ohio St.","7","1","0","0.87500","267","34","233"
"1935","Ohio St.","7","1","0","0.87500","237","57","180"
"1936","Ohio St.","5","3","0","0.62500","160","27","133"
"1937","Ohio St.","6","2","0","0.75000","125","23","102"
"1938","Ohio St.","4","3","1","0.56250","119","65","54"
"1939","Ohio St.","6","2","0","0.75000","189","64","125"
"1940","Ohio St.","4","4","0","0.50000","99","113","-14"
"1941","Idaho","4","5","0","0.44444","123","135","-12"
"1942","Idaho","3","7","0","0.30000","96","209","-113"
"1941","Ohio St.","6","1","1","0.81250","167","110","57"
"1942","Ohio St.","9","1","0","0.90000","337","114","223"
"1943","Ohio St.","3","6","0","0.33333","149","187","-38"
"1944","Ohio St.","9","0","0","1.00000","287","79","208"
"1945","Ohio St.","7","2","0","0.77778","194","71","123"
"1949","Ohio","4","4","1","0.50000","114","120","-6"
"1950","Ohio","6","4","0","0.60000","165","161","4"
"1951","Ohio","5","4","1","0.55000","167","141","26"
"1952","Ohio","6","2","1","0.72222","180","160","20"
"1953","Ohio","6","2","1","0.72222","245","86","159"
"1954","Ohio","6","3","0","0.66667","175","158","17"
"1955","Ohio","5","4","0","0.55556","160","134","26"
"1956","Ohio","2","7","0","0.22222","136","211","-75"
"1957","Ohio","2","6","1","0.27778","134","156","-22"
"1946","Ohio St.","4","3","2","0.55556","166","170","-4"
"1947","Colgate (NY)","1","5","2","0.25000","87","139","-52"
"1948","Colgate (NY)","3","6","0","0.33333","133","196","-63"
"1949","Colgate (NY)","1","8","0","0.11111","186","291","-105"
"1950","Colgate (NY)","5","3","0","0.62500","184","193","-9"
"1951","Colgate (NY)","4","5","0","0.44444","184","187","-3"
"1946","Pittsburgh (PA)","3","5","1","0.38889","88","136","-48"
"1947","Ohio St.","2","6","1","0.27778","60","150","-90"
"1948","Ohio St.","6","3","0","0.66667","184","94","90"
"1949","Ohio St.","7","1","2","0.80000","207","136","71"
"1950","Ohio St.","6","3","0","0.66667","286","111","175"
"1951","Minnesota","2","6","1","0.27778","162","258","-96"
"1952","Minnesota","4","3","2","0.55556","131","171","-40"
"1953","Minnesota","4","4","1","0.50000","150","160","-10"
"1949","Miami (OH)","5","4","0","0.55556","251","163","88"
"1950","Miami (OH)","9","1","0","0.90000","356","100","256"
"1951","Ohio St.","4","3","2","0.55556","109","104","5"
"1952","Ohio St.","6","3","0","0.66667","197","119","78"
"1953","Ohio St.","6","3","0","0.66667","182","164","18"
"1954","Ohio St.","10","0","0","1.00000","249","75","174"
"1955","Ohio St.","7","2","0","0.77778","201","97","104"
"1956","Ohio St.","6","3","0","0.66667","160","81","79"
"1957","Ohio St.","9","1","0","0.90000","267","92","175"
"1958","Ohio St.","6","1","2","0.77778","182","132","50"
"1959","Ohio St.","3","5","1","0.38889","83","114","-31"
"1960","Ohio St.","7","2","0","0.77778","209","90","119"
"1961","Ohio St.","8","0","1","0.94444","221","83","138"
"1962","Ohio St.","6","3","0","0.66667","205","98","107"
"1963","Ohio St.","5","3","1","0.61111","110","102","8"
"1964","Ohio St.","7","2","0","0.77778","146","76","70"
"1965","Ohio St.","7","2","0","0.77778","156","118","38"
"1966","Ohio St.","4","5","0","0.44444","108","123","-15"
"1967","Ohio St.","6","3","0","0.66667","145","120","25"
"1968","Ohio St.","10","0","0","1.00000","323","150","173"
"1969","Ohio St.","8","1","0","0.88889","383","93","290"
"1970","Ohio St.","9","1","0","0.90000","290","120","170"
"1971","Ohio St.","6","4","0","0.60000","224","120","104"
"1972","Ohio St.","9","2","0","0.81818","280","171","109"
"1973","Ohio St.","10","0","1","0.95455","413","64","349"
"1974","Ohio St.","10","2","0","0.83333","437","129","308"
"1975","Ohio St.","11","1","0","0.91667","384","102","282"
"1976","Ohio St.","9","2","1","0.79167","305","149","156"
"1977","Ohio St.","9","3","0","0.75000","343","120","223"
"1978","Ohio St.","7","4","1","0.62500","339","216","123"
"1973","Iowa St.","4","7","0","0.36364","245","236","9"
"1974","Iowa St.","4","7","0","0.36364","186","198","-12"
"1975","Iowa St.","4","7","0","0.36364","161","263","-102"
"1976","Iowa St.","8","3","0","0.72727","369","216","153"
"1977","Iowa St.","8","4","0","0.66667","249","178","71"
"1978","Iowa St.","8","4","0","0.66667","219","188","31"
"1979","Ohio St.","11","1","0","0.91667","390","126","264"
"1980","Ohio St.","9","3","0","0.75000","387","181","206"
"1981","Ohio St.","9","3","0","0.75000","387","253","134"
"1982","Ohio St.","9","3","0","0.75000","348","208","140"
"1983","Ohio St.","9","3","0","0.75000","410","206","204"
"1984","Ohio St.","9","3","0","0.75000","391","200","191"
"1985","Ohio St.","9","3","0","0.75000","325","212","113"
"1986","Ohio St.","10","3","0","0.76923","347","179","168"
"1987","Ohio St.","6","4","1","0.59091","224","181","43"
"1988","Northern Iowa","5","6","0","0.45455","292","239","53"
"1989","Colorado St.","5","5","1","0.50000","350","303","47"
"1990","Colorado St.","9","4","0","0.69231","372","302","70"
"1991","Colorado St.","3","8","0","0.27273","265","375","-110"
"1992","Colorado St.","5","7","0","0.41667","281","334","-53"
"1977","Tulsa (OK)","3","8","0","0.27273","192","398","-206"
"1978","Tulsa (OK)","9","2","0","0.81818","289","203","86"
"1979","Tulsa (OK)","6","5","0","0.54545","195","221","-26"
"1980","Tulsa (OK)","8","3","0","0.72727","243","196","47"
"1981","Tulsa (OK)","6","5","0","0.54545","304","196","108"
"1982","Tulsa (OK)","10","1","0","0.90909","342","196","146"
"1983","Tulsa (OK)","8","3","0","0.72727","297","185","112"
"1984","Tulsa (OK)","6","5","0","0.54545","261","206","55"
"1985","Arizona St.","8","4","0","0.66667","285","168","117"
"1986","Arizona St.","10","1","1","0.87500","379","167","212"
"1987","Arizona St.","7","4","1","0.62500","334","263","71"
"1988","Ohio St.","4","6","1","0.40909","229","283","-54"
"1989","Ohio St.","8","4","0","0.66667","339","297","42"
"1990","Ohio St.","7","4","1","0.62500","349","220","129"
"1991","Ohio St.","8","4","0","0.66667","277","187","90"
"1992","Ohio St.","8","3","1","0.70833","271","158","113"
"1993","Ohio St.","10","1","1","0.87500","351","193","158"
"1994","Ohio St.","9","4","0","0.69231","336","211","125"
"1995","Ohio St.","11","2","0","0.84615","475","220","255"
"1996","Ohio St.","11","1","0","0.91667","455","131","324"
"1997","Ohio St.","10","3","0","0.76923","394","170","224"
"1998","Ohio St.","11","1","0","0.91667","430","144","286"
"1999","Ohio St.","6","6","0","0.50000","285","287","-2"
"2000","Ohio St.","8","4","0","0.66667","331","222","109"
"1986","Youngstown St. (OH)","2","9","0","0.18182","223","288","-65"
"1987","Youngstown St. (OH)","8","4","0","0.66667","240","231","9"
"1988","Youngstown St. (OH)","4","7","0","0.36364","190","267","-77"
"1989","Youngstown St. (OH)","9","4","0","0.69231","372","245","127"
"1990","Youngstown St. (OH)","11","1","0","0.91667","340","146","194"
"1991","Youngstown St. (OH)","12","3","0","0.80000","413","256","157"
"1992","Youngstown St. (OH)","11","3","1","0.76667","448","295","153"
"1993","Youngstown St. (OH)","13","2","0","0.86667","448","232","216"
"1994","Youngstown St. (OH)","14","0","1","0.96667","418","152","266"
"1995","Youngstown St. (OH)","3","8","0","0.27273","188","236","-48"
"1996","Youngstown St. (OH)","8","3","0","0.72727","261","131","130"
"1997","Youngstown St. (OH)","13","2","0","0.86667","460","230","230"
"1998","Youngstown St. (OH)","6","5","0","0.54545","250","261","-11"
"1999","Youngstown St. (OH)","12","3","0","0.80000","421","362","59"
"2000","Youngstown St. (OH)","9","3","0","0.75000","296","189","107"
"2001","Ohio St.","7","5","0","0.58333","312","244","68"
"2002","Ohio St.","14","0","0","1.00000","410","183","227"
"2003","Ohio St.","11","2","0","0.84615","322","229","93"
"2004","Ohio St.","8","4","0","0.66667","290","219","71"
"2005","Ohio St.","10","2","0","0.83333","392","183","209"
"2006","Ohio St.","12","1","0","0.92308","450","166","284"
"2007","Ohio St.","11","2","0","0.84615","408","166","242"
"2008","Ohio St.","10","3","0","0.76923","359","181","178"
"2009","Ohio St.","11","2","0","0.84615","377","163","214"
"2010","Ohio St.","0","1","0","0.00000","504","186","318"
"2011","Ohio St.","6","7","0","0.46154","318","273","45"
"2001","Bowling Green (OH)","8","3","0","0.72727","333","215","118"
"2002","Bowling Green (OH)","9","3","0","0.75000","490","304","186"
"2003","Utah","10","2","0","0.83333","344","229","115"
"2004","Utah","11","0","0","1.00000","509","227","282"
"2005","Florida","9","3","0","0.75000","343","226","117"
"2006","Florida","13","1","0","0.92857","416","189","227"
"2007","Florida","9","4","0","0.69231","552","331","221"
"2008","Florida","13","1","0","0.92857","611","181","430"
"2009","Florida","13","1","0","0.92857","502","174","328"
"2010","Florida","8","5","0","0.61538","388","277","111"
"2012","Ohio St.","12","0","0","1.00000","446","274","172"
"2013","Ohio St.","12","2","0","0.85714","637","317","320"
"1895","Oklahoma","0","1","0","0.00000","0","34","-34"
"1869","Rutgers (NJ)","2","2","0","0.50000","18","18","0"
"1870","Rutgers (NJ)","2","2","0","0.50000","17","17","0"
"1872","Columbia (NY)","5","4","0","0.55556","22","16","6"
"1873","Rutgers (NJ)","7","4","1","0.62500","31","26","5"
"1874","Harvard (MA)","9","7","0","0.56250","54","41","13"
"1875","Harvard (MA)","12","6","2","0.65000","52","29","23"
"1876","Harvard (MA)","13","8","1","0.61364","45","29","16"
"1877","Harvard (MA)","9","7","3","0.55263","31","21","10"
"1878","Pennsylvania","14","9","5","0.58929","42","24","18"
"1879","Harvard (MA)","13","9","12","0.55882","46","27","19"
"1880","Harvard (MA)","18","11","4","0.60606","75","53","22"
"1881","Rutgers (NJ)","22","18","8","0.54167","70","47","23"
"1882","Rutgers (NJ)","41","28","2","0.59155","176","111","65"
"1883","Rutgers (NJ)","38","32","1","0.54225","1288","965","323"
"1884","Pennsylvania","47","29","5","0.61111","1728","1184","544"
"1885","Michigan","34","17","4","0.65455","1437","612","825"
"1886","Lehigh (PA)","48","21","4","0.68493","1850","637","1213"
"1887","California","67","35","3","0.65238","2660","935","1725"
"1888","Princeton (NJ)","70","56","6","0.55303","2468","1899","569"
"1889","Brown (RI)","82","51","11","0.60764","2879","1796","1083"
"1890","Brown (RI)","77","76","9","0.50309","3002","2455","547"
"1891","Southern California","94","76","13","0.54918","2813","2189","624"
"1892","Minnesota","93","80","9","0.53571","2972","2394","578"
"1893","Duke (NC)","79","94","9","0.45879","2176","2912","-736"
"1894","Colorado St.","50","62","4","0.44828","1161","1518","-357"
"1895","Boston (MA)","31","44","11","0.42442","692","1031","-339"
"1896","Rhode Island","54","62","12","0.46875","1126","1201","-75"
"1897","Boston (MA)","32","40","6","0.44872","792","785","7"
"1898","Miami (OH)","47","23","4","0.66216","921","644","277"
"1899","New Hampshire","33","32","6","0.50704","571","522","49"
"1900","New Hampshire","22","35","11","0.40441","442","686","-244"
"1901","Marshall (WV)","18","34","3","0.35455","302","917","-615"
"1902","Saint John's (MN)","9","22","4","0.31429","148","460","-312"
"1903","Wichita St. (KS)","14","25","2","0.36585","376","546","-170"
"1904","Oklahoma St.","11","14","1","0.44231","194","394","-200"
"1905","Miami (OH)","7","25","5","0.25676","245","494","-249"
"1906","Rensselaer Tech (NY)","3","7","4","0.35714","92","107","-15"
"1907","Marshall (WV)","5","10","2","0.35294","71","238","-167"
"1908","Fort Hays St. (KS)","5","6","1","0.45833","56","91","-35"
"1909","Fort Hays St. (KS)","1","3","1","0.30000","12","68","-56"
"1910","Texas St.","0","1","0","0.00000","0","19","-19"
"1912","Fort Hays St. (KS)","1","2","0","0.33333","20","132","-112"
"1913","Eureka (IL)","1","6","0","0.14286","39","203","-164"
"1914","Eureka (IL)","3","4","0","0.42857","57","201","-144"
"1915","Texas St.","1","1","1","0.50000","13","20","-7"
"1916","Texas St.","0","2","1","0.16667","0","106","-106"
"1917","Boston (MA)","4","4","0","0.50000","73","136","-63"
"1918","Monmouth (IL)","1","7","0","0.12500","26","137","-111"
"1930","Troy (AL)","1","2","0","0.33333","7","73","-66"
"2013","Grambling St. (LA)","0","1","0","0.00000","0","0","0"
"1897","Oklahoma","2","0","0","1.00000","33","8","25"
"1898","Oklahoma","2","0","0","1.00000","29","0","29"
"1899","Oklahoma","2","1","0","0.66667","61","28","33"
"1900","Oklahoma","3","1","1","0.70000","118","28","90"
"1901","Oklahoma","3","2","0","0.60000","93","35","58"
"1902","Oklahoma","6","3","0","0.66667","175","60","115"
"1903","Oklahoma","5","4","3","0.54167","126","85","41"
"1904","Oklahoma","4","3","1","0.56250","204","96","108"
"1905","Oklahoma","7","2","0","0.77778","229","55","174"
"1906","Oklahoma","5","2","2","0.66667","124","36","88"
"1907","Oklahoma","4","4","0","0.50000","181","75","106"
"1908","Oklahoma","8","1","1","0.85000","272","35","237"
"1909","Oklahoma","6","4","0","0.60000","203","107","96"
"1910","Oklahoma","4","2","1","0.64286","163","31","132"
"1911","Oklahoma","8","0","0","1.00000","282","15","267"
"1912","Oklahoma","5","4","0","0.55556","197","80","117"
"1913","Oklahoma","6","2","0","0.75000","323","44","279"
"1914","Oklahoma","9","1","1","0.86364","440","96","344"
"1915","Oklahoma","10","0","0","1.00000","370","54","316"
"1916","Oklahoma","6","5","0","0.54545","472","115","357"
"1917","Oklahoma","6","4","1","0.59091","451","103","348"
"1918","Oklahoma","6","0","0","1.00000","278","7","271"
"1919","Oklahoma","5","2","3","0.65000","275","63","212"
"1920","Oklahoma","6","0","1","0.92857","176","51","125"
"1921","Oklahoma","5","3","0","0.62500","127","102","25"
"1922","Oklahoma","2","3","3","0.43750","66","114","-48"
"1923","Oklahoma","3","5","0","0.37500","144","111","33"
"1924","Oklahoma","2","5","1","0.31250","28","80","-52"
"1925","Oklahoma","4","3","1","0.56250","93","44","49"
"1926","Oklahoma","5","2","1","0.68750","137","52","85"
"1927","Oklahoma","3","3","2","0.50000","117","101","16"
"1928","Oklahoma","5","3","0","0.62500","120","88","32"
"1929","Oklahoma","3","3","2","0.50000","81","81","0"
"1930","Oklahoma","4","3","1","0.56250","100","57","43"
"1931","Oklahoma","4","7","1","0.37500","88","108","-20"
"1932","Kansas","4","2","0","0.66667","70","44","26"
"1933","Kansas","5","4","1","0.55000","102","51","51"
"1934","Kansas","3","4","3","0.45000","74","48","26"
"1935","Kansas","4","4","1","0.50000","102","118","-16"
"1936","Kansas","1","6","1","0.18750","35","153","-118"
"1937","Kansas","3","4","2","0.44444","72","74","-2"
"1938","Kansas","3","6","0","0.33333","132","169","-37"
"1913","Mercer (GA)","2","5","1","0.31250","90","182","-92"
"1932","Oklahoma","4","4","1","0.50000","90","81","9"
"1933","Oklahoma","4","4","1","0.50000","82","70","12"
"1934","Oklahoma","3","4","2","0.44444","64","43","21"
"1926","Army (NY)","7","1","1","0.83333","240","71","169"
"1927","Army (NY)","9","1","0","0.90000","197","37","160"
"1928","Army (NY)","8","2","0","0.80000","215","79","136"
"1929","Army (NY)","6","4","1","0.59091","276","132","144"
"1932","Louisiana St.","6","3","1","0.65000","187","31","156"
"1933","Louisiana St.","7","0","3","0.85000","176","27","149"
"1934","Louisiana St.","7","2","2","0.72727","172","77","95"
"1935","Oklahoma","6","3","0","0.66667","99","44","55"
"1936","Oklahoma","3","3","3","0.50000","84","67","17"
"1937","Nebraska","6","1","2","0.77778","99","42","57"
"1938","Nebraska","3","5","1","0.38889","68","84","-16"
"1939","Nebraska","7","1","1","0.83333","115","70","45"
"1940","Nebraska","8","2","0","0.80000","183","75","108"
"1941","Nebraska","4","5","0","0.44444","93","81","12"
"1937","Oklahoma","5","2","2","0.66667","98","39","59"
"1938","Oklahoma","10","1","0","0.90909","185","29","156"
"1939","Oklahoma","6","2","1","0.72222","186","62","124"
"1940","Oklahoma","6","3","0","0.66667","121","105","16"
"1941","Marquette (WI)","4","5","0","0.44444","170","151","19"
"1942","Marquette (WI)","7","2","0","0.77778","193","90","103"
"1943","Marquette (WI)","3","4","1","0.43750","143","153","-10"
"1944","Marquette (WI)","1","7","0","0.12500","73","191","-118"
"1945","Marquette (WI)","5","4","1","0.55000","238","156","82"
"1941","Oklahoma","6","3","0","0.66667","218","95","123"
"1942","Oklahoma","3","5","2","0.40000","135","78","57"
"1943","Oklahoma","7","2","0","0.77778","187","92","95"
"1944","Oklahoma","6","3","1","0.65000","227","149","78"
"1945","Oklahoma","5","5","0","0.50000","169","138","31"
"1942","North Carolina","5","2","2","0.66667","149","102","47"
"1946","Oklahoma","8","3","0","0.72727","309","120","189"
"1947","Maryland","7","2","2","0.72727","207","121","86"
"1948","Maryland","6","4","0","0.60000","207","132","75"
"1949","Maryland","9","1","0","0.90000","266","82","184"
"1950","Maryland","7","2","1","0.75000","274","120","154"
"1951","Maryland","10","0","0","1.00000","381","75","306"
"1952","Maryland","7","2","0","0.77778","218","85","133"
"1953","Maryland","10","1","0","0.90909","298","38","260"
"1954","Maryland","7","2","1","0.75000","280","67","213"
"1955","Maryland","10","1","0","0.90909","217","77","140"
"1956","North Carolina","0","9","1","0.05000","99","183","-84"
"1957","North Carolina","6","4","0","0.60000","142","129","13"
"1958","North Carolina","6","4","0","0.60000","195","109","86"
"1947","Oklahoma","7","2","1","0.75000","194","161","33"
"1948","Oklahoma","10","1","0","0.90909","350","121","229"
"1949","Oklahoma","11","0","0","1.00000","399","88","311"
"1950","Oklahoma","10","1","0","0.90909","352","148","204"
"1951","Oklahoma","8","2","0","0.80000","321","97","224"
"1952","Oklahoma","8","1","1","0.85000","407","141","266"
"1953","Oklahoma","9","1","1","0.86364","293","90","203"
"1954","Oklahoma","10","0","0","1.00000","304","62","242"
"1955","Oklahoma","11","0","0","1.00000","385","60","325"
"1956","Oklahoma","10","0","0","1.00000","466","51","415"
"1957","Oklahoma","10","1","0","0.90909","333","89","244"
"1958","Oklahoma","10","1","0","0.90909","300","55","245"
"1959","Oklahoma","7","3","0","0.70000","234","146","88"
"1960","Oklahoma","3","6","1","0.35000","136","158","-22"
"1961","Oklahoma","5","5","0","0.50000","122","141","-19"
"1962","Oklahoma","8","3","0","0.72727","267","61","206"
"1963","Oklahoma","8","2","0","0.80000","236","137","99"
"1964","Oklahoma","6","4","1","0.59091","207","170","37"
"1965","Oklahoma","3","7","0","0.30000","106","150","-44"
"1966","Oklahoma","6","4","0","0.60000","192","122","70"
"1967","Oklahoma","10","1","0","0.90909","290","92","198"
"1968","Oklahoma","7","4","0","0.63636","343","225","118"
"1969","Oklahoma","6","4","0","0.60000","285","289","-4"
"1970","Oklahoma","7","4","1","0.62500","305","239","66"
"1971","Oklahoma","11","1","0","0.91667","534","217","317"
"1972","Oklahoma","8","4","0","0.66667","399","74","325"
"1979","Colorado","3","8","0","0.27273","168","274","-106"
"1980","Colorado","1","10","0","0.09091","160","451","-291"
"1981","Colorado","3","8","0","0.27273","141","322","-181"
"1973","Oklahoma","10","0","1","0.95455","400","133","267"
"1974","Oklahoma","11","0","0","1.00000","473","92","381"
"1975","Oklahoma","11","1","0","0.91667","344","154","190"
"1976","Oklahoma","9","2","1","0.79167","326","192","134"
"1977","Oklahoma","10","2","0","0.83333","401","217","184"
"1978","Oklahoma","11","1","0","0.91667","471","175","296"
"1979","Oklahoma","11","1","0","0.91667","406","145","261"
"1980","Oklahoma","10","2","0","0.83333","396","209","187"
"1981","Oklahoma","7","4","1","0.62500","341","193","148"
"1982","Oklahoma","8","4","0","0.66667","317","203","114"
"1983","Oklahoma","8","4","0","0.66667","312","222","90"
"1984","Oklahoma","9","2","1","0.79167","306","164","142"
"1985","Oklahoma","11","1","0","0.91667","371","103","268"
"1986","Oklahoma","11","1","0","0.91667","508","81","427"
"1987","Oklahoma","11","1","0","0.91667","493","102","391"
"1988","Oklahoma","9","3","0","0.75000","332","160","172"
"1989","Oklahoma","7","4","0","0.63636","380","200","180"
"1990","Oklahoma","8","3","0","0.72727","401","174","227"
"1991","Oklahoma","9","3","0","0.75000","383","157","226"
"1992","Oklahoma","5","4","2","0.54545","271","196","75"
"1993","Oklahoma","9","3","0","0.75000","358","186","172"
"1994","Oklahoma","6","6","0","0.50000","224","269","-45"
"1979","Miami (FL)","5","6","0","0.45455","191","236","-45"
"1980","Miami (FL)","9","3","0","0.75000","278","171","107"
"1981","Miami (FL)","9","2","0","0.81818","245","145","100"
"1982","Miami (FL)","7","4","0","0.63636","241","153","88"
"1983","Miami (FL)","11","1","0","0.91667","313","136","177"
"1985","Louisville (KY)","2","9","0","0.18182","199","429","-230"
"1986","Louisville (KY)","3","8","0","0.27273","179","303","-124"
"1987","Louisville (KY)","3","7","1","0.31818","215","348","-133"
"1988","Louisville (KY)","8","3","0","0.72727","261","245","16"
"1989","Louisville (KY)","6","5","0","0.54545","312","222","90"
"1990","Louisville (KY)","10","1","1","0.87500","345","149","196"
"1991","Louisville (KY)","2","9","0","0.18182","135","335","-200"
"1992","Louisville (KY)","5","6","0","0.45455","214","243","-29"
"1993","Louisville (KY)","9","3","0","0.75000","350","243","107"
"1994","Louisville (KY)","6","5","0","0.54545","255","253","2"
"1995","Oklahoma","5","5","1","0.50000","233","275","-42"
"2001","Florida Atlantic","4","6","0","0.40000","177","245","-68"
"2002","Florida Atlantic","2","9","0","0.18182","176","339","-163"
"2003","Florida Atlantic","11","3","0","0.78571","404","306","98"
"2004","Florida Atlantic","9","3","0","0.75000","299","207","92"
"2005","Florida Atlantic","2","9","0","0.18182","148","339","-191"
"2006","Florida Atlantic","5","7","0","0.41667","181","299","-118"
"2007","Florida Atlantic","8","5","0","0.61538","405","432","-27"
"2008","Florida Atlantic","7","6","0","0.53846","326","373","-47"
"2009","Florida Atlantic","5","7","0","0.41667","329","405","-76"
"2010","Florida Atlantic","4","8","0","0.33333","202","351","-149"
"2011","Florida Atlantic","1","11","0","0.08333","155","416","-261"
"1996","Oklahoma","3","8","0","0.27273","255","392","-137"
"1997","Oklahoma","4","8","0","0.33333","232","379","-147"
"1998","Oklahoma","5","6","0","0.45455","184","229","-45"
"1999","Oklahoma","7","5","0","0.58333","430","229","201"
"2000","Oklahoma","13","0","0","1.00000","481","194","287"
"2001","Oklahoma","11","2","0","0.84615","397","169","228"
"2002","Oklahoma","12","2","0","0.85714","541","216","325"
"2003","Oklahoma","12","2","0","0.85714","601","214","387"
"2004","Oklahoma","12","1","0","0.92308","452","219","233"
"2005","Oklahoma","8","4","0","0.66667","323","277","46"
"2006","Oklahoma","11","3","0","0.78571","424","242","182"
"2007","Oklahoma","11","3","0","0.78571","592","284","308"
"2008","Oklahoma","12","2","0","0.85714","716","343","373"
"2009","Oklahoma","8","5","0","0.61538","404","189","215"
"2010","Oklahoma","12","2","0","0.85714","521","305","216"
"2011","Oklahoma","10","3","0","0.76923","514","287","227"
"2012","Oklahoma","10","3","0","0.76923","496","331","165"
"2013","Oklahoma","11","2","0","0.84615","427","287","140"
"1869","Rutgers (NJ)","2","2","0","0.50000","18","18","0"
"1870","Rutgers (NJ)","2","2","0","0.50000","17","17","0"
"1872","Columbia (NY)","5","4","0","0.55556","22","16","6"
"1873","Rutgers (NJ)","7","4","1","0.62500","31","26","5"
"1874","Harvard (MA)","9","7","0","0.56250","54","41","13"
"1875","Harvard (MA)","12","6","2","0.65000","52","29","23"
"1876","Harvard (MA)","13","8","1","0.61364","45","29","16"
"1877","Harvard (MA)","9","7","3","0.55263","31","21","10"
"1878","Pennsylvania","14","9","5","0.58929","42","24","18"
"1879","Harvard (MA)","13","9","12","0.55882","46","27","19"
"1880","Harvard (MA)","18","11","4","0.60606","75","53","22"
"1881","Rutgers (NJ)","22","18","8","0.54167","70","47","23"
"1882","Rutgers (NJ)","41","28","2","0.59155","176","111","65"
"1883","Rutgers (NJ)","38","32","1","0.54225","1288","965","323"
"1884","Pennsylvania","47","29","5","0.61111","1728","1184","544"
"1885","Michigan","34","17","4","0.65455","1437","612","825"
"1886","Lehigh (PA)","48","21","4","0.68493","1850","637","1213"
"1887","California","67","35","3","0.65238","2660","935","1725"
"1888","Princeton (NJ)","70","56","6","0.55303","2468","1899","569"
"1889","Brown (RI)","82","51","11","0.60764","2879","1796","1083"
"1890","Brown (RI)","77","76","9","0.50309","3002","2455","547"
"1891","Southern California","94","76","13","0.54918","2813","2189","624"
"1892","Minnesota","93","80","9","0.53571","2972","2394","578"
"1893","Duke (NC)","79","94","9","0.45879","2176","2912","-736"
"1894","Colorado St.","50","62","4","0.44828","1161","1518","-357"
"1895","Boston (MA)","31","44","11","0.42442","692","1031","-339"
"1896","Rhode Island","54","62","12","0.46875","1126","1201","-75"
"1897","Boston (MA)","32","40","6","0.44872","792","785","7"
"1898","Miami (OH)","47","23","4","0.66216","921","644","277"
"1899","New Hampshire","33","32","6","0.50704","571","522","49"
"1900","New Hampshire","22","35","11","0.40441","442","686","-244"
"1901","Marshall (WV)","18","34","3","0.35455","302","917","-615"
"1902","Saint John's (MN)","9","22","4","0.31429","148","460","-312"
"1903","Wichita St. (KS)","14","25","2","0.36585","376","546","-170"
"1904","Oklahoma St.","11","14","1","0.44231","194","394","-200"
"1905","Miami (OH)","7","25","5","0.25676","245","494","-249"
"1906","Rensselaer Tech (NY)","3","7","4","0.35714","92","107","-15"
"1907","Marshall (WV)","5","10","2","0.35294","71","238","-167"
"1908","Fort Hays St. (KS)","5","6","1","0.45833","56","91","-35"
"1909","Fort Hays St. (KS)","1","3","1","0.30000","12","68","-56"
"1910","Texas St.","0","1","0","0.00000","0","19","-19"
"1912","Fort Hays St. (KS)","1","2","0","0.33333","20","132","-112"
"1913","Eureka (IL)","1","6","0","0.14286","39","203","-164"
"1914","Eureka (IL)","3","4","0","0.42857","57","201","-144"
"1915","Texas St.","1","1","1","0.50000","13","20","-7"
"1916","Texas St.","0","2","1","0.16667","0","106","-106"
"1917","Boston (MA)","4","4","0","0.50000","73","136","-63"
"1918","Monmouth (IL)","1","7","0","0.12500","26","137","-111"
"1930","Troy (AL)","1","2","0","0.33333","7","73","-66"
"2013","Grambling St. (LA)","0","1","0","0.00000","0","0","0"
"1872","Stevens Tech (NJ)","0","1","0","0.00000","0","6","-6"
"1873","New York (NY)","3","3","0","0.50000","15","13","2"
"1874","Stevens Tech (NJ)","2","3","0","0.40000","10","20","-10"
"1875","Stevens Tech (NJ)","4","4","0","0.50000","21","20","1"
"1876","New York (NY)","2","3","1","0.41667","16","19","-3"
"1877","Stevens Tech (NJ)","3","1","2","0.66667","9","14","-5"
"1878","Stevens Tech (NJ)","3","3","3","0.50000","3","9","-6"
"1879","Stevens Tech (NJ)","2","3","5","0.45000","8","14","-6"
"1880","Stevens Tech (NJ)","1","5","0","0.16667","3","16","-13"
"1881","Stevens Tech (NJ)","3","8","3","0.32143","16","29","-13"
"1882","Lawrence (WI)","7","8","1","0.46875","17","25","-8"
"1883","Stevens Tech (NJ)","7","6","1","0.53571","187","128","59"
"1884","Fordham (NY)","9","10","0","0.47368","221","261","-40"
"1885","Georgetown (DC)","5","17","1","0.23913","359","612","-253"
"1886","New York (NY)","9","15","2","0.38462","180","565","-385"
"1887","Fordham (NY)","8","12","1","0.40476","157","445","-288"
"1888","Amherst (MA)","6","17","3","0.28846","192","791","-599"
"1889","New York (NY)","8","21","4","0.30303","278","647","-369"
"1890","New York (NY)","25","14","2","0.63415","727","538","189"
"1891","Delaware","32","30","7","0.51449","966","971","-5"
"1892","Beloit (WI)","29","31","3","0.48413","726","797","-71"
"1893","Marquette (WI)","39","34","3","0.53289","1091","885","206"
"1894","Manhattan (NY)","32","29","7","0.52206","853","692","161"
"1895","Delaware","44","35","6","0.55294","889","813","76"
"1896","Manhattan (NY)","51","49","6","0.50943","949","1164","-215"
"1897","Stevens Tech (NJ)","37","50","4","0.42857","661","1048","-387"
"1898","Manhattan (NY)","37","43","9","0.46629","781","1050","-269"
"1899","Manhattan (NY)","34","40","6","0.46250","594","1063","-469"
"1900","Manhattan (NY)","43","47","11","0.48020","991","1049","-58"
"1901","Ferris St. (MI)","51","44","7","0.53431","906","852","54"
"1902","Indiana St.","56","48","5","0.53670","1053","927","126"
"1903","Manhattan (NY)","30","49","7","0.38953","762","1319","-557"
"1904","Saint Francis (NY)","44","53","9","0.45755","787","1363","-576"
"1905","Bluffton (OH)","38","59","5","0.39706","850","1433","-583"
"1906","Ferris St. (MI)","32","43","12","0.43678","677","854","-177"
"1907","Ferris St. (MI)","32","48","10","0.41111","722","1208","-486"
"1908","Western Illinois","36","45","10","0.45055","760","1069","-309"
"1909","Delaware Valley (PA)","27","52","2","0.34568","682","1287","-605"
"1910","East Stroudsburg (PA)","23","31","3","0.42982","583","738","-155"
"1911","Western Illinois","32","44","7","0.42771","661","902","-241"
"1912","Indiana (PA)","36","56","7","0.39899","1134","1463","-329"
"1913","Saint Francis (NY)","52","67","8","0.44094","1672","2360","-688"
"1914","Delaware Valley (PA)","41","50","6","0.45361","1217","1585","-368"
"1915","Western Illinois","34","35","11","0.49375","932","1217","-285"
"1916","Morgan St. (MD)","44","43","7","0.50532","1493","1270","223"
"1917","Morgan St. (MD)","21","21","2","0.50000","408","883","-475"
"1918","Oklahoma Baptist University","7","16","2","0.32000","258","358","-100"
"1919","Western Illinois","53","41","8","0.55882","1478","1056","422"
"1920","Virginia Union","28","39","2","0.42029","506","893","-387"
"1921","Cooper Union (NY)","19","34","3","0.36607","441","1112","-671"
"1922","Cooper Union (NY)","27","34","6","0.44776","703","832","-129"
"1923","Cooper Union (NY)","31","45","2","0.41026","718","1112","-394"
"1924","East Stroudsburg (PA)","34","40","6","0.46250","946","1175","-229"
"1925","Saint Anselm (NH)","32","28","10","0.52857","847","802","45"
"1926","Saint Anselm (NH)","22","30","4","0.42857","515","702","-187"
"1927","Bethune-Cookman (FL)","20","29","8","0.42105","674","783","-109"
"1928","Saint Anselm (NH)","28","24","7","0.53390","564","1095","-531"
"1929","Saint Anselm (NH)","25","32","5","0.44355","616","843","-227"
"1930","Saint Anselm (NH)","31","27","10","0.52941","643","549","94"
"1931","Campbell (NC)","21","17","4","0.54762","465","428","37"
"1932","Campbell (NC)","7","30","3","0.21250","254","760","-506"
"1933","Campbell (NC)","11","13","3","0.46296","262","324","-62"
"1934","Bowie St. (MD)","4","7","2","0.38462","116","94","22"
"1935","Florida Southern","7","12","1","0.37500","170","162","8"
"1936","Bowie St. (MD)","5","2","1","0.68750","154","97","57"
"1937","Bowie St. (MD)","6","3","0","0.66667","98","87","11"
"1938","West Alabama","7","5","0","0.58333","151","88","63"
"1939","Elizabeth City St. (NC)","7","13","0","0.35000","150","307","-157"
"1940","Elizabeth City St. (NC)","6","5","4","0.53333","128","67","61"
"1941","Arkansas-Pine Bluff","3","9","5","0.32353","178","223","-45"
"1942","Brevard College (NC)","10","6","2","0.61111","225","189","36"
"1943","Clark Atlanta (GA)","6","8","0","0.42857","127","206","-79"
"1944","Abilene Christian (TX)","9","11","1","0.45238","158","255","-97"
"1945","Benedict (SC)","10","15","2","0.40741","299","296","3"
"1946","Elizabeth City St. (NC)","7","20","3","0.28333","144","540","-396"
"1947","Clark Atlanta (GA)","3","6","2","0.36364","49","230","-181"
"1948","Virginia-Lynchburg","4","6","1","0.40909","77","302","-225"
"1949","Virginia-Lynchburg","0","3","1","0.12500","7","70","-63"
"1950","Virginia-Lynchburg","2","3","0","0.40000","53","98","-45"
"1951","Lane (TN)","8","6","0","0.57143","295","234","61"
"1952","Lane (TN)","9","5","1","0.63333","220","206","14"
"1953","Lane (TN)","1","7","0","0.12500","58","215","-157"
"1954","Lane (TN)","2","6","0","0.25000","105","135","-30"
"1955","Lane (TN)","2","4","0","0.33333","83","129","-46"
"1957","Louisiana College","2","7","0","0.22222","106","179","-73"
"1959","Azusa Pacific (CA)","2","3","0","0.40000","117","90","27"
"1960","Azusa Pacific (CA)","4","3","1","0.56250","103","76","27"
"1961","Azusa Pacific (CA)","3","3","0","0.50000","123","147","-24"
"1963","San Francisco (CA)","2","5","0","0.28571","58","98","-40"
"1964","New York (NY)","0","2","0","0.00000","20","48","-28"
"1965","Adelphi (NY)","4","8","0","0.33333","198","216","-18"
"1966","Fairfield (CT)","18","22","2","0.45238","545","652","-107"
"1967","La Salle (PA)","25","31","0","0.44643","846","1080","-234"
"1968","Centenary (LA)","17","42","2","0.29508","726","1393","-667"
"1969","Bluffton (OH)","33","43","0","0.43421","1058","1548","-490"
"1970","Saint John's (NY)","35","54","1","0.39444","1379","1783","-404"
"1971","Bluffton (OH)","43","45","1","0.48876","1360","1384","-24"
"1972","Marquette (WI)","39","44","2","0.47059","1217","1351","-134"
"1973","Brooklyn (NY)","30","52","1","0.36747","1007","1611","-604"
"1974","Marquette (WI)","33","36","3","0.47917","959","1169","-210"
"1975","Marquette (WI)","31","22","4","0.57895","1042","932","110"
"1976","Bluffton (OH)","23","33","1","0.41228","862","1186","-324"
"1977","Manhattan (NY)","14","28","1","0.33721","568","923","-355"
"1978","Fairfield (CT)","5","7","1","0.42308","194","203","-9"
"1979","Fairfield (CT)","7","8","0","0.46667","247","260","-13"
"1980","Westfield St. (MA)","6","5","4","0.53333","184","196","-12"
"1981","San Francisco (CA)","17","14","0","0.54839","567","498","69"
"1982","Manhattan (NY)","18","16","0","0.52941","580","644","-64"
"1983","SUNY-Stony Brook (NY)","15","11","0","0.57692","474","453","21"
"1984","Stonehill (MA)","7","12","0","0.36842","231","439","-208"
"1985","Manhattan (NY)","10","10","0","0.50000","313","316","-3"
"1986","Marquette (WI)","13","17","0","0.43333","497","564","-67"
"1987","Marquette (WI)","10","17","0","0.37037","389","487","-98"
"1988","Marquette (WI)","1","5","0","0.16667","80","125","-45"
"1989","Marquette (WI)","4","4","0","0.50000","209","151","58"
"1990","Marquette (WI)","1","7","0","0.12500","80","180","-100"
"1991","Marquette (WI)","1","5","0","0.16667","106","182","-76"
"1992","Marquette (WI)","2","5","0","0.28571","81","129","-48"
"1993","Marquette (WI)","7","1","0","0.87500","212","126","86"
"1994","Marquette (WI)","1","6","0","0.14286","125","184","-59"
"1995","Marquette (WI)","3","4","0","0.42857","141","191","-50"
"1996","Marquette (WI)","3","5","0","0.37500","139","182","-43"
"1998","Madison College (WI)","2","15","0","0.11765","221","613","-392"
"1999","Marquette (WI)","0","7","0","0.00000","110","298","-188"
"2000","Marquette (WI)","1","5","0","0.16667","60","96","-36"
"2001","Marquette (WI)","2","6","0","0.25000","144","179","-35"
"2002","Marquette (WI)","3","4","0","0.42857","127","208","-81"
"2003","Marquette (WI)","1","6","0","0.14286","71","151","-80"
"2004","Marquette (WI)","0","6","0","0.00000","53","238","-185"
"2005","Marquette (WI)","2","5","0","0.28571","92","226","-134"
"2006","Marquette (WI)","1","6","0","0.14286","62","206","-144"
"2007","Marquette (WI)","2","5","0","0.28571","140","215","-75"
"2008","Marquette (WI)","0","7","0","0.00000","61","304","-243"
"2009","Marquette (WI)","0","1","0","0.00000","0","22","-22"
"1904","Central Oklahoma","2","3","0","0.40000","12","45","-33"
"1906","Oklahoma St.","1","4","2","0.28571","24","92","-68"
"1907","Oklahoma St.","1","4","1","0.25000","24","105","-81"
"1908","Oklahoma St.","4","3","0","0.57143","86","66","20"
"1909","Oklahoma St.","5","4","0","0.55556","49","33","16"
"1910","Oklahoma St.","3","4","0","0.42857","129","44","85"
"1911","Oklahoma St.","5","2","0","0.71429","256","59","197"
"1912","Oklahoma St.","6","2","0","0.75000","335","56","279"
"1913","Oklahoma St.","4","3","0","0.57143","165","27","138"
"1914","Oklahoma St.","6","2","1","0.72222","327","71","256"
"1915","North Dakota St.","3","3","0","0.50000","74","60","14"
"1916","North Dakota St.","3","2","1","0.58333","90","68","22"
"1917","North Dakota St.","4","2","0","0.66667","153","41","112"
"1919","North Dakota","2","4","1","0.35714","40","74","-34"
"1920","North Dakota","4","3","1","0.56250","123","94","29"
"1921","North Dakota","4","5","0","0.44444","180","71","109"
"1922","North Dakota","3","3","0","0.50000","30","40","-10"
"1923","North Dakota","5","3","0","0.62500","157","89","68"
"1924","North Dakota","2","8","0","0.20000","32","167","-135"
"1925","North Dakota","4","4","0","0.50000","163","77","86"
"1902","Idaho","1","3","1","0.30000","23","43","-20"
"1903","Idaho","4","1","0","0.80000","131","5","126"
"1904","Idaho","2","1","0","0.66667","36","12","24"
"1905","Idaho","5","0","0","1.00000","113","2","111"
"1906","Idaho","2","4","0","0.33333","47","49","-2"
"1909","Iowa","2","4","1","0.35714","58","97","-39"
"1910","Idaho","4","2","0","0.66667","112","69","43"
"1911","Idaho","4","3","0","0.57143","98","58","40"
"1912","Idaho","2","2","0","0.50000","26","34","-8"
"1913","Idaho","3","3","0","0.50000","93","56","37"
"1914","Idaho","2","3","1","0.41667","12","45","-33"
"1915","Oklahoma St.","4","5","1","0.45000","161","93","68"
"1916","Oklahoma St.","4","4","0","0.50000","290","95","195"
"1917","New Mexico St.","4","2","0","0.66667","231","75","156"
"1917","Oklahoma St.","4","5","0","0.44444","93","94","-1"
"1918","Oklahoma St.","4","2","0","0.66667","103","73","30"
"1919","Oklahoma St.","3","3","2","0.50000","126","94","32"
"1920","Oklahoma St.","0","7","1","0.06250","35","199","-164"
"1929","George Washington (DC)","0","8","0","0.00000","32","230","-198"
"1930","George Washington (DC)","4","4","1","0.50000","153","112","41"
"1931","George Washington (DC)","5","2","1","0.68750","200","44","156"
"1932","George Washington (DC)","6","2","1","0.72222","149","76","73"
"1933","George Washington (DC)","5","3","1","0.61111","125","51","74"
"1934","George Washington (DC)","6","3","1","0.65000","102","29","73"
"1935","George Washington (DC)","6","3","0","0.66667","135","101","34"
"1936","George Washington (DC)","7","1","1","0.83333","175","38","137"
"1937","George Washington (DC)","3","4","1","0.43750","104","105","-1"
"1921","Oklahoma St.","5","4","1","0.55000","135","125","10"
"1922","Oklahoma St.","5","4","1","0.55000","130","86","44"
"1923","Oklahoma St.","2","9","0","0.18182","40","97","-57"
"1924","Oklahoma St.","6","1","2","0.77778","117","50","67"
"1925","Oklahoma St.","2","5","1","0.31250","41","115","-74"
"1926","Oklahoma St.","3","4","1","0.43750","79","114","-35"
"1927","Oklahoma St.","4","4","0","0.50000","110","138","-28"
"1928","Oklahoma St.","1","7","0","0.12500","25","200","-175"
"1929","Marshall (WV)","5","3","1","0.61111","184","79","105"
"1930","Marshall (WV)","3","5","1","0.38889","111","130","-19"
"1929","Oklahoma St.","4","3","2","0.55556","107","79","28"
"1930","Oklahoma St.","7","2","1","0.75000","124","40","84"
"1931","Oklahoma St.","8","2","1","0.77273","183","52","131"
"1932","Oklahoma St.","9","1","2","0.83333","178","48","130"
"1933","Oklahoma St.","6","2","1","0.72222","132","57","75"
"1934","Kansas St.","7","2","1","0.75000","149","81","68"
"1935","Northwestern (IL)","4","3","1","0.56250","90","79","11"
"1936","Northwestern (IL)","7","1","0","0.87500","132","73","59"
"1937","Northwestern (IL)","4","4","0","0.50000","68","40","28"
"1938","Northwestern (IL)","4","2","2","0.62500","93","32","61"
"1939","Northwestern (IL)","3","4","1","0.43750","47","67","-20"
"1940","Northwestern (IL)","6","2","0","0.75000","170","64","106"
"1941","Northwestern (IL)","5","3","0","0.62500","173","67","106"
"1942","Northwestern (IL)","1","9","0","0.10000","96","209","-113"
"1943","Northwestern (IL)","6","2","0","0.75000","189","64","125"
"1944","Northwestern (IL)","1","7","1","0.16667","102","160","-58"
"1945","Northwestern (IL)","4","4","1","0.50000","127","148","-21"
"1946","Northwestern (IL)","4","4","1","0.50000","156","136","20"
"1947","California","9","1","0","0.90000","275","111","164"
"1948","California","10","1","0","0.90909","291","100","191"
"1949","California","10","1","0","0.90909","319","131","188"
"1950","California","9","1","1","0.86364","224","90","134"
"1951","California","8","2","0","0.80000","307","166","141"
"1952","California","7","3","0","0.70000","247","127","120"
"1953","California","4","4","2","0.50000","220","170","50"
"1954","California","5","5","0","0.50000","249","177","72"
"1955","California","2","7","1","0.25000","107","216","-109"
"1956","California","3","7","0","0.30000","135","181","-46"
"1914","Georgetown (DC)","2","4","2","0.37500","52","76","-24"
"1915","Georgetown (DC)","7","2","0","0.77778","317","30","287"
"1916","Georgetown (DC)","9","1","0","0.90000","473","32","441"
"1917","Georgetown (DC)","7","1","0","0.87500","169","53","116"
"1918","Georgetown (DC)","3","2","0","0.60000","188","48","140"
"1919","Georgetown (DC)","7","3","0","0.70000","244","79","165"
"1920","Georgetown (DC)","6","4","0","0.60000","235","138","97"
"1921","Georgetown (DC)","8","1","0","0.88889","245","51","194"
"1922","Georgetown (DC)","6","3","1","0.65000","175","77","98"
"1923","Washington St.","2","4","1","0.35714","56","84","-28"
"1924","Washington St.","1","5","2","0.25000","107","88","19"
"1925","Washington St.","3","4","1","0.43750","67","104","-37"
"1934","Oklahoma St.","4","5","1","0.45000","54","130","-76"
"1935","Oklahoma St.","3","7","0","0.30000","59","152","-93"
"1932","Tulane (LA)","6","2","1","0.72222","131","95","36"
"1933","Tulane (LA)","6","3","1","0.65000","160","68","92"
"1934","Tulane (LA)","10","1","0","0.90909","215","83","132"
"1935","Tulane (LA)","6","4","0","0.60000","156","123","33"
"1936","Oklahoma St.","1","9","0","0.10000","43","205","-162"
"1937","Oklahoma St.","4","6","0","0.40000","101","141","-40"
"1938","Oklahoma St.","2","8","0","0.20000","75","178","-103"
"1939","Oklahoma St.","5","4","1","0.55000","128","115","13"
"1940","Oklahoma St.","6","3","1","0.65000","210","137","73"
"1941","Oklahoma St.","5","4","0","0.55556","161","123","38"
"1942","Oklahoma St.","6","3","1","0.65000","235","116","119"
"1943","Oklahoma St.","3","4","0","0.42857","66","154","-88"
"1944","Oklahoma St.","8","1","0","0.88889","228","103","125"
"1945","Oklahoma St.","9","0","0","1.00000","285","76","209"
"1946","Oklahoma St.","3","7","1","0.31818","202","264","-62"
"1947","Oklahoma St.","3","7","0","0.30000","116","134","-18"
"1948","Oklahoma St.","6","4","0","0.60000","219","127","92"
"1949","Oklahoma St.","4","4","2","0.50000","223","212","11"
"1950","Oklahoma St.","4","6","1","0.40909","159","259","-100"
"1951","Oklahoma St.","3","7","0","0.30000","168","251","-83"
"1952","Oklahoma St.","3","7","0","0.30000","146","178","-32"
"1953","Oklahoma St.","7","3","0","0.70000","178","149","29"
"1954","Oklahoma St.","5","4","1","0.55000","161","119","42"
"1955","Alabama","0","10","0","0.00000","48","256","-208"
"1956","Alabama","2","7","1","0.25000","85","208","-123"
"1957","Alabama","2","7","1","0.25000","69","173","-104"
"1955","Oklahoma St.","2","8","0","0.20000","88","172","-84"
"1956","Oklahoma St.","3","5","2","0.40000","131","166","-35"
"1957","Oklahoma St.","6","3","1","0.65000","182","129","53"
"1958","Oklahoma St.","8","3","0","0.72727","201","134","67"
"1959","Oklahoma St.","6","4","0","0.60000","181","151","30"
"1960","Oklahoma St.","3","7","0","0.30000","102","126","-24"
"1961","Oklahoma St.","4","6","0","0.40000","154","166","-12"
"1962","Oklahoma St.","4","6","0","0.40000","138","214","-76"
"1963","Oklahoma St.","1","8","0","0.11111","107","260","-153"
"1964","Oklahoma St.","4","6","0","0.40000","165","192","-27"
"1965","Oklahoma St.","3","7","0","0.30000","131","173","-42"
"1966","Oklahoma St.","4","5","1","0.45000","103","138","-35"
"1967","Oklahoma St.","4","5","1","0.45000","123","140","-17"
"1968","Oklahoma St.","3","7","0","0.30000","161","288","-127"
"1969","Oklahoma St.","5","5","0","0.50000","197","200","-3"
"1970","Oklahoma St.","4","7","0","0.36364","213","337","-124"
"1971","Oklahoma St.","4","6","1","0.40909","184","322","-138"
"1972","Oklahoma St.","7","4","0","0.63636","259","203","56"
"1973","Southern Methodist (TX)","6","4","1","0.59091","259","228","31"
"1974","Southern Methodist (TX)","6","4","1","0.59091","221","240","-19"
"1975","Southern Methodist (TX)","4","7","0","0.36364","208","301","-93"
"1973","Oklahoma St.","5","4","2","0.54545","303","186","117"
"1974","Oklahoma St.","7","5","0","0.58333","262","183","79"
"1975","Oklahoma St.","7","4","0","0.63636","285","178","107"
"1976","Oklahoma St.","9","3","0","0.75000","329","214","115"
"1977","Oklahoma St.","4","7","0","0.36364","235","267","-32"
"1978","Oklahoma St.","3","8","0","0.27273","167","266","-99"
"1979","Oklahoma St.","7","4","0","0.63636","191","212","-21"
"1980","Oklahoma St.","3","7","1","0.31818","187","268","-81"
"1981","Oklahoma St.","7","5","0","0.58333","197","216","-19"
"1982","Oklahoma St.","4","5","2","0.45455","241","267","-26"
"1983","Oklahoma St.","8","4","0","0.66667","271","162","109"
"1984","Miami (FL)","8","5","0","0.61538","402","314","88"
"1985","Miami (FL)","10","2","0","0.83333","406","195","211"
"1986","Miami (FL)","11","1","0","0.91667","430","150","280"
"1987","Miami (FL)","12","0","0","1.00000","412","125","287"
"1988","Miami (FL)","11","1","0","0.91667","418","116","302"
"1984","Oklahoma St.","10","2","0","0.83333","312","148","164"
"1985","Oklahoma St.","8","4","0","0.66667","255","188","67"
"1986","Oklahoma St.","6","5","0","0.54545","181","191","-10"
"1987","Oklahoma St.","10","2","0","0.83333","409","242","167"
"1988","Oklahoma St.","10","2","0","0.83333","584","341","243"
"1989","Oklahoma St.","4","7","0","0.36364","226","319","-93"
"1990","Oklahoma St.","4","7","0","0.36364","233","309","-76"
"1991","Oklahoma St.","0","10","1","0.04545","106","307","-201"
"1992","Oklahoma St.","4","6","1","0.40909","161","251","-90"
"1993","Oklahoma St.","3","8","0","0.27273","174","236","-62"
"1994","Oklahoma St.","3","7","1","0.31818","180","256","-76"
"1995","Oklahoma St.","4","8","0","0.33333","250","345","-95"
"1996","Oklahoma St.","5","6","0","0.45455","243","327","-84"
"1997","Oklahoma St.","8","4","0","0.66667","352","233","119"
"1998","Oklahoma St.","5","6","0","0.45455","303","296","7"
"1999","Oklahoma St.","5","6","0","0.45455","267","274","-7"
"2000","Oklahoma St.","3","8","0","0.27273","202","303","-101"
"2001","Oklahoma St.","4","7","0","0.36364","242","281","-39"
"2002","Oklahoma St.","8","5","0","0.61538","446","356","90"
"2003","Oklahoma St.","9","4","0","0.69231","467","326","141"
"2004","Oklahoma St.","7","5","0","0.58333","387","301","86"
"2005","Louisiana St.","11","2","0","0.84615","383","185","198"
"2006","Louisiana St.","11","2","0","0.84615","438","164","274"
"2007","Louisiana St.","12","2","0","0.85714","541","279","262"
"2008","Louisiana St.","8","5","0","0.61538","402","314","88"
"2009","Louisiana St.","9","4","0","0.69231","323","211","112"
"2010","Louisiana St.","11","2","0","0.84615","386","237","149"
"2011","Louisiana St.","13","1","0","0.92857","500","158","342"
"2012","Louisiana St.","10","3","0","0.76923","387","228","159"
"2013","Louisiana St.","10","3","0","0.76923","465","286","179"
"2005","Oklahoma St.","4","7","0","0.36364","222","344","-122"
"2006","Oklahoma St.","7","6","0","0.53846","458","333","125"
"2007","Oklahoma St.","7","6","0","0.53846","450","384","66"
"2008","Oklahoma St.","9","4","0","0.69231","530","365","165"
"2009","Oklahoma St.","9","4","0","0.69231","369","282","87"
"2010","Oklahoma St.","11","2","0","0.84615","575","343","232"
"2011","Oklahoma St.","12","1","0","0.92308","633","348","285"
"2012","Oklahoma St.","8","5","0","0.61538","594","367","227"
"2013","Oklahoma St.","10","3","0","0.76923","508","281","227"
"1893","Oregon","1","0","0","1.00000","44","2","42"
"1894","Oregon","0","2","1","0.16667","0","28","-28"
"1895","Oregon","4","0","0","1.00000","64","8","56"
"1896","Oregon","2","1","0","0.66667","20","20","0"
"1897","Oregon","1","1","0","0.50000","18","26","-8"
"1898","Oregon","3","1","0","0.75000","167","21","146"
"1899","Oregon","4","2","1","0.64286","108","17","91"
"1901","California","9","0","1","0.95000","106","15","91"
"1900","Oregon","3","3","1","0.50000","66","44","22"
"1901","Oregon","3","4","1","0.43750","33","44","-11"
"1903","Oregon","4","2","1","0.64286","75","18","57"
"1902","Oregon","3","1","4","0.62500","87","16","71"
"1904","Nevada","3","3","0","0.50000","55","69","-14"
"1905","Oregon","4","2","2","0.62500","65","39","26"
"1906","Oregon","5","0","1","0.91667","50","10","40"
"1908","Arkansas","5","4","0","0.55556","213","120","93"
"1909","Arkansas","7","0","0","1.00000","186","18","168"
"1910","Arkansas","7","1","0","0.87500","221","19","202"
"1911","Arkansas","6","2","1","0.72222","268","23","245"
"1912","Arkansas","4","6","0","0.40000","149","179","-30"
"1913","Oregon","3","3","1","0.50000","132","54","78"
"1914","Oregon","4","2","1","0.64286","113","30","83"
"1915","Oregon","6","2","0","0.75000","169","53","116"
"1916","Oregon","7","0","1","0.93750","244","17","227"
"1917","Oregon","4","3","0","0.57143","73","74","-1"
"1918","Penn St.","1","2","1","0.37500","22","66","-44"
"1919","Penn St.","7","1","0","0.87500","173","33","140"
"1920","Penn St.","7","0","2","0.88889","259","35","224"
"1921","Penn St.","8","0","2","0.90000","251","56","195"
"1922","Penn St.","6","4","1","0.59091","185","62","123"
"1923","Penn St.","6","2","1","0.72222","159","46","113"
"1924","Penn St.","6","3","1","0.65000","202","65","137"
"1925","Penn St.","4","4","1","0.50000","67","66","1"
"1926","Penn St.","5","4","0","0.55556","200","83","117"
"1927","Penn St.","6","2","1","0.72222","163","81","82"
"1928","Penn St.","3","5","1","0.38889","93","68","25"
"1929","Penn St.","6","3","0","0.66667","101","75","26"
"1949","Delaware Valley (PA)","3","5","0","0.37500","96","144","-48"
"1907","Oregon","5","1","0","0.83333","100","14","86"
"1908","Oregon","5","2","0","0.71429","74","52","22"
"1909","Oregon","4","2","0","0.66667","72","29","43"
"1903","Cornell (NY)","6","3","1","0.65000","120","103","17"
"1905","North Carolina","4","3","1","0.56250","82","90","-8"
"1906","Colgate (NY)","4","2","2","0.62500","102","56","46"
"1907","Colgate (NY)","4","4","1","0.50000","108","61","47"
"1910","Oregon","4","1","0","0.80000","172","11","161"
"1911","Oregon","3","2","0","0.60000","59","51","8"
"1912","Oregon","3","4","0","0.42857","39","77","-38"
"1918","Oregon","4","2","0","0.66667","81","35","46"
"1919","Oregon","5","2","0","0.71429","104","40","64"
"1920","Oregon","3","2","1","0.58333","37","38","-1"
"1921","Oregon","5","1","3","0.72222","145","75","70"
"1922","Oregon","6","1","1","0.81250","99","26","73"
"1923","Oregon","3","4","1","0.43750","113","66","47"
"1904","Utah","7","1","0","0.87500","301","38","263"
"1905","Utah","6","2","0","0.75000","260","74","186"
"1906","Utah","6","1","0","0.85714","170","6","164"
"1907","Utah","7","2","0","0.77778","147","66","81"
"1908","Utah","4","2","1","0.64286","211","49","162"
"1909","Utah","6","1","0","0.85714","180","19","161"
"1924","Oregon","4","3","2","0.55556","94","66","28"
"1904","Oregon","5","3","0","0.62500","64","59","5"
"1925","Oregon","1","5","1","0.21429","53","108","-55"
"1923","Army (NY)","6","2","1","0.72222","237","56","181"
"1924","Army (NY)","5","1","2","0.75000","111","41","70"
"1925","Army (NY)","7","2","0","0.77778","185","71","114"
"1926","Oregon","2","4","1","0.35714","86","88","-2"
"1927","Oregon","2","4","1","0.35714","45","69","-24"
"1928","Oregon","9","2","0","0.81818","235","59","176"
"1929","Oregon","7","3","0","0.70000","209","91","118"
"1930","Holy Cross (MA)","8","2","0","0.80000","195","45","150"
"1931","Holy Cross (MA)","7","2","1","0.75000","166","53","113"
"1932","Holy Cross (MA)","6","1","0","0.85714","101","35","66"
"1917","Dartmouth (NH)","5","3","0","0.62500","83","68","15"
"1918","Dartmouth (NH)","3","3","0","0.50000","78","83","-5"
"1919","Dartmouth (NH)","6","1","1","0.81250","141","53","88"
"1920","Dartmouth (NH)","7","2","0","0.77778","199","68","131"
"1921","West Virginia","5","4","1","0.55000","161","82","79"
"1922","West Virginia","10","0","1","0.95455","267","34","233"
"1923","West Virginia","7","1","1","0.83333","297","41","256"
"1924","West Virginia","8","1","0","0.88889","282","47","235"
"1925","Minnesota","5","2","1","0.68750","176","91","85"
"1926","Minnesota","5","3","0","0.62500","269","57","212"
"1927","Minnesota","6","0","2","0.87500","209","51","158"
"1928","Minnesota","6","2","0","0.75000","182","36","146"
"1929","Minnesota","6","2","0","0.75000","179","55","124"
"1930","Oregon","7","2","0","0.77778","131","35","96"
"1931","Oregon","6","2","2","0.70000","90","87","3"
"1932","Wisconsin","6","1","1","0.81250","151","48","103"
"1933","Wisconsin","2","5","1","0.31250","54","79","-25"
"1934","Wisconsin","4","4","0","0.50000","48","84","-36"
"1935","Wisconsin","1","7","0","0.12500","53","171","-118"
"1936","Toledo (OH)","2","6","0","0.25000","94","58","36"
"1937","Toledo (OH)","6","3","0","0.66667","128","96","32"
"1938","Toledo (OH)","6","3","1","0.65000","156","83","73"
"1939","Toledo (OH)","7","3","0","0.70000","180","59","121"
"1940","Toledo (OH)","6","3","0","0.66667","146","78","68"
"1941","Toledo (OH)","7","4","0","0.63636","195","122","73"
"1942","Toledo (OH)","4","4","1","0.50000","91","114","-23"
"1943","Maryland","4","5","0","0.44444","105","194","-89"
"1944","Maryland","1","7","1","0.16667","46","170","-124"
"1932","Oregon","6","3","1","0.65000","109","70","39"
"1933","Oregon","9","1","0","0.90000","165","50","115"
"1934","Oregon","6","4","0","0.60000","108","98","10"
"1935","Oregon","6","3","0","0.66667","70","63","7"
"1936","Oregon","2","6","1","0.27778","34","96","-62"
"1937","Oregon","4","6","0","0.40000","114","158","-44"
"1933","Arizona","5","3","0","0.62500","113","35","78"
"1934","Arizona","7","2","1","0.75000","138","54","84"
"1935","Arizona","7","2","0","0.77778","218","45","173"
"1936","Arizona","5","2","3","0.65000","190","54","136"
"1937","Arizona","8","2","0","0.80000","194","88","106"
"1938","Oregon","4","5","0","0.44444","69","138","-69"
"1939","Oregon","3","4","1","0.43750","101","74","27"
"1940","Oregon","4","4","1","0.50000","100","58","42"
"1941","Oregon","5","5","0","0.50000","136","184","-48"
"1945","Oregon","3","6","0","0.33333","116","124","-8"
"1946","Oregon","4","4","1","0.50000","81","118","-37"
"1942","Oregon","2","6","0","0.25000","67","138","-71"
"1936","Akron (OH)","6","2","1","0.72222","150","87","63"
"1937","Akron (OH)","7","2","0","0.77778","139","53","86"
"1938","Akron (OH)","6","3","0","0.66667","117","94","23"
"1939","Nevada","5","4","0","0.55556","49","101","-52"
"1940","Nevada","4","4","1","0.50000","252","79","173"
"1941","Nevada","3","5","1","0.38889","100","114","-14"
"1942","Nevada","4","3","1","0.56250","81","80","1"
"1943","Nevada","4","1","1","0.75000","114","25","89"
"1944","Nevada","4","4","0","0.50000","92","93","-1"
"1945","Nevada","7","3","0","0.70000","240","147","93"
"1946","Nevada","7","2","0","0.77778","324","82","242"
"1947","Oregon","7","3","0","0.70000","174","121","53"
"1948","Oregon","9","2","0","0.81818","207","103","104"
"1949","Oregon","4","6","0","0.40000","250","219","31"
"1950","Oregon","1","9","0","0.10000","97","214","-117"
"1946","Santa Clara (CA)","2","5","1","0.31250","112","181","-69"
"1947","Santa Clara (CA)","4","4","0","0.50000","109","158","-49"
"1948","Santa Clara (CA)","7","2","1","0.75000","228","153","75"
"1949","Santa Clara (CA)","8","2","1","0.77273","222","114","108"
"1950","Pittsburgh (PA)","1","8","0","0.11111","99","204","-105"
"1951","Oregon","2","8","0","0.20000","130","317","-187"
"1952","Oregon","2","7","1","0.25000","112","234","-122"
"1953","Oregon","4","5","1","0.45000","91","85","6"
"1954","Oregon","6","4","0","0.60000","218","159","59"
"1955","Oregon","6","4","0","0.60000","204","158","46"
"1956","Oregon","4","4","2","0.50000","133","102","31"
"1957","Oregon","7","4","0","0.63636","160","97","63"
"1958","Oregon","4","6","0","0.40000","93","50","43"
"1959","Oregon","8","2","0","0.80000","209","113","96"
"1960","Oregon","7","3","1","0.68182","206","130","76"
"1961","Oregon","4","6","0","0.40000","152","112","40"
"1962","Oregon","6","3","1","0.65000","229","156","73"
"1963","Oregon","8","3","0","0.72727","274","153","121"
"1964","Oregon","7","2","1","0.75000","170","107","63"
"1965","Oregon","4","5","1","0.45000","165","186","-21"
"1966","Oregon","3","7","0","0.30000","118","129","-11"
"1967","Oregon","2","8","0","0.20000","104","193","-89"
"1968","Oregon","4","6","0","0.40000","132","201","-69"
"1969","Oregon","5","5","1","0.50000","271","242","29"
"1970","Oregon","6","4","1","0.59091","285","256","29"
"1971","Oregon","5","6","0","0.45455","235","286","-51"
"1972","Oregon","4","7","0","0.36364","194","285","-91"
"1973","Oregon","2","9","0","0.18182","205","239","-34"
"1968","Portland St. (OR)","4","6","0","0.40000","187","302","-115"
"1969","Portland St. (OR)","6","4","0","0.60000","293","220","73"
"1970","Portland St. (OR)","6","4","0","0.60000","276","191","85"
"1971","Portland St. (OR)","4","5","0","0.44444","151","218","-67"
"1974","Oregon","2","9","0","0.18182","116","330","-214"
"1975","Oregon","3","8","0","0.27273","146","266","-120"
"1976","Oregon","4","7","0","0.36364","144","271","-127"
"1981","Portland St. (OR)","2","9","0","0.18182","152","320","-168"
"1982","Portland St. (OR)","2","9","0","0.18182","138","319","-181"
"1983","Portland St. (OR)","3","7","0","0.30000","175","237","-62"
"1984","Portland St. (OR)","8","3","0","0.72727","253","189","64"
"1985","Portland St. (OR)","4","5","1","0.45000","261","287","-26"
"1986","Montana","6","4","0","0.60000","362","306","56"
"1987","Montana","6","5","0","0.54545","323","205","118"
"1988","Montana","8","4","0","0.66667","307","212","95"
"1989","Montana","11","3","0","0.78571","451","283","168"
"1990","Montana","7","4","0","0.63636","372","275","97"
"1991","Montana","7","4","0","0.63636","274","241","33"
"1992","Montana","6","5","0","0.54545","290","223","67"
"1993","Montana","10","2","0","0.83333","501","310","191"
"1994","Montana","11","3","0","0.78571","472","294","178"
"1995","Montana","13","2","0","0.86667","652","299","353"
"1977","Oregon","3","8","0","0.27273","164","377","-213"
"1978","Oregon","1","10","0","0.09091","173","212","-39"
"1979","Oregon","4","7","0","0.36364","200","212","-12"
"1980","Oregon","6","3","2","0.63636","263","193","70"
"1981","Oregon","2","9","0","0.18182","155","247","-92"
"1982","Oregon","2","8","1","0.22727","103","223","-120"
"1983","Oregon","4","6","1","0.40909","152","224","-72"
"1984","Oregon","6","5","0","0.54545","241","247","-6"
"1985","Oregon","5","6","0","0.45455","273","300","-27"
"1986","Oregon","5","6","0","0.45455","235","338","-103"
"1987","Oregon","6","5","0","0.54545","230","228","2"
"1988","Oregon","6","6","0","0.50000","296","247","49"
"1989","Oregon","8","4","0","0.66667","379","251","128"
"1990","Oregon","8","4","0","0.66667","341","221","120"
"1991","Oregon","3","8","0","0.27273","186","248","-62"
"1992","Oregon","6","6","0","0.50000","265","222","43"
"1993","Oregon","5","6","0","0.45455","278","276","2"
"1994","Oregon","9","4","0","0.69231","349","250","99"
"2003","Kentucky","4","8","0","0.33333","328","321","7"
"2004","Kentucky","2","9","0","0.18182","173","341","-168"
"2005","Kentucky","3","8","0","0.27273","239","375","-136"
"2006","Kentucky","8","5","0","0.61538","347","369","-22"
"2007","Kentucky","8","5","0","0.61538","475","385","90"
"2008","Kentucky","7","6","0","0.53846","294","279","15"
"2009","Kentucky","7","6","0","0.53846","339","295","44"
"1995","Oregon","9","3","0","0.75000","326","272","54"
"1996","Oregon","6","5","0","0.54545","378","356","22"
"1997","Oregon","7","5","0","0.58333","380","350","30"
"1998","Oregon","8","4","0","0.66667","473","328","145"
"1999","Oregon","9","3","0","0.75000","410","284","126"
"2000","Oregon","10","2","0","0.83333","351","249","102"
"2001","Oregon","11","1","0","0.91667","412","256","156"
"2002","Oregon","7","6","0","0.53846","417","362","55"
"2003","Oregon","8","5","0","0.61538","356","348","8"
"2004","Oregon","5","6","0","0.45455","282","282","0"
"2005","Oregon","10","2","0","0.83333","414","278","136"
"2006","Oregon","7","6","0","0.53846","383","345","38"
"2007","Oregon","9","4","0","0.69231","496","307","189"
"2008","Oregon","10","3","0","0.76923","545","367","178"
"2009","Oregon","10","3","0","0.76923","469","309","160"
"2010","Oregon","12","1","0","0.92308","611","243","368"
"2011","Oregon","12","2","0","0.85714","645","345","300"
"2012","Oregon","12","1","0","0.92308","645","281","364"
"2013","Oregon","11","2","0","0.84615","591","266","325"
"1893","Oregon St.","4","1","0","0.80000","144","48","96"
"1897","Oregon St.","2","0","0","1.00000","42","8","34"
"1894","Oregon St.","2","1","0","0.66667","52","28","24"
"1895","Oregon St.","0","2","1","0.16667","6","80","-74"
"1896","Oregon St.","1","2","0","0.33333","26","14","12"
"1869","Rutgers (NJ)","2","2","0","0.50000","18","18","0"
"1870","Rutgers (NJ)","2","2","0","0.50000","17","17","0"
"1872","Columbia (NY)","5","4","0","0.55556","22","16","6"
"1873","Rutgers (NJ)","7","4","1","0.62500","31","26","5"
"1874","Harvard (MA)","9","7","0","0.56250","54","41","13"
"1875","Harvard (MA)","12","6","2","0.65000","52","29","23"
"1876","Harvard (MA)","13","8","1","0.61364","45","29","16"
"1877","Harvard (MA)","9","7","3","0.55263","31","21","10"
"1878","Pennsylvania","14","9","5","0.58929","42","24","18"
"1879","Harvard (MA)","13","9","12","0.55882","46","27","19"
"1880","Harvard (MA)","18","11","4","0.60606","75","53","22"
"1881","Rutgers (NJ)","22","18","8","0.54167","70","47","23"
"1882","Rutgers (NJ)","41","28","2","0.59155","176","111","65"
"1883","Rutgers (NJ)","38","32","1","0.54225","1288","965","323"
"1884","Pennsylvania","47","29","5","0.61111","1728","1184","544"
"1885","Michigan","34","17","4","0.65455","1437","612","825"
"1886","Lehigh (PA)","48","21","4","0.68493","1850","637","1213"
"1887","California","67","35","3","0.65238","2660","935","1725"
"1888","Princeton (NJ)","70","56","6","0.55303","2468","1899","569"
"1889","Brown (RI)","82","51","11","0.60764","2879","1796","1083"
"1890","Brown (RI)","77","76","9","0.50309","3002","2455","547"
"1891","Southern California","94","76","13","0.54918","2813","2189","624"
"1892","Minnesota","93","80","9","0.53571","2972","2394","578"
"1893","Duke (NC)","79","94","9","0.45879","2176","2912","-736"
"1894","Colorado St.","50","62","4","0.44828","1161","1518","-357"
"1895","Boston (MA)","31","44","11","0.42442","692","1031","-339"
"1896","Rhode Island","54","62","12","0.46875","1126","1201","-75"
"1897","Boston (MA)","32","40","6","0.44872","792","785","7"
"1898","Miami (OH)","47","23","4","0.66216","921","644","277"
"1899","New Hampshire","33","32","6","0.50704","571","522","49"
"1900","New Hampshire","22","35","11","0.40441","442","686","-244"
"1901","Marshall (WV)","18","34","3","0.35455","302","917","-615"
"1902","Saint John's (MN)","9","22","4","0.31429","148","460","-312"
"1903","Wichita St. (KS)","14","25","2","0.36585","376","546","-170"
"1904","Oklahoma St.","11","14","1","0.44231","194","394","-200"
"1905","Miami (OH)","7","25","5","0.25676","245","494","-249"
"1906","Rensselaer Tech (NY)","3","7","4","0.35714","92","107","-15"
"1907","Marshall (WV)","5","10","2","0.35294","71","238","-167"
"1908","Fort Hays St. (KS)","5","6","1","0.45833","56","91","-35"
"1909","Fort Hays St. (KS)","1","3","1","0.30000","12","68","-56"
"1910","Texas St.","0","1","0","0.00000","0","19","-19"
"1912","Fort Hays St. (KS)","1","2","0","0.33333","20","132","-112"
"1913","Eureka (IL)","1","6","0","0.14286","39","203","-164"
"1914","Eureka (IL)","3","4","0","0.42857","57","201","-144"
"1915","Texas St.","1","1","1","0.50000","13","20","-7"
"1916","Texas St.","0","2","1","0.16667","0","106","-106"
"1917","Boston (MA)","4","4","0","0.50000","73","136","-63"
"1918","Monmouth (IL)","1","7","0","0.12500","26","137","-111"
"1930","Troy (AL)","1","2","0","0.33333","7","73","-66"
"2013","Grambling St. (LA)","0","1","0","0.00000","0","0","0"
"1899","Oregon St.","3","2","0","0.60000","75","60","15"
"1872","Stevens Tech (NJ)","0","1","0","0.00000","0","6","-6"
"1873","New York (NY)","3","3","0","0.50000","15","13","2"
"1874","Stevens Tech (NJ)","2","3","0","0.40000","10","20","-10"
"1875","Stevens Tech (NJ)","4","4","0","0.50000","21","20","1"
"1876","New York (NY)","2","3","1","0.41667","16","19","-3"
"1877","Stevens Tech (NJ)","3","1","2","0.66667","9","14","-5"
"1878","Stevens Tech (NJ)","3","3","3","0.50000","3","9","-6"
"1879","Stevens Tech (NJ)","2","3","5","0.45000","8","14","-6"
"1880","Stevens Tech (NJ)","1","5","0","0.16667","3","16","-13"
"1881","Stevens Tech (NJ)","3","8","3","0.32143","16","29","-13"
"1882","Lawrence (WI)","7","8","1","0.46875","17","25","-8"
"1883","Stevens Tech (NJ)","7","6","1","0.53571","187","128","59"
"1884","Fordham (NY)","9","10","0","0.47368","221","261","-40"
"1885","Georgetown (DC)","5","17","1","0.23913","359","612","-253"
"1886","New York (NY)","9","15","2","0.38462","180","565","-385"
"1887","Fordham (NY)","8","12","1","0.40476","157","445","-288"
"1888","Amherst (MA)","6","17","3","0.28846","192","791","-599"
"1889","New York (NY)","8","21","4","0.30303","278","647","-369"
"1890","New York (NY)","25","14","2","0.63415","727","538","189"
"1891","Delaware","32","30","7","0.51449","966","971","-5"
"1892","Beloit (WI)","29","31","3","0.48413","726","797","-71"
"1893","Marquette (WI)","39","34","3","0.53289","1091","885","206"
"1894","Manhattan (NY)","32","29","7","0.52206","853","692","161"
"1895","Delaware","44","35","6","0.55294","889","813","76"
"1896","Manhattan (NY)","51","49","6","0.50943","949","1164","-215"
"1897","Stevens Tech (NJ)","37","50","4","0.42857","661","1048","-387"
"1898","Manhattan (NY)","37","43","9","0.46629","781","1050","-269"
"1899","Manhattan (NY)","34","40","6","0.46250","594","1063","-469"
"1900","Manhattan (NY)","43","47","11","0.48020","991","1049","-58"
"1901","Ferris St. (MI)","51","44","7","0.53431","906","852","54"
"1902","Indiana St.","56","48","5","0.53670","1053","927","126"
"1903","Manhattan (NY)","30","49","7","0.38953","762","1319","-557"
"1904","Saint Francis (NY)","44","53","9","0.45755","787","1363","-576"
"1905","Bluffton (OH)","38","59","5","0.39706","850","1433","-583"
"1906","Ferris St. (MI)","32","43","12","0.43678","677","854","-177"
"1907","Ferris St. (MI)","32","48","10","0.41111","722","1208","-486"
"1908","Western Illinois","36","45","10","0.45055","760","1069","-309"
"1909","Delaware Valley (PA)","27","52","2","0.34568","682","1287","-605"
"1910","East Stroudsburg (PA)","23","31","3","0.42982","583","738","-155"
"1911","Western Illinois","32","44","7","0.42771","661","902","-241"
"1912","Indiana (PA)","36","56","7","0.39899","1134","1463","-329"
"1913","Saint Francis (NY)","52","67","8","0.44094","1672","2360","-688"
"1914","Delaware Valley (PA)","41","50","6","0.45361","1217","1585","-368"
"1915","Western Illinois","34","35","11","0.49375","932","1217","-285"
"1916","Morgan St. (MD)","44","43","7","0.50532","1493","1270","223"
"1917","Morgan St. (MD)","21","21","2","0.50000","408","883","-475"
"1918","Oklahoma Baptist University","7","16","2","0.32000","258","358","-100"
"1919","Western Illinois","53","41","8","0.55882","1478","1056","422"
"1920","Virginia Union","28","39","2","0.42029","506","893","-387"
"1921","Cooper Union (NY)","19","34","3","0.36607","441","1112","-671"
"1922","Cooper Union (NY)","27","34","6","0.44776","703","832","-129"
"1923","Cooper Union (NY)","31","45","2","0.41026","718","1112","-394"
"1924","East Stroudsburg (PA)","34","40","6","0.46250","946","1175","-229"
"1925","Saint Anselm (NH)","32","28","10","0.52857","847","802","45"
"1926","Saint Anselm (NH)","22","30","4","0.42857","515","702","-187"
"1927","Bethune-Cookman (FL)","20","29","8","0.42105","674","783","-109"
"1928","Saint Anselm (NH)","28","24","7","0.53390","564","1095","-531"
"1929","Saint Anselm (NH)","25","32","5","0.44355","616","843","-227"
"1930","Saint Anselm (NH)","31","27","10","0.52941","643","549","94"
"1931","Campbell (NC)","21","17","4","0.54762","465","428","37"
"1932","Campbell (NC)","7","30","3","0.21250","254","760","-506"
"1933","Campbell (NC)","11","13","3","0.46296","262","324","-62"
"1934","Bowie St. (MD)","4","7","2","0.38462","116","94","22"
"1935","Florida Southern","7","12","1","0.37500","170","162","8"
"1936","Bowie St. (MD)","5","2","1","0.68750","154","97","57"
"1937","Bowie St. (MD)","6","3","0","0.66667","98","87","11"
"1938","West Alabama","7","5","0","0.58333","151","88","63"
"1939","Elizabeth City St. (NC)","7","13","0","0.35000","150","307","-157"
"1940","Elizabeth City St. (NC)","6","5","4","0.53333","128","67","61"
"1941","Arkansas-Pine Bluff","3","9","5","0.32353","178","223","-45"
"1942","Brevard College (NC)","10","6","2","0.61111","225","189","36"
"1943","Clark Atlanta (GA)","6","8","0","0.42857","127","206","-79"
"1944","Abilene Christian (TX)","9","11","1","0.45238","158","255","-97"
"1945","Benedict (SC)","10","15","2","0.40741","299","296","3"
"1946","Elizabeth City St. (NC)","7","20","3","0.28333","144","540","-396"
"1947","Clark Atlanta (GA)","3","6","2","0.36364","49","230","-181"
"1948","Virginia-Lynchburg","4","6","1","0.40909","77","302","-225"
"1949","Virginia-Lynchburg","0","3","1","0.12500","7","70","-63"
"1950","Virginia-Lynchburg","2","3","0","0.40000","53","98","-45"
"1951","Lane (TN)","8","6","0","0.57143","295","234","61"
"1952","Lane (TN)","9","5","1","0.63333","220","206","14"
"1953","Lane (TN)","1","7","0","0.12500","58","215","-157"
"1954","Lane (TN)","2","6","0","0.25000","105","135","-30"
"1955","Lane (TN)","2","4","0","0.33333","83","129","-46"
"1957","Louisiana College","2","7","0","0.22222","106","179","-73"
"1959","Azusa Pacific (CA)","2","3","0","0.40000","117","90","27"
"1960","Azusa Pacific (CA)","4","3","1","0.56250","103","76","27"
"1961","Azusa Pacific (CA)","3","3","0","0.50000","123","147","-24"
"1963","San Francisco (CA)","2","5","0","0.28571","58","98","-40"
"1964","New York (NY)","0","2","0","0.00000","20","48","-28"
"1965","Adelphi (NY)","4","8","0","0.33333","198","216","-18"
"1966","Fairfield (CT)","18","22","2","0.45238","545","652","-107"
"1967","La Salle (PA)","25","31","0","0.44643","846","1080","-234"
"1968","Centenary (LA)","17","42","2","0.29508","726","1393","-667"
"1969","Bluffton (OH)","33","43","0","0.43421","1058","1548","-490"
"1970","Saint John's (NY)","35","54","1","0.39444","1379","1783","-404"
"1971","Bluffton (OH)","43","45","1","0.48876","1360","1384","-24"
"1972","Marquette (WI)","39","44","2","0.47059","1217","1351","-134"
"1973","Brooklyn (NY)","30","52","1","0.36747","1007","1611","-604"
"1974","Marquette (WI)","33","36","3","0.47917","959","1169","-210"
"1975","Marquette (WI)","31","22","4","0.57895","1042","932","110"
"1976","Bluffton (OH)","23","33","1","0.41228","862","1186","-324"
"1977","Manhattan (NY)","14","28","1","0.33721","568","923","-355"
"1978","Fairfield (CT)","5","7","1","0.42308","194","203","-9"
"1979","Fairfield (CT)","7","8","0","0.46667","247","260","-13"
"1980","Westfield St. (MA)","6","5","4","0.53333","184","196","-12"
"1981","San Francisco (CA)","17","14","0","0.54839","567","498","69"
"1982","Manhattan (NY)","18","16","0","0.52941","580","644","-64"
"1983","SUNY-Stony Brook (NY)","15","11","0","0.57692","474","453","21"
"1984","Stonehill (MA)","7","12","0","0.36842","231","439","-208"
"1985","Manhattan (NY)","10","10","0","0.50000","313","316","-3"
"1986","Marquette (WI)","13","17","0","0.43333","497","564","-67"
"1987","Marquette (WI)","10","17","0","0.37037","389","487","-98"
"1988","Marquette (WI)","1","5","0","0.16667","80","125","-45"
"1989","Marquette (WI)","4","4","0","0.50000","209","151","58"
"1990","Marquette (WI)","1","7","0","0.12500","80","180","-100"
"1991","Marquette (WI)","1","5","0","0.16667","106","182","-76"
"1992","Marquette (WI)","2","5","0","0.28571","81","129","-48"
"1993","Marquette (WI)","7","1","0","0.87500","212","126","86"
"1994","Marquette (WI)","1","6","0","0.14286","125","184","-59"
"1995","Marquette (WI)","3","4","0","0.42857","141","191","-50"
"1996","Marquette (WI)","3","5","0","0.37500","139","182","-43"
"1998","Madison College (WI)","2","15","0","0.11765","221","613","-392"
"1999","Marquette (WI)","0","7","0","0.00000","110","298","-188"
"2000","Marquette (WI)","1","5","0","0.16667","60","96","-36"
"2001","Marquette (WI)","2","6","0","0.25000","144","179","-35"
"2002","Marquette (WI)","3","4","0","0.42857","127","208","-81"
"2003","Marquette (WI)","1","6","0","0.14286","71","151","-80"
"2004","Marquette (WI)","0","6","0","0.00000","53","238","-185"
"2005","Marquette (WI)","2","5","0","0.28571","92","226","-134"
"2006","Marquette (WI)","1","6","0","0.14286","62","206","-144"
"2007","Marquette (WI)","2","5","0","0.28571","140","215","-75"
"2008","Marquette (WI)","0","7","0","0.00000","61","304","-243"
"2009","Marquette (WI)","0","1","0","0.00000","0","22","-22"
"1900","Idaho","1","0","0","1.00000","12","6","6"
"1901","Idaho","3","2","1","0.58333","38","25","13"
"1902","Oregon St.","4","1","1","0.75000","157","16","141"
"1903","Oregon St.","2","4","1","0.35714","21","32","-11"
"1901","Nevada","3","3","0","0.50000","64","31","33"
"1902","Nevada","1","2","0","0.33333","21","40","-19"
"1903","Nevada","2","4","2","0.37500","56","40","16"
"1904","Oregon St.","4","2","0","0.66667","119","22","97"
"1905","Oregon St.","6","3","0","0.66667","164","28","136"
"1906","Oregon St.","4","1","2","0.71429","77","4","73"
"1907","Oregon St.","6","0","0","1.00000","137","0","137"
"1908","Oregon St.","4","3","1","0.56250","83","51","32"
"1904","Baylor (TX)","2","5","1","0.31250","34","106","-72"
"1908","Pennsylvania","11","0","1","0.95833","215","28","187"
"1909","Oregon St.","4","2","1","0.64286","54","41","13"
"1914","West Virginia","5","4","0","0.55556","159","96","63"
"1915","West Virginia","5","2","1","0.68750","208","20","188"
"1920","South Carolina","5","4","0","0.55556","82","140","-58"
"1921","South Carolina","5","1","2","0.75000","116","28","88"
"1922","South Carolina","5","4","0","0.55556","93","69","24"
"1923","South Carolina","4","6","0","0.40000","104","77","27"
"1924","South Carolina","7","3","0","0.70000","120","48","72"
"1909","Maine","3","4","1","0.43750","53","71","-18"
"1910","Oregon St.","3","3","1","0.50000","27","49","-22"
"1911","Oregon St.","5","2","0","0.71429","119","49","70"
"1912","Oregon St.","3","4","0","0.42857","57","40","17"
"1907","Mount Union (OH)","9","2","0","0.81818","265","23","242"
"1909","Allegheny (PA)","2","4","1","0.35714","41","115","-74"
"1910","Allegheny (PA)","4","1","1","0.75000","81","29","52"
"1913","Oregon St.","3","2","3","0.56250","59","75","-16"
"1914","Oregon St.","7","0","2","0.88889","172","15","157"
"1915","Oregon St.","5","3","0","0.62500","166","73","93"
"1916","Nebraska","6","2","0","0.75000","145","51","94"
"1917","Nebraska","5","2","0","0.71429","228","33","195"
"1921","Clemson (SC)","1","6","2","0.22222","48","187","-139"
"1922","Clemson (SC)","5","4","0","0.55556","170","109","61"
"1923","Texas","8","0","1","0.94444","241","21","220"
"1924","Texas","5","3","1","0.61111","109","64","45"
"1925","Texas","6","2","1","0.72222","157","51","106"
"1926","Texas","5","4","0","0.55556","146","69","77"
"1927","Texas-El Paso","2","2","2","0.50000","69","69","0"
"1928","Texas-El Paso","3","4","1","0.43750","100","103","-3"
"1910","South Dakota","5","2","0","0.71429","142","46","96"
"1916","Oregon St.","4","5","0","0.44444","92","112","-20"
"1917","Oregon St.","4","2","1","0.64286","83","33","50"
"1914","Emporia St. (KS)","5","1","1","0.78571","190","13","177"
"1915","Emporia St. (KS)","5","2","2","0.66667","130","91","39"
"1916","Emporia St. (KS)","6","3","1","0.65000","131","75","56"
"1917","Emporia St. (KS)","5","3","1","0.61111","107","115","-8"
"1918","Oregon St.","2","4","0","0.33333","33","46","-13"
"1919","Oregon St.","4","4","1","0.50000","143","64","79"
"1920","Emporia St. (KS)","0","6","2","0.12500","101","127","-26"
"1921","Emporia St. (KS)","7","0","0","1.00000","196","24","172"
"1922","Emporia St. (KS)","6","2","0","0.75000","155","46","109"
"1923","Emporia St. (KS)","5","1","1","0.78571","112","45","67"
"1924","Emporia St. (KS)","4","4","1","0.50000","72","63","9"
"1925","Emporia St. (KS)","4","3","1","0.56250","76","56","20"
"1926","Emporia St. (KS)","7","0","0","1.00000","149","3","146"
"1927","Emporia St. (KS)","7","0","1","0.93750","145","20","125"
"1928","Kansas","2","4","2","0.37500","34","66","-32"
"1929","Kansas","4","4","0","0.50000","97","50","47"
"1930","Kansas","6","2","0","0.75000","144","50","94"
"1931","Kansas","5","5","0","0.50000","112","54","58"
"1932","Kansas","1","1","0","0.50000","19","33","-14"
"1920","Oregon St.","2","2","2","0.50000","20","52","-32"
"1921","Oregon St.","4","3","2","0.55556","231","42","189"
"1922","Oregon St.","3","4","0","0.42857","44","42","2"
"1923","Oregon St.","4","5","2","0.45455","55","71","-16"
"1915","Doane (NE)","5","3","0","0.62500","83","39","44"
"1924","Oregon St.","3","5","0","0.37500","71","85","-14"
"1925","Oregon St.","7","2","0","0.77778","268","81","187"
"1926","Oregon St.","7","1","0","0.87500","221","30","191"
"1927","Oregon St.","3","3","1","0.50000","98","78","20"
"1928","Oregon St.","6","3","0","0.66667","206","53","153"
"1929","Oregon St.","5","4","0","0.55556","182","106","76"
"1930","Oregon St.","7","3","0","0.70000","208","60","148"
"1931","Oregon St.","6","3","1","0.65000","198","62","136"
"1932","Oregon St.","4","6","0","0.40000","130","109","21"
"1933","Oregon St.","6","2","2","0.70000","88","48","40"
"1934","Oregon St.","3","6","2","0.36364","104","131","-27"
"1935","Oregon St.","6","4","1","0.59091","175","100","75"
"1936","Oregon St.","4","6","0","0.40000","116","151","-35"
"1937","Oregon St.","3","3","3","0.50000","71","60","11"
"1938","Oregon St.","5","3","1","0.61111","72","51","21"
"1939","Oregon St.","9","1","1","0.86364","186","77","109"
"1940","Oregon St.","5","3","1","0.61111","128","80","48"
"1941","Oregon St.","8","2","0","0.80000","143","49","94"
"1942","Oregon St.","4","5","1","0.45000","157","142","15"
"1945","Oregon St.","4","4","1","0.50000","100","131","-31"
"1946","Oregon St.","7","1","1","0.83333","157","81","76"
"1947","Oregon St.","5","5","0","0.50000","171","136","35"
"1948","Oregon St.","5","4","3","0.54167","249","236","13"
"1949","Oregon St.","7","3","0","0.70000","232","188","44"
"1950","Oregon St.","3","6","0","0.33333","114","183","-69"
"1951","Oregon St.","4","6","0","0.40000","204","180","24"
"1952","Oregon St.","2","7","0","0.22222","123","267","-144"
"1953","Oregon St.","3","6","0","0.33333","39","187","-148"
"1954","Oregon St.","1","8","0","0.11111","60","296","-236"
"1955","Oregon St.","6","3","0","0.66667","126","120","6"
"1956","Oregon St.","7","3","1","0.68182","203","166","37"
"1957","Oregon St.","8","2","0","0.80000","203","129","74"
"1958","Oregon St.","6","4","0","0.60000","98","118","-20"
"1959","Oregon St.","3","7","0","0.30000","166","178","-12"
"1960","Oregon St.","6","3","1","0.65000","197","145","52"
"1961","Oregon St.","5","5","0","0.50000","165","137","28"
"1962","Oregon St.","9","2","0","0.81818","279","148","131"
"1963","Oregon St.","5","5","0","0.50000","198","192","6"
"1964","Oregon St.","8","3","0","0.72727","149","124","25"
"1965","UCLA","8","2","1","0.77273","257","168","89"
"1966","UCLA","9","1","0","0.90000","281","127","154"
"1967","UCLA","7","2","1","0.75000","284","161","123"
"1968","UCLA","3","7","0","0.30000","197","246","-49"
"1969","UCLA","8","1","1","0.85000","329","103","226"
"1970","UCLA","6","5","0","0.54545","274","240","34"
"1962","Idaho","2","6","1","0.27778","108","209","-101"
"1963","Idaho","5","4","0","0.55556","186","148","38"
"1964","Idaho","4","6","0","0.40000","144","143","1"
"1965","Oregon St.","5","5","0","0.50000","125","162","-37"
"1966","Oregon St.","7","3","0","0.70000","171","156","15"
"1967","Oregon St.","7","2","1","0.75000","187","137","50"
"1968","Oregon St.","7","3","0","0.70000","285","179","106"
"1969","Oregon St.","6","4","0","0.60000","175","148","27"
"1970","Oregon St.","6","5","0","0.54545","211","239","-28"
"1971","Oregon St.","5","6","0","0.45455","268","317","-49"
"1972","Oregon St.","2","9","0","0.18182","131","295","-164"
"1973","Oregon St.","2","9","0","0.18182","166","293","-127"
"1974","Oregon St.","3","8","0","0.27273","216","285","-69"
"1975","Oregon St.","1","10","0","0.09091","103","264","-161"
"1976","Oregon St.","2","10","0","0.16667","179","325","-146"
"1977","Oregon St.","3","8","0","0.27273","173","303","-130"
"1978","Oregon St.","3","7","1","0.31818","128","266","-138"
"1979","Oregon St.","2","9","0","0.18182","147","396","-249"
"1980","Oregon St.","0","11","0","0.00000","108","386","-278"
"1981","Oregon St.","1","10","0","0.09091","145","469","-324"
"1982","Oregon St.","1","9","1","0.13636","134","306","-172"
"1983","Oregon St.","2","8","1","0.22727","171","332","-161"
"1984","Oregon St.","2","9","0","0.18182","158","279","-121"
"1969","South Dakota St.","3","7","0","0.30000","175","227","-52"
"1980","Idaho St.","6","5","0","0.54545","278","201","77"
"1981","Idaho St.","12","1","0","0.92308","422","172","250"
"1982","Idaho St.","3","8","0","0.27273","228","239","-11"
"1985","Oregon St.","3","8","0","0.27273","160","362","-202"
"1986","Oregon St.","3","8","0","0.27273","143","270","-127"
"1987","Oregon St.","2","9","0","0.18182","189","433","-244"
"1988","Oregon St.","4","6","1","0.40909","246","280","-34"
"1989","Oregon St.","4","7","1","0.37500","207","357","-150"
"1990","Oregon St.","1","10","0","0.09091","152","371","-219"
"1985","Northern Illinois","4","7","0","0.36364","174","259","-85"
"1986","Northern Illinois","2","9","0","0.18182","144","308","-164"
"1987","Northern Illinois","5","5","1","0.50000","305","262","43"
"1988","Northern Illinois","7","4","0","0.63636","155","185","-30"
"1989","Northern Illinois","9","2","0","0.81818","344","269","75"
"1990","Northern Illinois","6","5","0","0.54545","333","260","73"
"1991","Oregon St.","1","10","0","0.09091","125","365","-240"
"1992","Oregon St.","1","9","1","0.13636","163","363","-200"
"1993","Oregon St.","4","7","0","0.36364","224","294","-70"
"1994","Oregon St.","4","7","0","0.36364","223","239","-16"
"1995","Oregon St.","1","10","0","0.09091","136","237","-101"
"1996","Oregon St.","2","9","0","0.18182","216","388","-172"
"1982","Idaho","9","4","0","0.69231","397","299","98"
"1983","Idaho","8","3","0","0.72727","347","257","90"
"1984","Idaho","6","5","0","0.54545","363","283","80"
"1985","Idaho","9","3","0","0.75000","441","247","194"
"1986","Wyoming","6","6","0","0.50000","299","272","27"
"1987","Washington St.","3","7","1","0.31818","238","356","-118"
"1988","Washington St.","9","3","0","0.75000","415","303","112"
"1989","Miami (FL)","11","1","0","0.91667","426","127","299"
"1990","Miami (FL)","10","2","0","0.83333","447","184","263"
"1991","Miami (FL)","12","0","0","1.00000","386","100","286"
"1992","Miami (FL)","11","1","0","0.91667","369","161","208"
"1993","Miami (FL)","9","3","0","0.75000","331","167","164"
"1994","Miami (FL)","10","2","0","0.83333","365","143","222"
"1999","Oregon St.","7","5","0","0.58333","347","277","70"
"2000","Oregon St.","11","1","0","0.91667","400","212","188"
"2001","Oregon St.","5","6","0","0.45455","287","259","28"
"2002","Oregon St.","8","5","0","0.61538","414","267","147"
"2006","Idaho","4","8","0","0.33333","203","417","-214"
"2007","Arizona St.","10","3","0","0.76923","420","292","128"
"2008","Arizona St.","5","7","0","0.41667","274","272","2"
"2009","Arizona St.","4","8","0","0.33333","268","253","15"
"2010","Arizona St.","6","6","0","0.50000","387","300","87"
"2011","Arizona St.","6","7","0","0.46154","431","372","59"
"1997","Oregon St.","3","8","0","0.27273","195","285","-90"
"1998","Oregon St.","5","6","0","0.45455","286","291","-5"
"2003","Oregon St.","8","5","0","0.61538","433","301","132"
"2004","Oregon St.","7","5","0","0.58333","320","294","26"
"2005","Oregon St.","5","6","0","0.45455","293","365","-72"
"2006","Oregon St.","10","4","0","0.71429","389","311","78"
"2007","Oregon St.","9","4","0","0.69231","362","294","68"
"2008","Oregon St.","9","4","0","0.69231","397","300","97"
"2009","Oregon St.","8","5","0","0.61538","409","325","84"
"2010","Oregon St.","5","7","0","0.41667","293","322","-29"
"2011","Oregon St.","3","9","0","0.25000","262","370","-108"
"2012","Oregon St.","9","4","0","0.69231","423","268","155"
"2013","Oregon St.","7","6","0","0.53846","452","408","44"
"1869","Rutgers (NJ)","2","2","0","0.50000","18","18","0"
"1870","Rutgers (NJ)","2","2","0","0.50000","17","17","0"
"1872","Columbia (NY)","5","4","0","0.55556","22","16","6"
"1873","Rutgers (NJ)","7","4","1","0.62500","31","26","5"
"1874","Harvard (MA)","9","7","0","0.56250","54","41","13"
"1875","Harvard (MA)","12","6","2","0.65000","52","29","23"
"1876","Harvard (MA)","13","8","1","0.61364","45","29","16"
"1877","Harvard (MA)","9","7","3","0.55263","31","21","10"
"1878","Pennsylvania","14","9","5","0.58929","42","24","18"
"1879","Harvard (MA)","13","9","12","0.55882","46","27","19"
"1880","Harvard (MA)","18","11","4","0.60606","75","53","22"
"1881","Rutgers (NJ)","22","18","8","0.54167","70","47","23"
"1882","Rutgers (NJ)","41","28","2","0.59155","176","111","65"
"1883","Rutgers (NJ)","38","32","1","0.54225","1288","965","323"
"1884","Pennsylvania","47","29","5","0.61111","1728","1184","544"
"1885","Michigan","34","17","4","0.65455","1437","612","825"
"1886","Lehigh (PA)","48","21","4","0.68493","1850","637","1213"
"1887","California","67","35","3","0.65238","2660","935","1725"
"1888","Princeton (NJ)","70","56","6","0.55303","2468","1899","569"
"1889","Brown (RI)","82","51","11","0.60764","2879","1796","1083"
"1890","Brown (RI)","77","76","9","0.50309","3002","2455","547"
"1891","Southern California","94","76","13","0.54918","2813","2189","624"
"1892","Minnesota","93","80","9","0.53571","2972","2394","578"
"1893","Duke (NC)","79","94","9","0.45879","2176","2912","-736"
"1894","Colorado St.","50","62","4","0.44828","1161","1518","-357"
"1895","Boston (MA)","31","44","11","0.42442","692","1031","-339"
"1896","Rhode Island","54","62","12","0.46875","1126","1201","-75"
"1897","Boston (MA)","32","40","6","0.44872","792","785","7"
"1898","Miami (OH)","47","23","4","0.66216","921","644","277"
"1899","New Hampshire","33","32","6","0.50704","571","522","49"
"1900","New Hampshire","22","35","11","0.40441","442","686","-244"
"1901","Marshall (WV)","18","34","3","0.35455","302","917","-615"
"1902","Saint John's (MN)","9","22","4","0.31429","148","460","-312"
"1903","Wichita St. (KS)","14","25","2","0.36585","376","546","-170"
"1904","Oklahoma St.","11","14","1","0.44231","194","394","-200"
"1905","Miami (OH)","7","25","5","0.25676","245","494","-249"
"1906","Rensselaer Tech (NY)","3","7","4","0.35714","92","107","-15"
"1907","Marshall (WV)","5","10","2","0.35294","71","238","-167"
"1908","Fort Hays St. (KS)","5","6","1","0.45833","56","91","-35"
"1909","Fort Hays St. (KS)","1","3","1","0.30000","12","68","-56"
"1910","Texas St.","0","1","0","0.00000","0","19","-19"
"1912","Fort Hays St. (KS)","1","2","0","0.33333","20","132","-112"
"1913","Eureka (IL)","1","6","0","0.14286","39","203","-164"
"1914","Eureka (IL)","3","4","0","0.42857","57","201","-144"
"1915","Texas St.","1","1","1","0.50000","13","20","-7"
"1916","Texas St.","0","2","1","0.16667","0","106","-106"
"1917","Boston (MA)","4","4","0","0.50000","73","136","-63"
"1918","Monmouth (IL)","1","7","0","0.12500","26","137","-111"
"1930","Troy (AL)","1","2","0","0.33333","7","73","-66"
"2013","Grambling St. (LA)","0","1","0","0.00000","0","0","0"
"1892","Penn St.","6","1","0","0.85714","164","20","144"
"1893","Penn St.","6","2","0","0.75000","110","52","58"
"1894","Penn St.","6","0","1","0.92857","179","18","161"
"1895","Penn St.","2","2","3","0.50000","92","60","32"
"1896","Pittsburgh (PA)","3","6","0","0.33333","42","69","-27"
"1899","Bucknell (PA)","6","4","1","0.59091","149","129","20"
"1900","Bucknell (PA)","3","5","1","0.38889","138","70","68"
"1901","Bucknell (PA)","6","4","0","0.60000","145","46","99"
"1902","Bucknell (PA)","6","4","0","0.60000","162","82","80"
"1903","Bucknell (PA)","4","5","0","0.44444","121","121","0"
"1904","Bucknell (PA)","3","3","0","0.50000","77","46","31"
"1905","Bucknell (PA)","5","5","0","0.50000","120","182","-62"
"1906","Bucknell (PA)","3","4","1","0.43750","37","88","-51"
"1909","Bucknell (PA)","3","4","2","0.44444","59","154","-95"
"1896","Penn St.","3","4","0","0.42857","63","128","-65"
"1897","Penn St.","3","6","0","0.33333","69","141","-72"
"1898","Penn St.","6","4","0","0.60000","174","91","83"
"1899","Lafayette (PA)","12","1","0","0.92308","253","23","230"
"1900","Lafayette (PA)","9","2","0","0.81818","214","25","189"
"1901","Lafayette (PA)","9","3","0","0.75000","240","94","146"
"1902","Lehigh (PA)","7","3","1","0.68182","246","57","189"
"1903","Lehigh (PA)","9","2","1","0.79167","331","45","286"
"1904","Lehigh (PA)","1","8","0","0.11111","52","236","-184"
"1905","Lehigh (PA)","6","7","0","0.46154","154","201","-47"
"1898","Virginia Military Institute","4","2","0","0.66667","110","42","68"
"1899","Penn St.","5","6","1","0.45833","143","176","-33"
"1900","Penn St.","4","6","1","0.40909","83","156","-73"
"1901","Penn St.","5","3","0","0.62500","111","90","21"
"1902","Penn St.","7","3","0","0.70000","212","34","178"
"1899","Cincinnati (OH)","5","2","0","0.71429","81","60","21"
"1900","Cincinnati (OH)","3","5","1","0.38889","51","166","-115"
"1903","Penn St.","5","3","0","0.62500","182","77","105"
"1910","Cornell (NY)","5","2","1","0.68750","165","44","121"
"1911","Cornell (NY)","7","3","0","0.70000","101","52","49"
"1897","Cincinnati (OH)","9","1","1","0.86364","136","22","114"
"1904","Penn St.","6","4","0","0.60000","195","72","123"
"1905","Penn St.","8","3","0","0.72727","195","34","161"
"1906","Penn St.","8","1","1","0.85000","94","10","84"
"1907","Penn St.","6","4","0","0.60000","251","64","187"
"1908","Penn St.","5","5","0","0.50000","153","51","102"
"1909","Penn St.","5","0","2","0.85714","166","11","155"
"1910","Missouri","4","2","2","0.62500","77","17","60"
"1911","Penn St.","8","0","1","0.94444","199","15","184"
"1912","Penn St.","8","0","0","1.00000","285","6","279"
"1913","Penn St.","2","6","0","0.25000","78","94","-16"
"1914","Penn St.","5","3","1","0.61111","121","52","69"
"1916","Syracuse (NY)","5","4","0","0.55556","276","87","189"
"1910","Penn St.","5","2","1","0.68750","243","24","219"
"1915","Penn St.","7","2","0","0.77778","147","51","96"
"1916","Penn St.","8","2","0","0.80000","348","62","286"
"1917","Penn St.","5","4","0","0.55556","267","61","206"
"1922","Colgate (NY)","6","3","0","0.66667","297","62","235"
"1923","Colgate (NY)","6","2","1","0.72222","233","73","160"
"1924","Colgate (NY)","5","4","0","0.55556","218","96","122"
"1925","Colgate (NY)","7","0","2","0.88889","219","34","185"
"1935","Harvard (MA)","3","5","0","0.37500","107","89","18"
"1936","Harvard (MA)","3","4","1","0.43750","178","112","66"
"1937","Harvard (MA)","5","2","1","0.68750","158","46","112"
"1938","Harvard (MA)","4","4","0","0.50000","157","106","51"
"1939","Harvard (MA)","4","4","0","0.50000","162","67","95"
"1940","Harvard (MA)","3","2","3","0.56250","77","49","28"
"1941","Harvard (MA)","5","2","1","0.68750","70","43","27"
"1942","Harvard (MA)","2","6","1","0.27778","52","123","-71"
"1945","Harvard (MA)","5","3","0","0.62500","161","80","81"
"1946","Harvard (MA)","7","2","0","0.77778","214","65","149"
"1947","Harvard (MA)","4","5","0","0.44444","139","177","-38"
"1906","Oregon","5","0","1","0.91667","50","10","40"
"1908","Arkansas","5","4","0","0.55556","213","120","93"
"1909","Arkansas","7","0","0","1.00000","186","18","168"
"1910","Arkansas","7","1","0","0.87500","221","19","202"
"1911","Arkansas","6","2","1","0.72222","268","23","245"
"1912","Arkansas","4","6","0","0.40000","149","179","-30"
"1913","Oregon","3","3","1","0.50000","132","54","78"
"1914","Oregon","4","2","1","0.64286","113","30","83"
"1915","Oregon","6","2","0","0.75000","169","53","116"
"1916","Oregon","7","0","1","0.93750","244","17","227"
"1917","Oregon","4","3","0","0.57143","73","74","-1"
"1918","Penn St.","1","2","1","0.37500","22","66","-44"
"1919","Penn St.","7","1","0","0.87500","173","33","140"
"1920","Penn St.","7","0","2","0.88889","259","35","224"
"1921","Penn St.","8","0","2","0.90000","251","56","195"
"1922","Penn St.","6","4","1","0.59091","185","62","123"
"1923","Penn St.","6","2","1","0.72222","159","46","113"
"1924","Penn St.","6","3","1","0.65000","202","65","137"
"1925","Penn St.","4","4","1","0.50000","67","66","1"
"1926","Penn St.","5","4","0","0.55556","200","83","117"
"1927","Penn St.","6","2","1","0.72222","163","81","82"
"1928","Penn St.","3","5","1","0.38889","93","68","25"
"1929","Penn St.","6","3","0","0.66667","101","75","26"
"1949","Delaware Valley (PA)","3","5","0","0.37500","96","144","-48"
"1920","West Virginia Wesleyan","4","4","1","0.50000","204","90","114"
"1922","West Virginia Wesleyan","8","2","0","0.80000","181","81","100"
"1923","West Virginia Wesleyan","3","4","1","0.43750","56","99","-43"
"1924","West Virginia Wesleyan","9","3","0","0.75000","182","91","91"
"1930","Penn St.","3","4","2","0.44444","142","111","31"
"1931","Penn St.","2","8","0","0.20000","69","167","-98"
"1932","Penn St.","2","5","0","0.28571","82","115","-33"
"1933","Penn St.","3","3","1","0.50000","117","66","51"
"1934","Penn St.","4","4","0","0.50000","115","58","57"
"1935","Penn St.","4","4","0","0.50000","76","70","6"
"1936","Penn St.","3","5","0","0.37500","109","86","23"
"1937","Penn St.","5","3","0","0.62500","143","114","29"
"1938","Penn St.","3","4","1","0.43750","138","87","51"
"1939","Penn St.","5","1","2","0.75000","114","77","37"
"1940","Penn St.","6","1","1","0.81250","135","46","89"
"1941","Penn St.","7","2","0","0.77778","200","78","122"
"1942","Penn St.","6","1","1","0.81250","91","70","21"
"1943","Penn St.","5","3","1","0.61111","124","53","71"
"1944","Penn St.","6","3","0","0.66667","207","141","66"
"1945","Penn St.","5","3","0","0.62500","173","89","84"
"1946","Penn St.","6","2","0","0.75000","192","48","144"
"1947","Penn St.","9","0","1","0.95000","332","40","292"
"1948","Penn St.","7","1","1","0.83333","219","55","164"
"1949","Penn St.","5","4","0","0.55556","162","175","-13"
"1944","Brown (RI)","3","4","1","0.43750","132","150","-18"
"1945","Brown (RI)","3","4","1","0.43750","123","141","-18"
"1946","Brown (RI)","3","5","1","0.38889","122","185","-63"
"1947","Brown (RI)","4","4","1","0.50000","185","139","46"
"1948","Brown (RI)","7","2","0","0.77778","242","103","139"
"1949","Brown (RI)","8","1","0","0.88889","263","94","169"
"1950","Penn St.","5","3","1","0.61111","141","155","-14"
"1951","Penn St.","5","4","0","0.55556","155","161","-6"
"1952","Penn St.","7","2","1","0.75000","172","149","23"
"1953","Penn St.","6","3","0","0.66667","207","148","59"
"1954","Penn St.","7","2","0","0.77778","206","92","114"
"1955","Penn St.","5","4","0","0.55556","163","150","13"
"1956","Penn St.","6","2","1","0.72222","177","60","117"
"1957","Penn St.","6","3","0","0.66667","167","135","32"
"1958","Penn St.","6","3","1","0.65000","237","97","140"
"1959","Penn St.","9","2","0","0.81818","262","112","150"
"1960","Penn St.","7","3","0","0.70000","228","113","115"
"1961","Penn St.","8","3","0","0.72727","261","143","118"
"1962","Penn St.","9","2","0","0.81818","256","119","137"
"1963","Penn St.","7","3","0","0.70000","165","114","51"
"1964","Penn St.","6","4","0","0.60000","189","111","78"
"1965","Penn St.","5","5","0","0.50000","202","151","51"
"1966","Penn St.","5","5","0","0.50000","193","208","-15"
"1967","Penn St.","8","2","1","0.77273","299","158","141"
"1968","Penn St.","11","0","0","1.00000","354","120","234"
"1969","Penn St.","11","0","0","1.00000","322","90","232"
"1970","Penn St.","7","3","0","0.70000","300","163","137"
"1971","Penn St.","11","1","0","0.91667","484","137","347"
"1972","Penn St.","10","2","0","0.83333","358","189","169"
"1973","Penn St.","12","0","0","1.00000","447","129","318"
"1974","Penn St.","10","2","0","0.83333","322","142","180"
"1975","Penn St.","9","3","0","0.75000","240","123","117"
"1976","Penn St.","7","5","0","0.58333","241","173","68"
"1977","Penn St.","11","1","0","0.91667","390","187","203"
"1978","Penn St.","11","1","0","0.91667","333","111","222"
"1979","Penn St.","8","4","0","0.66667","257","177","80"
"1980","Penn St.","10","2","0","0.83333","321","158","163"
"1981","Penn St.","10","2","0","0.83333","371","162","209"
"1982","Penn St.","11","1","0","0.91667","395","196","199"
"1983","Penn St.","8","4","1","0.65385","320","312","8"
"1984","Penn St.","6","5","0","0.54545","209","230","-21"
"1985","Penn St.","11","1","0","0.91667","275","153","122"
"1986","Penn St.","12","0","0","1.00000","340","133","207"
"1987","Penn St.","8","4","0","0.66667","286","244","42"
"1988","Penn St.","5","6","0","0.45455","231","201","30"
"1989","Penn St.","8","3","1","0.70833","259","169","90"
"1990","Penn St.","9","3","0","0.75000","297","179","118"
"1991","Penn St.","11","2","0","0.84615","474","184","290"
"1992","Penn St.","7","5","0","0.58333","391","234","157"
"1993","Penn St.","10","2","0","0.83333","388","215","173"
"1994","Penn St.","12","0","0","1.00000","564","252","312"
"1995","Penn St.","9","3","0","0.75000","399","259","140"
"1996","Penn St.","11","2","0","0.84615","400","203","197"
"1997","Penn St.","9","3","0","0.75000","366","254","112"
"1998","Penn St.","0","3","0","0.00000","317","183","134"
"1999","Penn St.","0","3","0","0.00000","417","234","183"
"2000","Penn St.","0","7","0","0.00000","264","293","-29"
"2001","Penn St.","0","6","0","0.00000","248","281","-33"
"2002","Penn St.","0","4","0","0.00000","446","227","219"
"2003","Penn St.","0","9","0","0.00000","233","255","-22"
"2004","Penn St.","0","7","0","0.00000","195","168","27"
"2005","Penn St.","0","1","0","0.00000","413","204","209"
"2006","Penn St.","0","4","0","0.00000","290","187","103"
"2007","Penn St.","0","4","0","0.00000","394","228","166"
"2008","Penn St.","0","2","0","0.00000","506","187","319"
"2009","Penn St.","0","2","0","0.00000","375","159","216"
"2010","Penn St.","0","6","0","0.00000","319","308","11"
"2011","Penn St.","0","1","0","0.00000","196","112","84"
"2011","Penn St.","0","3","0","0.00000","55","106","-51"
"2012","Penn St.","8","4","0","0.66667","349","229","120"
"2013","Penn St.","7","5","0","0.58333","344","314","30"
"1869","Rutgers (NJ)","2","2","0","0.50000","18","18","0"
"1870","Rutgers (NJ)","2","2","0","0.50000","17","17","0"
"1872","Columbia (NY)","5","4","0","0.55556","22","16","6"
"1873","Rutgers (NJ)","7","4","1","0.62500","31","26","5"
"1874","Harvard (MA)","9","7","0","0.56250","54","41","13"
"1875","Harvard (MA)","12","6","2","0.65000","52","29","23"
"1876","Harvard (MA)","13","8","1","0.61364","45","29","16"
"1877","Harvard (MA)","9","7","3","0.55263","31","21","10"
"1878","Pennsylvania","14","9","5","0.58929","42","24","18"
"1879","Harvard (MA)","13","9","12","0.55882","46","27","19"
"1880","Harvard (MA)","18","11","4","0.60606","75","53","22"
"1881","Rutgers (NJ)","22","18","8","0.54167","70","47","23"
"1882","Rutgers (NJ)","41","28","2","0.59155","176","111","65"
"1883","Rutgers (NJ)","38","32","1","0.54225","1288","965","323"
"1884","Pennsylvania","47","29","5","0.61111","1728","1184","544"
"1885","Michigan","34","17","4","0.65455","1437","612","825"
"1886","Lehigh (PA)","48","21","4","0.68493","1850","637","1213"
"1887","California","67","35","3","0.65238","2660","935","1725"
"1888","Princeton (NJ)","70","56","6","0.55303","2468","1899","569"
"1889","Brown (RI)","82","51","11","0.60764","2879","1796","1083"
"1890","Brown (RI)","77","76","9","0.50309","3002","2455","547"
"1891","Southern California","94","76","13","0.54918","2813","2189","624"
"1892","Minnesota","93","80","9","0.53571","2972","2394","578"
"1893","Duke (NC)","79","94","9","0.45879","2176","2912","-736"
"1894","Colorado St.","50","62","4","0.44828","1161","1518","-357"
"1895","Boston (MA)","31","44","11","0.42442","692","1031","-339"
"1896","Rhode Island","54","62","12","0.46875","1126","1201","-75"
"1897","Boston (MA)","32","40","6","0.44872","792","785","7"
"1898","Miami (OH)","47","23","4","0.66216","921","644","277"
"1899","New Hampshire","33","32","6","0.50704","571","522","49"
"1900","New Hampshire","22","35","11","0.40441","442","686","-244"
"1901","Marshall (WV)","18","34","3","0.35455","302","917","-615"
"1902","Saint John's (MN)","9","22","4","0.31429","148","460","-312"
"1903","Wichita St. (KS)","14","25","2","0.36585","376","546","-170"
"1904","Oklahoma St.","11","14","1","0.44231","194","394","-200"
"1905","Miami (OH)","7","25","5","0.25676","245","494","-249"
"1906","Rensselaer Tech (NY)","3","7","4","0.35714","92","107","-15"
"1907","Marshall (WV)","5","10","2","0.35294","71","238","-167"
"1908","Fort Hays St. (KS)","5","6","1","0.45833","56","91","-35"
"1909","Fort Hays St. (KS)","1","3","1","0.30000","12","68","-56"
"1910","Texas St.","0","1","0","0.00000","0","19","-19"
"1912","Fort Hays St. (KS)","1","2","0","0.33333","20","132","-112"
"1913","Eureka (IL)","1","6","0","0.14286","39","203","-164"
"1914","Eureka (IL)","3","4","0","0.42857","57","201","-144"
"1915","Texas St.","1","1","1","0.50000","13","20","-7"
"1916","Texas St.","0","2","1","0.16667","0","106","-106"
"1917","Boston (MA)","4","4","0","0.50000","73","136","-63"
"1918","Monmouth (IL)","1","7","0","0.12500","26","137","-111"
"1930","Troy (AL)","1","2","0","0.33333","7","73","-66"
"2013","Grambling St. (LA)","0","1","0","0.00000","0","0","0"
"1893","Pittsburgh (PA)","0","5","0","0.00000","14","78","-64"
"1895","Pittsburgh (PA)","1","6","0","0.14286","30","136","-106"
"1892","Penn St.","6","1","0","0.85714","164","20","144"
"1893","Penn St.","6","2","0","0.75000","110","52","58"
"1894","Penn St.","6","0","1","0.92857","179","18","161"
"1895","Penn St.","2","2","3","0.50000","92","60","32"
"1896","Pittsburgh (PA)","3","6","0","0.33333","42","69","-27"
"1899","Bucknell (PA)","6","4","1","0.59091","149","129","20"
"1900","Bucknell (PA)","3","5","1","0.38889","138","70","68"
"1901","Bucknell (PA)","6","4","0","0.60000","145","46","99"
"1902","Bucknell (PA)","6","4","0","0.60000","162","82","80"
"1903","Bucknell (PA)","4","5","0","0.44444","121","121","0"
"1904","Bucknell (PA)","3","3","0","0.50000","77","46","31"
"1905","Bucknell (PA)","5","5","0","0.50000","120","182","-62"
"1906","Bucknell (PA)","3","4","1","0.43750","37","88","-51"
"1909","Bucknell (PA)","3","4","2","0.44444","59","154","-95"
"1895","North Carolina","7","1","1","0.83333","146","17","129"
"1896","West Virginia","3","7","2","0.33333","14","101","-87"
"1897","Pittsburgh (PA)","1","3","0","0.25000","13","91","-78"
"1913","North Carolina","5","4","0","0.55556","91","76","15"
"1914","North Carolina","10","1","0","0.90909","359","52","307"
"1915","North Carolina","4","3","1","0.56250","105","98","7"
"1898","Pittsburgh (PA)","5","3","4","0.58333","85","57","28"
"1899","Pittsburgh (PA)","3","2","0","0.60000","43","23","20"
"1900","Pittsburgh (PA)","5","4","0","0.55556","110","33","77"
"1901","Pittsburgh (PA)","7","2","1","0.75000","96","47","49"
"1902","Pittsburgh (PA)","5","6","1","0.45833","128","129","-1"
"1904","Villanova (PA)","4","2","1","0.64286","101","66","35"
"1905","Villanova (PA)","3","7","0","0.30000","70","185","-115"
"1906","Villanova (PA)","3","7","0","0.30000","91","97","-6"
"1907","Villanova (PA)","3","5","1","0.38889","81","157","-76"
"1908","Villanova (PA)","2","6","0","0.25000","62","84","-22"
"1909","Villanova (PA)","3","2","0","0.60000","80","27","53"
"1910","Villanova (PA)","0","4","2","0.16667","6","70","-64"
"1911","Villanova (PA)","0","5","1","0.08333","6","94","-88"
"1899","Central Missouri St.","6","1","0","0.85714","130","28","102"
"1902","Central Missouri St.","6","3","0","0.66667","193","55","138"
"1903","Pittsburgh (PA)","0","9","1","0.05000","26","271","-245"
"1904","Pittsburgh (PA)","10","0","0","1.00000","406","5","401"
"1905","Pittsburgh (PA)","10","2","0","0.83333","405","36","369"
"1912","Kansas","4","4","0","0.50000","128","45","83"
"1913","Kansas","5","3","0","0.62500","120","40","80"
"1904","Butler (IN)","8","1","0","0.88889","223","70","153"
"1905","Butler (IN)","7","3","0","0.70000","300","66","234"
"1906","Pittsburgh (PA)","6","4","0","0.60000","229","55","174"
"1907","Louisiana St.","7","3","0","0.70000","266","52","214"
"1908","Louisiana St.","10","0","0","1.00000","442","11","431"
"1910","Maine","5","1","2","0.75000","71","18","53"
"1911","Maine","6","2","0","0.75000","89","8","81"
"1916","Susquehanna (PA)","4","5","0","0.44444","131","172","-41"
"1917","Susquehanna (PA)","1","0","0","1.00000","1","0","1"
"1918","Bucknell (PA)","6","0","0","1.00000","236","7","229"
"1919","Susquehanna (PA)","5","4","1","0.55000","311","76","235"
"1924","Susquehanna (PA)","3","5","0","0.37500","81","202","-121"
"1925","Susquehanna (PA)","1","6","2","0.22222","37","207","-170"
"1907","Pittsburgh (PA)","8","2","0","0.80000","147","27","120"
"1908","Pittsburgh (PA)","8","3","0","0.72727","140","36","104"
"1909","Pittsburgh (PA)","6","2","1","0.72222","94","26","68"
"1910","Pittsburgh (PA)","9","0","0","1.00000","282","0","282"
"1911","Pittsburgh (PA)","4","3","1","0.56250","72","29","43"
"1912","Pittsburgh (PA)","3","6","0","0.33333","113","118","-5"
"1913","Pittsburgh (PA)","6","2","1","0.72222","165","46","119"
"1914","Pittsburgh (PA)","8","1","0","0.88889","207","38","169"
"1895","Iowa St.","3","5","0","0.37500","108","56","52"
"1896","Georgia","4","0","0","1.00000","86","22","64"
"1897","Cornell (NY)","5","3","1","0.61111","133","42","91"
"1898","Cornell (NY)","10","2","0","0.83333","296","29","267"
"1899","Carlisle Indian School (PA)","9","2","0","0.81818","365","50","315"
"1900","Carlisle Indian School (PA)","6","4","1","0.59091","212","92","120"
"1901","Carlisle Indian School (PA)","5","7","1","0.42308","133","168","-35"
"1902","Carlisle Indian School (PA)","8","3","0","0.72727","251","51","200"
"1903","Carlisle Indian School (PA)","11","2","1","0.82143","274","52","222"
"1904","Cornell (NY)","7","3","0","0.70000","226","92","134"
"1905","Cornell (NY)","6","4","0","0.60000","173","59","114"
"1906","Cornell (NY)","8","1","2","0.81818","237","37","200"
"1907","Carlisle Indian School (PA)","10","1","0","0.90909","267","62","205"
"1908","Carlisle Indian School (PA)","10","2","1","0.80769","222","55","167"
"1909","Carlisle Indian School (PA)","8","3","1","0.70833","243","94","149"
"1910","Carlisle Indian School (PA)","8","6","0","0.57143","235","69","166"
"1911","Carlisle Indian School (PA)","11","1","0","0.91667","298","49","249"
"1912","Carlisle Indian School (PA)","12","1","1","0.89286","503","120","383"
"1913","Carlisle Indian School (PA)","10","1","1","0.87500","296","63","233"
"1914","Carlisle Indian School (PA)","5","9","1","0.36667","125","174","-49"
"1915","Pittsburgh (PA)","8","0","0","1.00000","247","19","228"
"1916","Pittsburgh (PA)","8","0","0","1.00000","255","25","230"
"1917","Pittsburgh (PA)","10","0","0","1.00000","260","21","239"
"1918","Pittsburgh (PA)","4","1","0","0.80000","140","16","124"
"1919","Pittsburgh (PA)","6","2","1","0.72222","119","66","53"
"1920","Pittsburgh (PA)","6","0","2","0.87500","146","44","102"
"1921","Pittsburgh (PA)","5","3","1","0.61111","133","51","82"
"1922","Pittsburgh (PA)","8","2","0","0.80000","190","43","147"
"1923","Pittsburgh (PA)","5","4","0","0.55556","83","39","44"
"1924","Stanford (CA)","7","1","1","0.83333","179","69","110"
"1925","Stanford (CA)","7","2","0","0.77778","231","71","160"
"1926","Stanford (CA)","10","0","1","0.95455","268","73","195"
"1927","Stanford (CA)","8","2","1","0.77273","162","82","80"
"1928","Stanford (CA)","8","3","1","0.70833","274","69","205"
"1929","Stanford (CA)","9","2","0","0.81818","288","53","235"
"1930","Stanford (CA)","9","1","1","0.86364","252","69","183"
"1931","Stanford (CA)","7","2","2","0.72727","160","44","116"
"1932","Stanford (CA)","6","4","1","0.59091","171","58","113"
"1933","Temple (PA)","5","3","0","0.62500","110","96","14"
"1934","Temple (PA)","7","1","2","0.80000","220","57","163"
"1935","Temple (PA)","7","3","0","0.70000","181","68","113"
"1936","Temple (PA)","6","3","2","0.63636","117","66","51"
"1937","Temple (PA)","3","2","4","0.55556","38","59","-21"
"1938","Temple (PA)","3","6","1","0.35000","97","170","-73"
"1919","Lafayette (PA)","6","2","0","0.75000","174","40","134"
"1920","Lafayette (PA)","5","3","0","0.62500","182","47","135"
"1921","Lafayette (PA)","9","0","0","1.00000","274","26","248"
"1922","Lafayette (PA)","7","2","0","0.77778","206","40","166"
"1923","Lafayette (PA)","6","1","2","0.77778","152","28","124"
"1924","Pittsburgh (PA)","5","3","1","0.61111","98","43","55"
"1925","Pittsburgh (PA)","8","1","0","0.88889","151","34","117"
"1926","Pittsburgh (PA)","5","2","2","0.66667","170","73","97"
"1927","Pittsburgh (PA)","8","1","1","0.85000","279","27","252"
"1928","Pittsburgh (PA)","6","2","1","0.72222","177","15","162"
"1929","Pittsburgh (PA)","9","1","0","0.90000","291","90","201"
"1930","Pittsburgh (PA)","6","2","1","0.72222","186","69","117"
"1931","Pittsburgh (PA)","8","1","0","0.88889","280","37","243"
"1932","Pittsburgh (PA)","8","1","2","0.81818","182","60","122"
"1933","Pittsburgh (PA)","8","1","0","0.88889","147","13","134"
"1934","Pittsburgh (PA)","8","1","0","0.88889","205","44","161"
"1935","Pittsburgh (PA)","7","1","2","0.80000","135","28","107"
"1936","Pittsburgh (PA)","8","1","1","0.85000","224","34","190"
"1937","Pittsburgh (PA)","9","0","1","0.95000","203","34","169"
"1938","Pittsburgh (PA)","8","2","0","0.80000","213","59","154"
"1939","Pittsburgh (PA)","5","4","0","0.55556","119","98","21"
"1940","Pittsburgh (PA)","3","4","1","0.43750","85","102","-17"
"1941","Pittsburgh (PA)","3","6","0","0.33333","82","171","-89"
"1942","Pittsburgh (PA)","3","6","0","0.33333","90","190","-100"
"1915","Tulane (LA)","4","4","0","0.50000","118","78","40"
"1916","Tulane (LA)","4","3","1","0.56250","126","149","-23"
"1917","Tulane (LA)","5","3","0","0.62500","159","105","54"
"1918","Tulane (LA)","4","1","1","0.75000","133","16","117"
"1919","Tulane (LA)","6","2","1","0.72222","224","55","169"
"1920","Tulane (LA)","6","2","1","0.72222","181","28","153"
"1922","Tulane (LA)","4","4","0","0.50000","136","100","36"
"1923","Tulane (LA)","6","3","1","0.65000","117","89","28"
"1924","Tulane (LA)","8","1","0","0.88889","201","59","142"
"1925","Tulane (LA)","9","0","1","0.95000","246","23","223"
"1926","Tulane (LA)","3","5","1","0.38889","71","60","11"
"1927","Loyola (LA)","6","2","2","0.70000","130","41","89"
"1928","Loyola (LA)","7","3","0","0.70000","220","85","135"
"1929","Loyola (LA)","4","5","2","0.45455","150","129","21"
"1930","Loyola (LA)","9","1","0","0.90000","217","52","165"
"1931","Loyola (LA)","5","4","0","0.55556","154","91","63"
"1932","Loyola (LA)","6","4","1","0.59091","134","77","57"
"1933","Chicago (IL)","3","3","2","0.50000","118","56","62"
"1934","Chicago (IL)","4","4","0","0.50000","113","106","7"
"1935","Chicago (IL)","4","4","0","0.50000","102","110","-8"
"1936","Chicago (IL)","2","5","1","0.31250","68","166","-98"
"1937","Chicago (IL)","1","6","0","0.14286","45","143","-98"
"1938","Chicago (IL)","1","6","1","0.18750","75","241","-166"
"1939","Chicago (IL)","2","6","0","0.25000","37","308","-271"
"1940","Stanford (CA)","10","0","0","1.00000","196","85","111"
"1941","Stanford (CA)","6","3","0","0.66667","160","95","65"
"1942","Maryland","7","2","0","0.77778","198","124","74"
"1943","Pittsburgh (PA)","3","5","0","0.37500","114","180","-66"
"1944","Pittsburgh (PA)","4","5","0","0.44444","147","293","-146"
"1945","Pittsburgh (PA)","3","7","0","0.30000","87","141","-54"
"1946","Maryland","3","6","0","0.33333","136","193","-57"
"1965","Hawaii","1","8","1","0.15000","85","227","-142"
"1946","Pittsburgh (PA)","3","5","1","0.38889","88","136","-48"
"1947","Ohio St.","2","6","1","0.27778","60","150","-90"
"1948","Ohio St.","6","3","0","0.66667","184","94","90"
"1949","Ohio St.","7","1","2","0.80000","207","136","71"
"1950","Ohio St.","6","3","0","0.66667","286","111","175"
"1951","Minnesota","2","6","1","0.27778","162","258","-96"
"1952","Minnesota","4","3","2","0.55556","131","171","-40"
"1953","Minnesota","4","4","1","0.50000","150","160","-10"
"1947","Pittsburgh (PA)","1","8","0","0.11111","26","267","-241"
"1948","Pittsburgh (PA)","6","3","0","0.66667","119","154","-35"
"1949","Pittsburgh (PA)","6","3","0","0.66667","156","154","2"
"1946","Santa Clara (CA)","2","5","1","0.31250","112","181","-69"
"1947","Santa Clara (CA)","4","4","0","0.50000","109","158","-49"
"1948","Santa Clara (CA)","7","2","1","0.75000","228","153","75"
"1949","Santa Clara (CA)","8","2","1","0.77273","222","114","108"
"1950","Pittsburgh (PA)","1","8","0","0.11111","99","204","-105"
"1951","Oregon","2","8","0","0.20000","130","317","-187"
"1952","Oregon","2","7","1","0.25000","112","234","-122"
"1953","Oregon","4","5","1","0.45000","91","85","6"
"1954","Oregon","6","4","0","0.60000","218","159","59"
"1955","Oregon","6","4","0","0.60000","204","158","46"
"1956","Oregon","4","4","2","0.50000","133","102","31"
"1957","Oregon","7","4","0","0.63636","160","97","63"
"1958","Oregon","4","6","0","0.40000","93","50","43"
"1959","Oregon","8","2","0","0.80000","209","113","96"
"1960","Oregon","7","3","1","0.68182","206","130","76"
"1961","Oregon","4","6","0","0.40000","152","112","40"
"1962","Oregon","6","3","1","0.65000","229","156","73"
"1963","Oregon","8","3","0","0.72727","274","153","121"
"1964","Oregon","7","2","1","0.75000","170","107","63"
"1965","Oregon","4","5","1","0.45000","165","186","-21"
"1966","Oregon","3","7","0","0.30000","118","129","-11"
"1934","Navy (MD)","8","1","0","0.88889","138","70","68"
"1935","Navy (MD)","5","4","0","0.55556","136","89","47"
"1936","Navy (MD)","6","3","0","0.66667","115","74","41"
"1946","Navy (MD)","1","8","0","0.11111","105","186","-81"
"1947","Navy (MD)","1","7","1","0.16667","86","165","-79"
"1951","Pittsburgh (PA)","3","7","0","0.30000","156","215","-59"
"1954","Pittsburgh (PA)","4","2","0","0.66667","69","82","-13"
"1936","Tulane (LA)","6","3","1","0.65000","163","117","46"
"1937","Tulane (LA)","5","4","1","0.55000","164","69","95"
"1938","Tulane (LA)","7","2","1","0.75000","211","53","158"
"1939","Tulane (LA)","8","1","1","0.85000","194","60","134"
"1940","Tulane (LA)","5","5","0","0.50000","144","126","18"
"1941","Tulane (LA)","5","4","0","0.55556","220","95","125"
"1952","Pittsburgh (PA)","6","3","0","0.66667","187","156","31"
"1953","Pittsburgh (PA)","3","5","1","0.38889","143","138","5"
"1954","Pittsburgh (PA)","0","3","0","0.00000","14","106","-92"
"1955","Pittsburgh (PA)","7","4","0","0.63636","181","122","59"
"1956","Pittsburgh (PA)","7","3","1","0.68182","156","119","37"
"1957","Pittsburgh (PA)","4","6","0","0.40000","134","157","-23"
"1958","Pittsburgh (PA)","5","4","1","0.55000","163","138","25"
"1959","Pittsburgh (PA)","6","4","0","0.60000","148","164","-16"
"1960","Pittsburgh (PA)","4","3","3","0.55000","134","77","57"
"1961","Pittsburgh (PA)","3","7","0","0.30000","145","209","-64"
"1962","Pittsburgh (PA)","5","5","0","0.50000","142","185","-43"
"1963","Pittsburgh (PA)","9","1","0","0.90000","236","130","106"
"1964","Pittsburgh (PA)","3","5","2","0.40000","152","154","-2"
"1965","Pittsburgh (PA)","3","7","0","0.30000","173","311","-138"
"1966","Pittsburgh (PA)","1","9","0","0.10000","105","326","-221"
"1967","Pittsburgh (PA)","1","9","0","0.10000","73","295","-222"
"1968","Pittsburgh (PA)","1","9","0","0.10000","99","393","-294"
"1969","Pittsburgh (PA)","4","6","0","0.40000","166","287","-121"
"1970","Pittsburgh (PA)","5","5","0","0.50000","179","245","-66"
"1971","Pittsburgh (PA)","3","8","0","0.27273","216","388","-172"
"1972","Pittsburgh (PA)","1","10","0","0.09091","193","350","-157"
"1968","Iowa St.","3","7","0","0.30000","178","263","-85"
"1969","Iowa St.","3","7","0","0.30000","152","231","-79"
"1970","Iowa St.","5","6","0","0.45455","248","284","-36"
"1971","Iowa St.","8","4","0","0.66667","337","250","87"
"1972","Iowa St.","5","6","1","0.45833","319","238","81"
"1973","Pittsburgh (PA)","6","5","1","0.54167","225","211","14"
"1974","Pittsburgh (PA)","7","4","0","0.63636","227","202","25"
"1975","Pittsburgh (PA)","8","4","0","0.66667","322","161","161"
"1976","Pittsburgh (PA)","12","0","0","1.00000","381","133","248"
"1977","Tennessee","4","7","0","0.36364","229","229","0"
"1978","Tennessee","5","5","1","0.50000","251","209","42"
"1979","Tennessee","7","5","0","0.58333","311","235","76"
"1980","Tennessee","5","6","0","0.45455","256","189","67"
"1981","Tennessee","8","4","0","0.66667","244","265","-21"
"1982","Tennessee","6","5","1","0.54167","281","239","42"
"1983","Tennessee","9","3","0","0.75000","282","165","117"
"1984","Tennessee","7","4","1","0.62500","327","276","51"
"1985","Tennessee","9","1","2","0.83333","325","140","185"
"1986","Tennessee","7","5","0","0.58333","293","249","44"
"1987","Tennessee","10","2","1","0.80769","422","246","176"
"1988","Tennessee","5","6","0","0.45455","212","286","-74"
"1989","Tennessee","11","1","0","0.91667","346","217","129"
"1990","Tennessee","9","2","2","0.76923","465","220","245"
"1991","Tennessee","9","3","0","0.75000","352","263","89"
"1992","Tennessee","5","3","0","0.62500","206","125","81"
"1993","Pittsburgh (PA)","3","8","0","0.27273","168","371","-203"
"1994","Pittsburgh (PA)","3","8","0","0.27273","246","307","-61"
"1995","Pittsburgh (PA)","2","9","0","0.18182","217","329","-112"
"1996","Pittsburgh (PA)","4","7","0","0.36364","214","430","-216"
"1976","Washington St.","3","8","0","0.27273","240","331","-91"
"1977","Pittsburgh (PA)","9","2","1","0.79167","428","134","294"
"1978","Pittsburgh (PA)","8","4","0","0.66667","263","187","76"
"1979","Pittsburgh (PA)","11","1","0","0.91667","291","116","175"
"1980","Pittsburgh (PA)","11","1","0","0.91667","380","130","250"
"1981","Pittsburgh (PA)","11","1","0","0.91667","385","160","225"
"1982","Texas A&M","5","6","0","0.45455","286","314","-28"
"1983","Texas A&M","5","5","1","0.50000","218","174","44"
"1984","Texas A&M","6","5","0","0.54545","245","217","28"
"1985","Texas A&M","10","2","0","0.83333","375","196","179"
"1986","Texas A&M","9","3","0","0.75000","372","215","157"
"1987","Texas A&M","10","2","0","0.83333","313","168","145"
"1988","Texas A&M","7","5","0","0.58333","293","253","40"
"1991","Mississippi St.","7","5","0","0.58333","291","194","97"
"1992","Mississippi St.","7","5","0","0.58333","252","197","55"
"1993","Mississippi St.","4","5","2","0.45455","241","245","-4"
"1994","Mississippi St.","8","4","0","0.66667","373","262","111"
"1995","Mississippi St.","3","8","0","0.27273","261","357","-96"
"1996","Mississippi St.","5","6","0","0.45455","249","229","20"
"1997","Mississippi St.","7","4","0","0.63636","226","215","11"
"1998","Mississippi St.","8","5","0","0.61538","350","256","94"
"1999","Mississippi St.","10","2","0","0.83333","255","156","99"
"2000","Mississippi St.","8","4","0","0.66667","390","306","84"
"2001","Mississippi St.","3","8","0","0.27273","196","288","-92"
"2002","Mississippi St.","3","9","0","0.25000","227","339","-112"
"2003","Mississippi St.","2","10","0","0.16667","225","471","-246"
"1982","Pittsburgh (PA)","9","3","0","0.75000","300","129","171"
"1983","Pittsburgh (PA)","8","3","1","0.70833","288","165","123"
"1984","Pittsburgh (PA)","3","7","1","0.31818","178","247","-69"
"1985","Pittsburgh (PA)","5","5","1","0.50000","202","187","15"
"1978","Murray St. (KY)","4","7","0","0.36364","236","237","-1"
"1979","Murray St. (KY)","9","2","1","0.79167","272","144","128"
"1980","Murray St. (KY)","9","2","0","0.81818","230","100","130"
"1981","Cincinnati (OH)","6","5","0","0.54545","171","187","-16"
"1982","Cincinnati (OH)","6","5","0","0.54545","276","206","70"
"1983","Kansas","4","6","1","0.40909","296","320","-24"
"1984","Kansas","5","6","0","0.45455","218","298","-80"
"1985","Kansas","6","6","0","0.50000","294","281","13"
"1986","Pittsburgh (PA)","6","4","1","0.59091","253","209","44"
"1987","Pittsburgh (PA)","8","4","0","0.66667","230","146","84"
"1988","Pittsburgh (PA)","6","5","0","0.54545","300","183","117"
"1989","Pittsburgh (PA)","7","3","1","0.68182","302","240","62"
"1989","Pittsburgh (PA)","1","0","0","1.00000","31","28","3"
"1990","Pittsburgh (PA)","3","7","1","0.31818","240","293","-53"
"1991","Pittsburgh (PA)","6","5","0","0.54545","244","241","3"
"1992","Pittsburgh (PA)","3","8","0","0.27273","266","393","-127"
"1998","Southern California","8","5","0","0.61538","346","241","105"
"1999","Southern California","7","5","0","0.58333","348","278","70"
"2000","Southern California","5","7","0","0.41667","309","337","-28"
"1992","Pittsburgh (PA)","0","1","0","0.00000","23","36","-13"
"1989","Pacific (CA)","2","10","0","0.16667","179","406","-227"
"1990","Pacific (CA)","4","7","0","0.36364","353","411","-58"
"1991","Pacific (CA)","5","7","0","0.41667","435","481","-46"
"1997","Pittsburgh (PA)","6","6","0","0.50000","333","354","-21"
"1998","Pittsburgh (PA)","2","9","0","0.18182","234","334","-100"
"1999","Pittsburgh (PA)","5","6","0","0.45455","281","278","3"
"2000","Pittsburgh (PA)","7","5","0","0.58333","296","247","49"
"2001","Pittsburgh (PA)","7","5","0","0.58333","296","245","51"
"2002","Pittsburgh (PA)","9","4","0","0.69231","331","232","99"
"2003","Pittsburgh (PA)","8","5","0","0.61538","389","311","78"
"2004","Pittsburgh (PA)","8","4","0","0.66667","325","288","37"
"2005","Stanford (CA)","5","6","0","0.45455","269","337","-68"
"2006","Stanford (CA)","1","11","0","0.08333","127","377","-250"
"2005","Pittsburgh (PA)","5","6","0","0.45455","267","243","24"
"2006","Pittsburgh (PA)","6","6","0","0.50000","381","274","107"
"2007","Pittsburgh (PA)","5","7","0","0.41667","274","291","-17"
"2008","Pittsburgh (PA)","9","4","0","0.69231","352","279","73"
"2009","Pittsburgh (PA)","10","3","0","0.76923","417","257","160"
"2010","Pittsburgh (PA)","7","5","0","0.58333","315","237","78"
"2002","Southern Methodist (TX)","3","9","0","0.25000","207","378","-171"
"2003","Southern Methodist (TX)","0","12","0","0.00000","134","386","-252"
"2004","Southern Methodist (TX)","3","8","0","0.27273","202","420","-218"
"2005","Southern Methodist (TX)","5","6","0","0.45455","229","280","-51"
"2006","Southern Methodist (TX)","6","6","0","0.50000","325","294","31"
"2007","Southern Methodist (TX)","1","11","0","0.08333","340","477","-137"
"2010","Pittsburgh (PA)","1","0","0","1.00000","27","10","17"
"2011","Pittsburgh (PA)","0","1","0","0.00000","6","28","-22"
"2006","Rice (TX)","7","6","0","0.53846","350","432","-82"
"2007","Tulsa (OK)","10","4","0","0.71429","576","467","109"
"2008","Tulsa (OK)","11","3","0","0.78571","661","391","270"
"2009","Tulsa (OK)","5","7","0","0.41667","351","328","23"
"2010","Tulsa (OK)","10","3","0","0.76923","538","394","144"
"2011","Pittsburgh (PA)","6","6","0","0.50000","309","269","40"
"2012","Arizona St.","8","5","0","0.61538","499","316","183"
"2013","Arizona St.","10","4","0","0.71429","556","373","183"
"2012","Pittsburgh (PA)","6","7","0","0.46154","346","274","72"
"2013","Pittsburgh (PA)","7","6","0","0.53846","342","353","-11"
"1887","Purdue (IN)","0","1","0","0.00000","6","48","-42"
"1889","Purdue (IN)","2","1","0","0.66667","52","28","24"
"1887","Butler (IN)","2","1","0","0.66667","104","24","80"
"1889","Butler (IN)","2","0","0","1.00000","46","0","46"
"1890","Purdue (IN)","6","3","1","0.65000","222","72","150"
"1891","DePauw (IN)","3","1","0","0.75000","95","54","41"
"1891","Purdue (IN)","4","0","0","1.00000","192","0","192"
"1892","Purdue (IN)","8","0","0","1.00000","318","22","296"
"1892","Auburn (AL)","1","0","0","1.00000","32","22","10"
"1893","Purdue (IN)","5","2","1","0.68750","334","144","190"
"1894","Purdue (IN)","9","1","0","0.90000","177","42","135"
"1895","Purdue (IN)","4","3","0","0.57143","77","58","19"
"1901","Purdue (IN)","4","4","1","0.50000","138","66","72"
"1896","Purdue (IN)","4","2","1","0.64286","122","60","62"
"1897","Lehigh (PA)","3","7","0","0.30000","84","261","-177"
"1897","Purdue (IN)","5","3","1","0.61111","106","108","-2"
"1899","Georgetown (DC)","5","2","1","0.68750","59","33","26"
"1901","Georgetown (DC)","3","3","2","0.50000","56","84","-28"
"1898","Purdue (IN)","3","3","0","0.50000","37","33","4"
"1899","Purdue (IN)","4","4","1","0.50000","100","122","-22"
"1900","Purdue (IN)","4","4","0","0.50000","172","79","93"
"1900","Drake (IA)","6","3","0","0.66667","129","45","84"
"1901","Drake (IA)","4","4","0","0.50000","112","34","78"
"1902","Purdue (IN)","7","2","1","0.75000","316","68","248"
"1917","Sewanee (TN)","4","2","2","0.62500","172","57","115"
"1918","Sewanee (TN)","3","2","0","0.60000","160","66","94"
"1903","Purdue (IN)","4","2","0","0.66667","87","48","39"
"1904","Purdue (IN)","9","3","0","0.75000","176","66","110"
"1905","Washington","5","2","2","0.66667","96","52","44"
"1905","Purdue (IN)","6","1","1","0.81250","177","30","147"
"1906","Purdue (IN)","0","5","0","0.00000","5","86","-81"
"1920","Colorado","4","1","2","0.71429","99","28","71"
"1921","Colorado","4","1","1","0.75000","65","63","2"
"1922","Colorado","4","4","0","0.50000","56","79","-23"
"1923","Colorado","9","0","0","1.00000","280","27","253"
"1924","Colorado","8","1","1","0.85000","237","13","224"
"1925","Colorado","6","3","0","0.66667","156","45","111"
"1926","Colorado","3","5","1","0.38889","77","103","-26"
"1927","Colorado","4","5","0","0.44444","136","195","-59"
"1928","Colorado","5","1","0","0.83333","110","57","53"
"1929","Colorado","5","1","1","0.78571","78","69","9"
"1930","Colorado","6","1","1","0.81250","120","68","52"
"1931","Colorado","5","3","0","0.62500","111","94","17"
"1904","Hamilton (NY)","5","3","0","0.62500","124","129","-5"
"1907","Purdue (IN)","0","5","0","0.00000","10","108","-98"
"1908","Purdue (IN)","4","3","0","0.57143","124","78","46"
"1909","Purdue (IN)","2","5","0","0.28571","72","147","-75"
"1909","Northwestern (IL)","1","3","1","0.30000","25","95","-70"
"1910","Purdue (IN)","1","5","0","0.16667","19","65","-46"
"1911","Purdue (IN)","3","4","0","0.42857","58","48","10"
"1912","Purdue (IN)","4","2","1","0.64286","176","70","106"
"1909","Pennsylvania","7","1","2","0.80000","146","38","108"
"1910","Pennsylvania","9","1","1","0.86364","184","19","165"
"1911","Pennsylvania","7","4","0","0.63636","131","83","48"
"1912","Pennsylvania","7","4","0","0.63636","191","106","85"
"1913","Purdue (IN)","4","1","2","0.71429","171","20","151"
"1914","Purdue (IN)","5","2","0","0.71429","157","63","94"
"1915","Purdue (IN)","3","3","1","0.50000","62","62","0"
"1916","California","6","4","1","0.59091","192","103","89"
"1917","California","5","5","1","0.50000","149","104","45"
"1918","California","7","2","0","0.77778","187","62","125"
"1919","California","6","2","1","0.72222","147","64","83"
"1920","California","9","0","0","1.00000","510","14","496"
"1921","California","9","0","1","0.95000","312","33","279"
"1922","California","9","0","0","1.00000","398","34","364"
"1923","California","9","0","1","0.95000","182","7","175"
"1924","California","8","0","2","0.90000","162","51","111"
"1925","California","6","3","0","0.66667","192","49","143"
"1916","Purdue (IN)","2","4","1","0.35714","67","99","-32"
"1917","Purdue (IN)","3","4","0","0.42857","95","109","-14"
"1919","Holy Cross (MA)","5","3","0","0.62500","174","42","132"
"1920","Holy Cross (MA)","5","3","0","0.62500","177","44","133"
"1921","Holy Cross (MA)","5","3","0","0.62500","153","44","109"
"1922","Holy Cross (MA)","7","2","1","0.75000","147","53","94"
"1923","Holy Cross (MA)","8","2","0","0.80000","272","29","243"
"1924","Holy Cross (MA)","7","1","1","0.83333","192","36","156"
"1925","Holy Cross (MA)","8","2","0","0.80000","209","63","146"
"1926","Holy Cross (MA)","7","1","2","0.80000","180","51","129"
"1927","Holy Cross (MA)","6","3","0","0.66667","125","42","83"
"1928","Holy Cross (MA)","5","3","2","0.60000","176","50","126"
"1929","Holy Cross (MA)","6","4","0","0.60000","147","73","74"
"1935","Saint Anselm (NH)","2","3","0","0.40000","57","60","-3"
"1936","Saint Anselm (NH)","6","0","1","0.92857","137","4","133"
"1937","Saint Anselm (NH)","5","2","0","0.71429","119","58","61"
"1938","Saint Anselm (NH)","6","0","1","0.92857","153","27","126"
"1939","Saint Anselm (NH)","4","2","0","0.66667","127","55","72"
"1940","Saint Anselm (NH)","5","4","0","0.55556","96","119","-23"
"1918","Purdue (IN)","3","3","0","0.50000","87","78","9"
"1919","Purdue (IN)","2","4","1","0.35714","71","104","-33"
"1920","Purdue (IN)","2","5","0","0.28571","36","103","-67"
"1915","Washington St.","7","0","0","1.00000","204","10","194"
"1916","Washington St.","4","2","0","0.66667","136","25","111"
"1917","Washington St.","6","0","1","0.92857","112","3","109"
"1921","Purdue (IN)","1","6","0","0.14286","9","95","-86"
"1922","Louisiana Tech","5","1","1","0.78571","290","26","264"
"1923","Louisiana Tech","6","2","0","0.75000","194","63","131"
"1924","Wyoming","2","6","0","0.25000","59","133","-74"
"1925","Wyoming","6","3","0","0.66667","147","83","64"
"1926","Wyoming","2","4","2","0.37500","152","91","61"
"1920","Missouri","7","1","0","0.87500","156","61","95"
"1921","Missouri","6","2","0","0.75000","136","50","86"
"1922","Purdue (IN)","1","5","1","0.21429","36","126","-90"
"1923","Purdue (IN)","2","5","1","0.31250","65","106","-41"
"1924","Purdue (IN)","5","2","0","0.71429","137","46","91"
"1925","Purdue (IN)","3","4","1","0.43750","119","39","80"
"1926","Purdue (IN)","5","2","1","0.68750","146","67","79"
"1927","Purdue (IN)","6","2","0","0.75000","170","38","132"
"1928","Purdue (IN)","5","2","1","0.68750","143","41","102"
"1929","Purdue (IN)","8","0","0","1.00000","187","44","143"
"1930","Washington","5","4","0","0.55556","182","67","115"
"1931","Washington","5","3","1","0.61111","166","83","83"
"1932","Washington","6","2","2","0.70000","193","56","137"
"1933","Washington","5","4","0","0.55556","88","81","7"
"1934","Washington","6","1","1","0.81250","104","51","53"
"1935","Washington","5","3","0","0.62500","93","42","51"
"1936","Washington","7","2","1","0.75000","148","56","92"
"1937","Washington","7","2","2","0.72727","187","52","135"
"1938","Washington","3","5","1","0.38889","68","83","-15"
"1939","Washington","4","5","0","0.44444","77","93","-16"
"1940","Washington","7","2","0","0.77778","169","54","115"
"1941","Washington","5","4","0","0.55556","120","94","26"
"1942","Saint Mary's (CA)","6","3","1","0.65000","135","46","89"
"1943","Saint Mary's (CA)","2","5","0","0.28571","93","126","-33"
"1944","Saint Mary's (CA)","0","5","0","0.00000","14","148","-134"
"1945","Saint Mary's (CA)","7","2","0","0.77778","282","65","217"
"1946","Saint Mary's (CA)","6","3","0","0.66667","229","160","69"
"1947","Saint Mary's (CA)","3","7","0","0.30000","178","246","-68"
"1930","Purdue (IN)","6","2","0","0.75000","150","41","109"
"1931","Purdue (IN)","9","1","0","0.90000","192","39","153"
"1932","Purdue (IN)","7","0","1","0.93750","164","42","122"
"1933","Purdue (IN)","6","1","1","0.81250","109","37","72"
"1934","Purdue (IN)","5","3","0","0.62500","93","75","18"
"1935","Purdue (IN)","4","4","0","0.50000","65","57","8"
"1936","Purdue (IN)","5","2","1","0.68750","157","95","62"
"1937","Purdue (IN)","4","3","1","0.56250","83","69","14"
"1938","Purdue (IN)","5","1","2","0.75000","84","38","46"
"1939","Purdue (IN)","3","3","2","0.50000","56","53","3"
"1940","Purdue (IN)","2","6","0","0.25000","96","106","-10"
"1941","Purdue (IN)","2","5","1","0.31250","27","62","-35"
"1942","Purdue (IN)","1","8","0","0.11111","27","179","-152"
"1943","Purdue (IN)","9","0","0","1.00000","214","55","159"
"1944","Purdue (IN)","5","5","0","0.50000","207","166","41"
"1945","Purdue (IN)","7","3","0","0.70000","198","125","73"
"1946","Purdue (IN)","2","6","1","0.27778","97","208","-111"
"1942","Miami (OH)","3","6","0","0.33333","154","195","-41"
"1943","Miami (OH)","7","2","1","0.75000","293","91","202"
"1947","Purdue (IN)","5","4","0","0.55556","205","130","75"
"1948","Purdue (IN)","3","6","0","0.33333","126","175","-49"
"1949","Purdue (IN)","4","5","0","0.44444","119","135","-16"
"1950","Purdue (IN)","2","7","0","0.22222","143","200","-57"
"1951","Purdue (IN)","5","4","0","0.55556","153","152","1"
"1952","Purdue (IN)","4","3","2","0.55556","188","151","37"
"1953","Purdue (IN)","2","7","0","0.22222","89","167","-78"
"1954","Purdue (IN)","5","3","1","0.61111","165","134","31"
"1955","Purdue (IN)","5","3","1","0.61111","113","103","10"
"1956","Purdue (IN)","3","4","2","0.44444","139","122","17"
"1957","Purdue (IN)","5","4","0","0.55556","178","114","64"
"1958","Purdue (IN)","6","1","2","0.77778","184","102","82"
"1959","Purdue (IN)","5","2","2","0.66667","109","81","28"
"1960","Purdue (IN)","4","4","1","0.50000","212","163","49"
"1961","Purdue (IN)","6","3","0","0.66667","146","87","59"
"1962","Purdue (IN)","4","4","1","0.50000","141","68","73"
"1963","Purdue (IN)","5","4","0","0.55556","119","149","-30"
"1964","Purdue (IN)","6","3","0","0.66667","168","146","22"
"1965","Purdue (IN)","7","2","1","0.75000","227","127","100"
"1966","Purdue (IN)","9","2","0","0.81818","297","154","143"
"1967","Purdue (IN)","8","2","0","0.80000","291","154","137"
"1968","Purdue (IN)","8","2","0","0.80000","291","167","124"
"1969","Purdue (IN)","8","2","0","0.80000","354","264","90"
"1970","Purdue (IN)","4","6","0","0.40000","161","189","-28"
"1971","Purdue (IN)","3","7","0","0.30000","210","228","-18"
"1972","Purdue (IN)","6","5","0","0.54545","245","135","110"
"1964","Northwestern (IL)","3","6","0","0.33333","95","164","-69"
"1965","Northwestern (IL)","4","6","0","0.40000","141","208","-67"
"1966","Northwestern (IL)","3","6","1","0.35000","137","213","-76"
"1967","Northwestern (IL)","3","7","0","0.30000","149","213","-64"
"1968","Northwestern (IL)","1","9","0","0.10000","109","325","-216"
"1969","Northwestern (IL)","3","7","0","0.30000","137","306","-169"
"1970","Northwestern (IL)","6","4","0","0.60000","233","161","72"
"1971","Northwestern (IL)","7","4","0","0.63636","211","183","28"
"1972","Northwestern (IL)","2","9","0","0.18182","146","290","-144"
"1973","Purdue (IN)","5","6","0","0.45455","200","213","-13"
"1974","Purdue (IN)","4","6","1","0.40909","223","261","-38"
"1975","Purdue (IN)","4","7","0","0.36364","128","220","-92"
"1976","Purdue (IN)","5","6","0","0.45455","188","233","-45"
"1973","Arizona","8","3","0","0.72727","286","213","73"
"1974","Arizona","9","2","0","0.81818","263","174","89"
"1975","Arizona","9","2","0","0.81818","330","169","161"
"1976","Arizona","5","6","0","0.45455","283","273","10"
"1977","Purdue (IN)","5","6","0","0.45455","231","247","-16"
"1978","Purdue (IN)","9","2","1","0.79167","261","130","131"
"1979","Purdue (IN)","10","2","0","0.83333","287","226","61"
"1980","Purdue (IN)","9","3","0","0.75000","328","233","95"
"1981","Purdue (IN)","5","6","0","0.45455","242","241","1"
"1983","Army (NY)","2","9","0","0.18182","140","304","-164"
"1984","Army (NY)","8","3","1","0.70833","320","218","102"
"1985","Army (NY)","9","3","0","0.75000","396","232","164"
"1986","Army (NY)","6","5","0","0.54545","276","292","-16"
"1987","Army (NY)","5","6","0","0.45455","277","223","54"
"1988","Army (NY)","9","3","0","0.75000","336","226","110"
"1989","Army (NY)","6","5","0","0.54545","316","212","104"
"1990","Army (NY)","6","5","0","0.54545","295","264","31"
"1982","Purdue (IN)","3","8","0","0.27273","211","324","-113"
"1983","Purdue (IN)","3","7","1","0.31818","251","366","-115"
"1984","Purdue (IN)","7","5","0","0.58333","286","283","3"
"1985","Purdue (IN)","5","6","0","0.45455","287","306","-19"
"1986","Purdue (IN)","3","8","0","0.27273","160","335","-175"
"1975","Wyoming","2","9","0","0.18182","174","219","-45"
"1976","Wyoming","8","4","0","0.66667","278","250","28"
"1977","Texas","11","1","0","0.91667","441","152","289"
"1978","Texas","9","3","0","0.75000","287","136","151"
"1979","Texas","9","3","0","0.75000","221","104","117"
"1980","Texas","7","5","0","0.58333","267","214","53"
"1981","Texas","10","1","1","0.87500","262","158","104"
"1982","Texas","9","3","0","0.75000","357","170","187"
"1983","Texas","11","1","0","0.91667","289","114","175"
"1984","Texas","7","4","1","0.62500","264","261","3"
"1985","Texas","8","4","0","0.66667","270","259","11"
"1986","Texas","5","6","0","0.45455","229","245","-16"
"1987","Purdue (IN)","3","7","1","0.31818","197","285","-88"
"1988","Purdue (IN)","4","7","0","0.36364","124","303","-179"
"1989","Purdue (IN)","3","8","0","0.27273","172","281","-109"
"1990","Purdue (IN)","2","9","0","0.18182","177","337","-160"
"1975","Cal St.-Fullerton","2","9","0","0.18182","138","385","-247"
"1976","Cal St.-Fullerton","3","7","1","0.31818","184","213","-29"
"1977","Cal St.-Fullerton","4","7","0","0.36364","285","290","-5"
"1978","Cal St.-Fullerton","5","7","0","0.41667","298","330","-32"
"1979","Cal St.-Fullerton","3","8","0","0.27273","193","237","-44"
"1991","Purdue (IN)","4","7","0","0.36364","219","272","-53"
"1992","Purdue (IN)","4","7","0","0.36364","211","267","-56"
"1993","Purdue (IN)","1","10","0","0.09091","221","326","-105"
"1994","Purdue (IN)","5","4","2","0.54545","336","346","-10"
"1995","Purdue (IN)","4","6","1","0.40909","282","269","13"
"1996","Purdue (IN)","3","8","0","0.27273","194","324","-130"
"1991","Wyoming","4","6","1","0.40909","305","357","-52"
"1992","Wyoming","5","7","0","0.41667","302","341","-39"
"1993","Wyoming","8","4","0","0.66667","357","329","28"
"1994","Wyoming","6","6","0","0.50000","319","341","-22"
"1995","Wyoming","6","5","0","0.54545","322","264","58"
"1996","Wyoming","10","2","0","0.83333","464","284","180"
"1997","Purdue (IN)","9","3","0","0.75000","396","267","129"
"1998","Purdue (IN)","9","4","0","0.69231","444","276","168"
"1999","Purdue (IN)","7","5","0","0.58333","384","305","79"
"2000","Purdue (IN)","8","4","0","0.66667","381","266","115"
"2001","Purdue (IN)","6","6","0","0.50000","250","278","-28"
"2002","Purdue (IN)","7","6","0","0.53846","386","288","98"
"2003","Purdue (IN)","9","4","0","0.69231","349","226","123"
"2004","Purdue (IN)","7","5","0","0.58333","381","206","175"
"2005","Purdue (IN)","5","6","0","0.45455","330","309","21"
"2006","Purdue (IN)","8","6","0","0.57143","364","374","-10"
"2007","Purdue (IN)","8","5","0","0.61538","446","345","101"
"2008","Purdue (IN)","4","8","0","0.33333","296","301","-5"
"2003","Eastern Kentucky","7","5","0","0.58333","347","352","-5"
"2004","Eastern Kentucky","6","5","0","0.54545","290","239","51"
"2005","Eastern Kentucky","7","4","0","0.63636","346","233","113"
"2006","Eastern Kentucky","6","5","0","0.54545","238","240","-2"
"2007","Eastern Kentucky","9","3","0","0.75000","382","286","96"
"2009","Purdue (IN)","5","7","0","0.41667","334","349","-15"
"2010","Purdue (IN)","4","8","0","0.33333","236","345","-109"
"2011","Purdue (IN)","7","6","0","0.53846","350","349","1"
"2012","Purdue (IN)","6","6","0","0.50000","359","348","11"
"2012","Purdue (IN)","0","1","0","0.00000","14","58","-44"
"2011","Kent St. (OH)","5","7","0","0.41667","205","291","-86"
"2012","Kent St. (OH)","11","3","0","0.78571","463","343","120"
"2013","Purdue (IN)","1","11","0","0.08333","179","456","-277"
"1908","Southwestern (TX)","3","2","0","0.60000","51","60","-9"
"1909","Southwestern (TX)","1","4","2","0.28571","35","51","-16"
"1910","Southwestern (TX)","2","4","1","0.35714","79","75","4"
"1911","Southwestern (TX)","2","3","2","0.42857","45","47","-2"
"1912","Rice (TX)","3","2","0","0.60000","40","125","-85"
"1913","Rice (TX)","4","0","0","1.00000","81","14","67"
"1914","Rice (TX)","3","2","3","0.56250","59","113","-54"
"1915","Rice (TX)","5","3","0","0.62500","122","143","-21"
"1916","Rice (TX)","6","1","2","0.77778","346","62","284"
"1917","Rice (TX)","8","1","0","0.88889","249","55","194"
"1919","Rice (TX)","8","1","0","0.88889","190","60","130"
"1920","Rice (TX)","4","2","2","0.62500","105","28","77"
"1921","Rice (TX)","4","4","1","0.50000","144","128","16"
"1922","Rice (TX)","4","4","0","0.50000","96","128","-32"
"1923","Rice (TX)","3","5","0","0.37500","35","94","-59"
"1924","Louisiana Tech","1","6","1","0.18750","42","139","-97"
"1918","Rice (TX)","1","6","1","0.18750","13","68","-55"
"1893","Akron (OH)","5","2","0","0.71429","276","82","194"
"1894","Akron (OH)","1","0","0","1.00000","12","6","6"
"1895","Auburn (AL)","2","1","0","0.66667","70","15","55"
"1896","Auburn (AL)","3","1","0","0.75000","135","18","117"
"1897","Auburn (AL)","2","0","1","0.83333","40","4","36"
"1898","Auburn (AL)","2","1","0","0.66667","47","47","0"
"1899","Auburn (AL)","3","1","1","0.70000","148","11","137"
"1900","Clemson (SC)","6","0","0","1.00000","222","10","212"
"1901","Clemson (SC)","3","1","1","0.70000","190","38","152"
"1902","Clemson (SC)","6","1","0","0.85714","152","22","130"
"1903","Clemson (SC)","4","1","1","0.75000","167","22","145"
"1904","Georgia Tech","8","1","1","0.85000","287","34","253"
"1905","Georgia Tech","7","0","1","0.93750","233","33","200"
"1906","Georgia Tech","6","3","1","0.65000","140","69","71"
"1907","Georgia Tech","4","4","0","0.50000","148","100","48"
"1908","Georgia Tech","6","3","0","0.66667","147","74","73"
"1909","Georgia Tech","7","2","0","0.77778","217","44","173"
"1910","Georgia Tech","5","3","0","0.62500","197","50","147"
"1911","Georgia Tech","6","2","1","0.72222","150","21","129"
"1912","Georgia Tech","5","3","1","0.61111","100","86","14"
"1913","Georgia Tech","7","2","0","0.77778","250","43","207"
"1914","Georgia Tech","6","2","0","0.75000","206","40","166"
"1915","Georgia Tech","7","0","1","0.93750","233","24","209"
"1916","Georgia Tech","8","0","1","0.94444","421","20","401"
"1917","Georgia Tech","9","0","0","1.00000","491","17","474"
"1918","Georgia Tech","6","1","0","0.85714","466","32","434"
"1919","Georgia Tech","7","3","0","0.70000","256","33","223"
"1920","Pennsylvania","6","4","0","0.60000","167","133","34"
"1921","Pennsylvania","4","3","2","0.55556","164","135","29"
"1922","Pennsylvania","6","3","0","0.66667","100","44","56"
"1924","Rice (TX)","4","4","0","0.50000","85","70","15"
"1925","Rice (TX)","4","4","1","0.50000","85","79","6"
"1926","Rice (TX)","4","4","1","0.50000","84","81","3"
"1927","Rice (TX)","2","6","1","0.27778","64","160","-96"
"1906","Colorado St.","1","2","1","0.37500","4","21","-17"
"1907","Colorado St.","0","4","0","0.00000","17","77","-60"
"1908","Colorado St.","1","3","0","0.25000","30","58","-28"
"1909","Colorado St.","1","2","0","0.33333","38","91","-53"
"1928","Rice (TX)","2","7","0","0.22222","83","174","-91"
"1929","Rice (TX)","2","7","0","0.22222","34","208","-174"
"1930","Rice (TX)","8","4","0","0.66667","135","91","44"
"1931","Rice (TX)","6","4","0","0.60000","178","66","112"
"1932","Rice (TX)","7","3","0","0.70000","141","77","64"
"1933","Rice (TX)","3","8","0","0.27273","56","137","-81"
"1934","Auburn (AL)","2","8","0","0.20000","58","107","-49"
"1935","Auburn (AL)","8","2","0","0.80000","201","46","155"
"1936","Auburn (AL)","7","2","2","0.72727","160","63","97"
"1937","Auburn (AL)","6","2","3","0.68182","127","36","91"
"1938","Auburn (AL)","4","5","1","0.45000","110","88","22"
"1939","Auburn (AL)","5","5","1","0.50000","71","69","2"
"1940","Auburn (AL)","6","4","1","0.59091","170","153","17"
"1941","Auburn (AL)","4","5","1","0.45000","123","115","8"
"1942","Auburn (AL)","6","4","1","0.59091","174","133","41"
"1934","Rice (TX)","9","1","1","0.86364","204","44","160"
"1935","Rice (TX)","8","3","0","0.72727","201","95","106"
"1936","Rice (TX)","5","7","0","0.41667","127","108","19"
"1937","Rice (TX)","6","3","2","0.63636","117","94","23"
"1938","Rice (TX)","4","6","0","0.40000","91","133","-42"
"1939","Rice (TX)","1","9","1","0.13636","77","143","-66"
"1941","Virginia Tech","6","4","0","0.60000","112","120","-8"
"1946","Virginia Tech","3","4","3","0.45000","102","149","-47"
"1947","Virginia Tech","4","5","0","0.44444","162","191","-29"
"1931","Clemson (SC)","1","6","2","0.22222","19","164","-145"
"1932","Clemson (SC)","3","5","1","0.38889","89","111","-22"
"1933","Clemson (SC)","3","6","2","0.36364","50","98","-48"
"1934","Clemson (SC)","5","4","0","0.55556","89","85","4"
"1935","Clemson (SC)","6","3","0","0.66667","147","99","48"
"1936","Clemson (SC)","5","5","0","0.50000","98","95","3"
"1937","Clemson (SC)","4","4","1","0.50000","128","64","64"
"1938","Clemson (SC)","7","1","1","0.83333","145","56","89"
"1939","Clemson (SC)","9","1","0","0.90000","165","45","120"
"1940","Rice (TX)","7","3","0","0.70000","131","78","53"
"1941","Rice (TX)","6","3","1","0.65000","167","121","46"
"1942","Rice (TX)","7","2","1","0.75000","177","74","103"
"1943","Rice (TX)","3","7","0","0.30000","60","183","-123"
"1944","Rice (TX)","5","6","0","0.45455","143","163","-20"
"1945","Rice (TX)","5","6","0","0.45455","130","153","-23"
"1946","Rice (TX)","9","2","0","0.81818","245","62","183"
"1947","Rice (TX)","6","3","1","0.65000","202","74","128"
"1948","Rice (TX)","5","4","1","0.55000","168","119","49"
"1949","Rice (TX)","10","1","0","0.90909","276","97","179"
"1950","Rice (TX)","6","4","0","0.60000","168","196","-28"
"1951","Rice (TX)","5","5","0","0.50000","149","144","5"
"1952","Rice (TX)","5","5","0","0.50000","152","175","-23"
"1953","Rice (TX)","9","2","0","0.81818","295","105","190"
"1954","Rice (TX)","7","3","0","0.70000","205","148","57"
"1955","Rice (TX)","2","7","1","0.25000","110","179","-69"
"1956","Rice (TX)","4","6","0","0.40000","160","169","-9"
"1957","Rice (TX)","7","4","0","0.63636","175","121","54"
"1958","Rice (TX)","5","5","0","0.50000","178","156","22"
"1959","Rice (TX)","1","7","2","0.20000","86","197","-111"
"1960","Rice (TX)","7","4","0","0.63636","174","72","102"
"1961","Rice (TX)","7","4","0","0.63636","183","158","25"
"1962","Rice (TX)","2","6","2","0.30000","119","173","-54"
"1963","Rice (TX)","6","4","0","0.60000","145","114","31"
"1964","Rice (TX)","4","5","1","0.45000","117","111","6"
"1965","Rice (TX)","2","8","0","0.20000","123","248","-125"
"1966","Rice (TX)","2","8","0","0.20000","154","211","-57"
"1967","Rice (TX)","4","6","0","0.40000","164","175","-11"
"1968","Rice (TX)","0","9","1","0.05000","151","326","-175"
"1969","Rice (TX)","3","7","0","0.30000","168","225","-57"
"1970","Rice (TX)","5","5","0","0.50000","168","175","-7"
"1960","Florida St.","3","6","1","0.35000","111","136","-25"
"1961","Florida St.","4","5","1","0.45000","93","128","-35"
"1962","Florida St.","4","3","3","0.55000","170","69","101"
"1963","Florida St.","4","5","1","0.45000","167","93","74"
"1964","Florida St.","9","1","1","0.86364","263","85","178"
"1965","Florida St.","4","5","1","0.45000","121","119","2"
"1966","Florida St.","6","5","0","0.54545","274","215","59"
"1967","Florida St.","7","2","2","0.72727","250","187","63"
"1968","Florida St.","8","3","0","0.72727","308","211","97"
"1969","Florida St.","6","3","1","0.65000","220","182","38"
"1970","Florida St.","7","4","0","0.63636","254","195","59"
"1971","Rice (TX)","3","7","1","0.31818","146","220","-74"
"1972","Rice (TX)","5","5","1","0.50000","196","238","-42"
"1973","Rice (TX)","5","6","0","0.45455","153","223","-70"
"1974","Rice (TX)","2","8","1","0.22727","117","222","-105"
"1975","Rice (TX)","3","8","0","0.27273","176","252","-76"
"1967","Cincinnati (OH)","3","6","0","0.33333","111","189","-78"
"1968","Cincinnati (OH)","5","4","1","0.55000","300","327","-27"
"1976","Rice (TX)","3","8","0","0.27273","236","417","-181"
"1977","Rice (TX)","1","10","0","0.09091","151","458","-307"
"1978","Rice (TX)","2","9","0","0.18182","159","408","-249"
"1979","Rice (TX)","1","10","0","0.09091","121","418","-297"
"1980","Rice (TX)","5","6","0","0.45455","175","215","-40"
"1981","Rice (TX)","4","7","0","0.36364","183","347","-164"
"1982","Rice (TX)","0","11","0","0.00000","138","361","-223"
"1983","Rice (TX)","1","10","0","0.09091","105","333","-228"
"1986","Lamar (TX)","2","9","0","0.18182","194","339","-145"
"1987","Lamar (TX)","3","8","0","0.27273","283","386","-103"
"1988","Lamar (TX)","3","8","0","0.27273","227","254","-27"
"1989","Lamar (TX)","5","5","0","0.50000","281","262","19"
"1979","Austin Peay St. (TN)","7","4","0","0.63636","198","150","48"
"1980","Austin Peay St. (TN)","7","4","0","0.63636","217","148","69"
"1983","Cincinnati (OH)","4","6","1","0.40909","208","234","-26"
"1984","Rice (TX)","1","10","0","0.09091","213","382","-169"
"1985","Rice (TX)","3","8","0","0.27273","233","404","-171"
"1986","Vanderbilt (TN)","1","10","0","0.09091","193","347","-154"
"1987","Vanderbilt (TN)","4","7","0","0.36364","286","355","-69"
"1988","Vanderbilt (TN)","3","8","0","0.27273","202","277","-75"
"1989","Vanderbilt (TN)","1","10","0","0.09091","162","265","-103"
"1990","Vanderbilt (TN)","1","10","0","0.09091","227","457","-230"
"1995","Alabama-Birmingham","5","6","0","0.45455","273","261","12"
"1996","Alabama-Birmingham","5","6","0","0.45455","266","279","-13"
"1997","Alabama-Birmingham","5","6","0","0.45455","222","238","-16"
"1998","Alabama-Birmingham","4","7","0","0.36364","237","308","-71"
"1999","Alabama-Birmingham","5","6","0","0.45455","248","279","-31"
"2000","Alabama-Birmingham","7","4","0","0.63636","238","192","46"
"2001","Alabama-Birmingham","6","5","0","0.54545","265","206","59"
"2002","Alabama-Birmingham","5","7","0","0.41667","268","370","-102"
"2003","Alabama-Birmingham","5","7","0","0.41667","245","287","-42"
"2004","Alabama-Birmingham","7","5","0","0.58333","372","351","21"
"2005","Alabama-Birmingham","5","6","0","0.45455","307","264","43"
"2006","Alabama-Birmingham","3","9","0","0.25000","225","297","-72"
"2007","Tennessee Tech","4","7","0","0.36364","329","352","-23"
"2008","Tennessee Tech","3","9","0","0.25000","240","420","-180"
"2009","Tennessee Tech","6","5","0","0.54545","267","286","-19"
"2010","Tennessee Tech","5","6","0","0.45455","264","317","-53"
"2011","Tennessee Tech","7","4","0","0.63636","355","279","76"
"2012","Tennessee Tech","3","8","0","0.27273","347","433","-86"
"2013","Tennessee Tech","5","7","0","0.41667","313","353","-40"
"1979","DePauw (IN)","2","7","0","0.22222","64","171","-107"
"1980","DePauw (IN)","7","2","1","0.75000","235","159","76"
"1981","Pennsylvania","1","9","0","0.10000","133","324","-191"
"1982","Pennsylvania","7","3","0","0.70000","221","192","29"
"1983","Pennsylvania","6","3","1","0.65000","225","204","21"
"1984","Pennsylvania","8","1","0","0.88889","286","152","134"
"1985","Pennsylvania","7","2","1","0.75000","197","161","36"
"1986","Rice (TX)","4","7","0","0.36364","185","330","-145"
"1987","Rice (TX)","2","9","0","0.18182","237","427","-190"
"1988","Rice (TX)","0","11","0","0.00000","165","358","-193"
"1989","Temple (PA)","1","10","0","0.09091","141","387","-246"
"1990","Temple (PA)","7","4","0","0.63636","261","269","-8"
"1991","Temple (PA)","2","9","0","0.18182","145","290","-145"
"1992","Temple (PA)","1","10","0","0.09091","132","383","-251"
"1989","Rice (TX)","2","8","1","0.22727","175","313","-138"
"1990","Rice (TX)","5","6","0","0.45455","256","258","-2"
"1991","Rice (TX)","4","7","0","0.36364","239","287","-48"
"1992","Rice (TX)","6","5","0","0.54545","294","261","33"
"1993","Rice (TX)","6","5","0","0.54545","284","294","-10"
"1994","Duke (NC)","8","4","0","0.66667","380","281","99"
"1995","Duke (NC)","3","8","0","0.27273","282","386","-104"
"1996","Duke (NC)","0","11","0","0.00000","162","379","-217"
"1997","Duke (NC)","2","9","0","0.18182","223","341","-118"
"1998","Duke (NC)","4","7","0","0.36364","229","319","-90"
"2007","Lenoir-Rhyne (NC)","2","9","0","0.18182","156","348","-192"
"2008","Lenoir-Rhyne (NC)","3","8","0","0.27273","276","352","-76"
"2009","Lenoir-Rhyne (NC)","5","6","0","0.45455","293","241","52"
"2010","Lenoir-Rhyne (NC)","7","4","0","0.63636","358","223","135"
"1979","Air Force (CO)","2","9","0","0.18182","127","253","-126"
"1980","Air Force (CO)","2","9","1","0.20833","161","290","-129"
"1981","Air Force (CO)","4","7","0","0.36364","171","252","-81"
"1982","Air Force (CO)","8","5","0","0.61538","395","367","28"
"1983","Air Force (CO)","10","2","0","0.83333","367","221","146"
"1984","Arkansas","7","4","1","0.62500","268","159","109"
"1985","Arkansas","10","2","0","0.83333","323","146","177"
"1986","Arkansas","9","3","0","0.75000","311","184","127"
"1987","Arkansas","9","4","0","0.69231","300","219","81"
"1988","Arkansas","10","2","0","0.83333","349","190","159"
"1989","Arkansas","10","2","0","0.83333","385","230","155"
"1990","Clemson (SC)","10","2","0","0.83333","333","109","224"
"1991","Clemson (SC)","9","2","1","0.79167","317","185","132"
"1992","Clemson (SC)","5","6","0","0.45455","261","213","48"
"1993","Clemson (SC)","8","3","0","0.72727","184","179","5"
"1994","Rice (TX)","5","6","0","0.45455","206","203","3"
"1995","Rice (TX)","2","8","1","0.22727","215","284","-69"
"1996","Rice (TX)","7","4","0","0.63636","296","312","-16"
"1997","Rice (TX)","7","4","0","0.63636","306","285","21"
"1998","Rice (TX)","5","6","0","0.45455","235","257","-22"
"1999","Rice (TX)","5","6","0","0.45455","237","261","-24"
"2000","Rice (TX)","3","8","0","0.27273","237","322","-85"
"2001","Rice (TX)","8","4","0","0.66667","333","335","-2"
"2002","Rice (TX)","4","7","0","0.36364","253","296","-43"
"2003","Rice (TX)","5","7","0","0.41667","343","378","-35"
"2004","Rice (TX)","3","8","0","0.27273","279","377","-98"
"2005","Rice (TX)","1","10","0","0.09091","241","447","-206"
"2006","Rice (TX)","7","6","0","0.53846","350","432","-82"
"2007","Tulsa (OK)","10","4","0","0.71429","576","467","109"
"2008","Tulsa (OK)","11","3","0","0.78571","661","391","270"
"2009","Tulsa (OK)","5","7","0","0.41667","351","328","23"
"2010","Tulsa (OK)","10","3","0","0.76923","538","394","144"
"2011","Pittsburgh (PA)","6","6","0","0.50000","309","269","40"
"2012","Arizona St.","8","5","0","0.61538","499","316","183"
"2013","Arizona St.","10","4","0","0.71429","556","373","183"
"2004","Texas St.","5","6","0","0.45455","283","285","-2"
"2005","Texas St.","11","3","0","0.78571","518","284","234"
"2006","Texas St.","5","6","0","0.45455","244","248","-4"
"2007","Rice (TX)","3","9","0","0.25000","377","515","-138"
"2008","Rice (TX)","10","3","0","0.76923","537","433","104"
"2009","Rice (TX)","2","10","0","0.16667","219","517","-298"
"2010","Rice (TX)","4","8","0","0.33333","344","462","-118"
"2011","Rice (TX)","4","8","0","0.33333","280","400","-120"
"2012","Rice (TX)","7","6","0","0.53846","414","390","24"
"2013","Rice (TX)","10","4","0","0.71429","415","342","73"
"1869","Rutgers (NJ)","2","2","0","0.50000","18","18","0"
"1870","Rutgers (NJ)","2","2","0","0.50000","17","17","0"
"1872","Columbia (NY)","5","4","0","0.55556","22","16","6"
"1873","Rutgers (NJ)","7","4","1","0.62500","31","26","5"
"1874","Harvard (MA)","9","7","0","0.56250","54","41","13"
"1875","Harvard (MA)","12","6","2","0.65000","52","29","23"
"1876","Harvard (MA)","13","8","1","0.61364","45","29","16"
"1877","Harvard (MA)","9","7","3","0.55263","31","21","10"
"1878","Pennsylvania","14","9","5","0.58929","42","24","18"
"1879","Harvard (MA)","13","9","12","0.55882","46","27","19"
"1880","Harvard (MA)","18","11","4","0.60606","75","53","22"
"1881","Rutgers (NJ)","22","18","8","0.54167","70","47","23"
"1882","Rutgers (NJ)","41","28","2","0.59155","176","111","65"
"1883","Rutgers (NJ)","38","32","1","0.54225","1288","965","323"
"1884","Pennsylvania","47","29","5","0.61111","1728","1184","544"
"1885","Michigan","34","17","4","0.65455","1437","612","825"
"1886","Lehigh (PA)","48","21","4","0.68493","1850","637","1213"
"1887","California","67","35","3","0.65238","2660","935","1725"
"1888","Princeton (NJ)","70","56","6","0.55303","2468","1899","569"
"1889","Brown (RI)","82","51","11","0.60764","2879","1796","1083"
"1890","Brown (RI)","77","76","9","0.50309","3002","2455","547"
"1891","Southern California","94","76","13","0.54918","2813","2189","624"
"1892","Minnesota","93","80","9","0.53571","2972","2394","578"
"1893","Duke (NC)","79","94","9","0.45879","2176","2912","-736"
"1894","Colorado St.","50","62","4","0.44828","1161","1518","-357"
"1895","Boston (MA)","31","44","11","0.42442","692","1031","-339"
"1896","Rhode Island","54","62","12","0.46875","1126","1201","-75"
"1897","Boston (MA)","32","40","6","0.44872","792","785","7"
"1898","Miami (OH)","47","23","4","0.66216","921","644","277"
"1899","New Hampshire","33","32","6","0.50704","571","522","49"
"1900","New Hampshire","22","35","11","0.40441","442","686","-244"
"1901","Marshall (WV)","18","34","3","0.35455","302","917","-615"
"1902","Saint John's (MN)","9","22","4","0.31429","148","460","-312"
"1903","Wichita St. (KS)","14","25","2","0.36585","376","546","-170"
"1904","Oklahoma St.","11","14","1","0.44231","194","394","-200"
"1905","Miami (OH)","7","25","5","0.25676","245","494","-249"
"1906","Rensselaer Tech (NY)","3","7","4","0.35714","92","107","-15"
"1907","Marshall (WV)","5","10","2","0.35294","71","238","-167"
"1908","Fort Hays St. (KS)","5","6","1","0.45833","56","91","-35"
"1909","Fort Hays St. (KS)","1","3","1","0.30000","12","68","-56"
"1910","Texas St.","0","1","0","0.00000","0","19","-19"
"1912","Fort Hays St. (KS)","1","2","0","0.33333","20","132","-112"
"1913","Eureka (IL)","1","6","0","0.14286","39","203","-164"
"1914","Eureka (IL)","3","4","0","0.42857","57","201","-144"
"1915","Texas St.","1","1","1","0.50000","13","20","-7"
"1916","Texas St.","0","2","1","0.16667","0","106","-106"
"1917","Boston (MA)","4","4","0","0.50000","73","136","-63"
"1918","Monmouth (IL)","1","7","0","0.12500","26","137","-111"
"1930","Troy (AL)","1","2","0","0.33333","7","73","-66"
"2013","Grambling St. (LA)","0","1","0","0.00000","0","0","0"
"1891","Rutgers (NJ)","8","6","0","0.57143","265","137","128"
"1896","Cincinnati (OH)","4","3","1","0.56250","88","68","20"
"1897","North Carolina","7","3","0","0.70000","150","53","97"
"1898","North Carolina","9","0","0","1.00000","187","8","179"
"1899","North Carolina","7","3","1","0.68182","173","58","115"
"1900","North Carolina","4","1","3","0.68750","163","22","141"
"1895","Rutgers (NJ)","4","4","0","0.50000","98","131","-33"
"1896","Rutgers (NJ)","0","1","0","0.00000","0","22","-22"
"1896","Rutgers (NJ)","6","6","0","0.50000","74","204","-130"
"1897","Rutgers (NJ)","2","7","0","0.22222","38","128","-90"
"1898","Rutgers (NJ)","1","6","1","0.18750","16","114","-98"
"1899","Rutgers (NJ)","2","9","0","0.18182","114","245","-131"
"1900","Rutgers (NJ)","4","4","0","0.50000","50","66","-16"
"1901","Rutgers (NJ)","0","7","0","0.00000","5","133","-128"
"1902","Rutgers (NJ)","3","7","0","0.30000","42","188","-146"
"1903","Rutgers (NJ)","4","4","1","0.50000","94","110","-16"
"1905","Rutgers (NJ)","3","6","0","0.33333","44","99","-55"
"1904","Rutgers (NJ)","1","6","2","0.22222","16","202","-186"
"1906","Rutgers (NJ)","5","2","2","0.66667","123","30","93"
"1907","Rutgers (NJ)","3","5","1","0.38889","76","99","-23"
"1914","Virginia Military Institute","4","4","0","0.50000","120","95","25"
"1915","Virginia Military Institute","6","2","1","0.72222","103","102","1"
"1916","Virginia Military Institute","4","5","0","0.44444","233","119","114"
"1908","Rutgers (NJ)","3","5","1","0.38889","53","104","-51"
"1909","Rutgers (NJ)","3","5","1","0.38889","62","74","-12"
"1908","Fordham (NY)","5","1","0","0.83333","96","29","67"
"1909","Fordham (NY)","5","1","2","0.75000","86","22","64"
"1910","Rutgers (NJ)","3","2","3","0.56250","59","33","26"
"1911","Rutgers (NJ)","4","4","1","0.50000","25","99","-74"
"1912","Rutgers (NJ)","5","4","0","0.55556","112","102","10"
"1899","Columbia (NY)","8","3","0","0.72727","194","85","109"
"1900","Columbia (NY)","6","3","1","0.65000","79","77","2"
"1901","Columbia (NY)","8","5","0","0.61538","157","91","66"
"1904","Virginia","6","3","0","0.66667","78","54","24"
"1913","Rutgers (NJ)","6","3","0","0.66667","247","76","171"
"1914","Rutgers (NJ)","5","3","1","0.61111","208","73","135"
"1915","Rutgers (NJ)","7","1","0","0.87500","351","33","318"
"1916","Rutgers (NJ)","3","2","2","0.57143","106","52","54"
"1917","Rutgers (NJ)","7","1","1","0.83333","295","28","267"
"1918","Rutgers (NJ)","5","2","0","0.71429","192","78","114"
"1919","Rutgers (NJ)","5","3","0","0.62500","115","70","45"
"1920","Rutgers (NJ)","2","7","0","0.22222","32","132","-100"
"1921","Rutgers (NJ)","4","5","0","0.44444","99","168","-69"
"1922","Rutgers (NJ)","5","4","0","0.55556","133","117","16"
"1923","Rutgers (NJ)","7","1","1","0.83333","260","36","224"
"1924","Rutgers (NJ)","7","1","1","0.83333","249","48","201"
"1925","Rutgers (NJ)","2","7","0","0.22222","38","146","-108"
"1926","Rutgers (NJ)","3","6","0","0.33333","49","134","-85"
"1927","Rutgers (NJ)","4","4","0","0.50000","103","179","-76"
"1928","Rutgers (NJ)","6","3","0","0.66667","97","116","-19"
"1929","Rutgers (NJ)","5","4","0","0.55556","109","94","15"
"1930","Rutgers (NJ)","4","5","0","0.44444","159","154","5"
"1942","Rutgers (NJ)","3","4","1","0.43750","100","113","-13"
"1943","Rutgers (NJ)","3","2","0","0.60000","61","21","40"
"1944","Rutgers (NJ)","3","2","0","0.60000","58","82","-24"
"1945","Rutgers (NJ)","5","2","0","0.71429","140","61","79"
"1921","Connecticut","3","2","3","0.56250","115","75","40"
"1922","Connecticut","2","6","1","0.27778","77","108","-31"
"1923","William & Mary (VA)","7","3","0","0.70000","224","115","109"
"1924","William & Mary (VA)","6","2","1","0.72222","170","61","109"
"1925","William & Mary (VA)","7","4","0","0.63636","235","86","149"
"1926","William & Mary (VA)","7","3","0","0.70000","169","87","82"
"1927","William & Mary (VA)","4","5","1","0.45000","111","118","-7"
"1931","Rutgers (NJ)","4","3","1","0.56250","111","100","11"
"1932","Rutgers (NJ)","6","3","1","0.65000","159","58","101"
"1933","Rutgers (NJ)","6","3","1","0.65000","146","94","52"
"1934","Rutgers (NJ)","5","3","1","0.61111","184","68","116"
"1935","Rutgers (NJ)","4","5","0","0.44444","115","170","-55"
"1936","Rutgers (NJ)","1","6","1","0.18750","20","133","-113"
"1937","Rutgers (NJ)","5","4","0","0.55556","128","39","89"
"1930","Sewanee (TN)","3","6","1","0.35000","71","133","-62"
"1931","Pennsylvania","6","3","0","0.66667","121","94","27"
"1932","Pennsylvania","6","2","0","0.75000","178","58","120"
"1933","Pennsylvania","2","4","1","0.35714","57","80","-23"
"1934","Pennsylvania","4","4","0","0.50000","118","83","35"
"1935","Pennsylvania","4","4","0","0.50000","199","80","119"
"1936","Pennsylvania","7","1","0","0.87500","166","44","122"
"1937","Pennsylvania","2","5","1","0.31250","75","129","-54"
"1938","Rutgers (NJ)","7","1","0","0.87500","118","57","61"
"1939","Rutgers (NJ)","7","1","1","0.83333","146","70","76"
"1940","Rutgers (NJ)","5","3","0","0.62500","211","56","155"
"1941","Rutgers (NJ)","7","2","0","0.77778","174","85","89"
"1946","Rutgers (NJ)","7","2","0","0.77778","252","48","204"
"1947","Rutgers (NJ)","8","1","0","0.88889","262","99","163"
"1948","Rutgers (NJ)","7","2","0","0.77778","224","130","94"
"1949","Rutgers (NJ)","6","3","0","0.66667","266","138","128"
"1950","Rutgers (NJ)","4","4","0","0.50000","186","154","32"
"1951","Rutgers (NJ)","4","4","0","0.50000","184","114","70"
"1952","Rutgers (NJ)","4","4","1","0.50000","178","184","-6"
"1953","Rutgers (NJ)","2","6","0","0.25000","126","216","-90"
"1954","Rutgers (NJ)","3","6","0","0.33333","140","145","-5"
"1955","Rutgers (NJ)","3","5","0","0.37500","95","163","-68"
"1956","Rutgers (NJ)","3","7","0","0.30000","117","240","-123"
"1957","Rutgers (NJ)","5","4","0","0.55556","181","133","48"
"1958","Rutgers (NJ)","8","1","0","0.88889","301","77","224"
"1959","Rutgers (NJ)","6","3","0","0.66667","132","121","11"
"1960","Pennsylvania","3","6","0","0.33333","104","149","-45"
"1961","Pennsylvania","2","7","0","0.22222","42","194","-152"
"1962","Pennsylvania","3","6","0","0.33333","90","174","-84"
"1963","Pennsylvania","3","6","0","0.33333","97","189","-92"
"1964","Pennsylvania","1","8","0","0.11111","48","222","-174"
"1960","Rutgers (NJ)","8","1","0","0.88889","225","69","156"
"1961","Rutgers (NJ)","9","0","0","1.00000","246","102","144"
"1962","Rutgers (NJ)","5","5","0","0.50000","164","169","-5"
"1963","Rutgers (NJ)","3","6","0","0.33333","145","148","-3"
"1964","Rutgers (NJ)","6","3","0","0.66667","149","115","34"
"1965","Rutgers (NJ)","3","6","0","0.33333","84","152","-68"
"1966","Rutgers (NJ)","5","4","0","0.55556","184","177","7"
"1967","Rutgers (NJ)","4","5","0","0.44444","155","170","-15"
"1968","Rutgers (NJ)","8","2","0","0.80000","276","182","94"
"1969","Rutgers (NJ)","6","3","0","0.66667","212","150","62"
"1970","Rutgers (NJ)","5","5","0","0.50000","193","215","-22"
"1971","Rutgers (NJ)","4","7","0","0.36364","193","243","-50"
"1972","Rutgers (NJ)","7","4","0","0.63636","290","172","118"
"1951","Johns Hopkins (MD)","2","5","1","0.31250","177","236","-59"
"1952","Johns Hopkins (MD)","4","4","0","0.50000","183","152","31"
"1973","Rutgers (NJ)","6","5","0","0.54545","245","208","37"
"1974","Rutgers (NJ)","7","3","1","0.68182","244","146","98"
"1975","Rutgers (NJ)","9","2","0","0.81818","347","91","256"
"1976","Rutgers (NJ)","11","0","0","1.00000","287","81","206"
"1977","Rutgers (NJ)","8","3","0","0.72727","291","181","110"
"1978","Rutgers (NJ)","9","3","0","0.75000","284","165","119"
"1979","Rutgers (NJ)","8","3","0","0.72727","243","174","69"
"1980","Rutgers (NJ)","7","4","0","0.63636","279","156","123"
"1981","Rutgers (NJ)","5","6","0","0.45455","139","208","-69"
"1982","Rutgers (NJ)","5","6","0","0.45455","180","278","-98"
"1983","Rutgers (NJ)","3","8","0","0.27273","195","258","-63"
"1984","Rutgers (NJ)","7","3","0","0.70000","213","155","58"
"1985","Rutgers (NJ)","2","8","1","0.22727","149","266","-117"
"1986","Rutgers (NJ)","6","4","1","0.59091","221","189","32"
"1987","Rutgers (NJ)","6","5","0","0.54545","168","213","-45"
"1988","Rutgers (NJ)","5","6","0","0.45455","273","255","18"
"1989","Rutgers (NJ)","2","7","2","0.27273","245","319","-74"
"1982","Montana St.","6","5","0","0.54545","240","294","-54"
"1990","Rutgers (NJ)","3","8","0","0.27273","173","302","-129"
"1991","Rutgers (NJ)","6","5","0","0.54545","217","217","0"
"1992","Rutgers (NJ)","7","4","0","0.63636","341","245","96"
"1993","Rutgers (NJ)","4","7","0","0.36364","351","334","17"
"1994","Rutgers (NJ)","5","5","1","0.50000","241","261","-20"
"1995","Rutgers (NJ)","4","7","0","0.36364","304","412","-108"
"1990","San Jose St. (CA)","9","2","1","0.79167","435","228","207"
"1991","San Jose St. (CA)","6","4","1","0.59091","372","298","74"
"1996","Rutgers (NJ)","2","9","0","0.18182","143","380","-237"
"1997","Rutgers (NJ)","0","11","0","0.00000","191","496","-305"
"1998","Rutgers (NJ)","5","6","0","0.45455","206","376","-170"
"1999","Rutgers (NJ)","2","9","0","0.18182","155","427","-272"
"2000","Rutgers (NJ)","3","8","0","0.27273","233","399","-166"
"2001","Rutgers (NJ)","2","9","0","0.18182","119","397","-278"
"2002","Rutgers (NJ)","1","11","0","0.08333","167","397","-230"
"2003","Rutgers (NJ)","5","7","0","0.41667","329","354","-25"
"2004","Rutgers (NJ)","4","7","0","0.36364","269","343","-74"
"2005","Rutgers (NJ)","7","5","0","0.58333","344","307","37"
"2006","Rutgers (NJ)","11","2","0","0.84615","387","186","201"
"2007","Rutgers (NJ)","8","5","0","0.61538","426","292","134"
"2008","Rutgers (NJ)","8","5","0","0.61538","377","245","132"
"2009","Rutgers (NJ)","9","4","0","0.69231","375","233","142"
"2010","Rutgers (NJ)","4","8","0","0.33333","250","318","-68"
"2011","Rutgers (NJ)","9","4","0","0.69231","343","238","105"
"2012","Rutgers (NJ)","9","4","0","0.69231","279","184","95"
"2013","Rutgers (NJ)","6","7","0","0.46154","345","387","-42"
"1921","San Diego St. (CA)","4","6","0","0.40000","60","100","-40"
"1922","San Diego St. (CA)","6","4","0","0.60000","190","104","86"
"1923","San Diego St. (CA)","8","2","0","0.80000","207","82","125"
"1924","San Diego St. (CA)","7","1","2","0.80000","249","53","196"
"1925","San Diego St. (CA)","5","3","1","0.61111","108","59","49"
"1926","San Diego St. (CA)","3","4","1","0.43750","78","150","-72"
"1927","San Diego St. (CA)","4","3","0","0.57143","190","79","111"
"1928","San Diego St. (CA)","3","3","0","0.50000","111","105","6"
"1929","San Diego St. (CA)","3","5","0","0.37500","81","96","-15"
"1930","San Diego St. (CA)","5","4","0","0.55556","112","71","41"
"1931","San Diego St. (CA)","5","3","2","0.60000","71","45","26"
"1932","San Diego St. (CA)","3","5","1","0.38889","80","72","8"
"1933","San Diego St. (CA)","4","4","1","0.50000","59","72","-13"
"1934","San Diego St. (CA)","3","5","1","0.38889","61","106","-45"
"1929","Idaho","4","5","0","0.44444","168","214","-46"
"1930","Idaho","4","7","0","0.36364","154","176","-22"
"1931","Idaho","3","4","0","0.42857","75","106","-31"
"1932","Idaho","3","5","0","0.37500","114","97","17"
"1933","Idaho","4","4","0","0.50000","117","89","28"
"1934","Idaho","3","5","0","0.37500","77","120","-43"
"1935","San Diego St. (CA)","3","4","1","0.43750","56","83","-27"
"1936","San Diego St. (CA)","6","1","1","0.81250","118","62","56"
"1937","San Diego St. (CA)","7","1","0","0.87500","90","16","74"
"1938","San Diego St. (CA)","5","2","1","0.68750","82","69","13"
"1939","San Diego St. (CA)","2","7","0","0.22222","60","148","-88"
"1940","San Diego St. (CA)","5","3","1","0.61111","128","87","41"
"1941","San Diego St. (CA)","6","4","0","0.60000","105","87","18"
"1942","San Diego St. (CA)","0","6","1","0.07143","50","211","-161"
"1945","San Diego St. (CA)","2","5","0","0.28571","65","163","-98"
"1938","Western Kentucky","7","2","0","0.77778","217","46","171"
"1939","Western Kentucky","7","1","1","0.83333","132","52","80"
"1940","Western Kentucky","7","1","1","0.83333","115","20","95"
"1941","Western Kentucky","4","5","1","0.45000","128","149","-21"
"1946","San Diego St. (CA)","6","4","0","0.60000","152","105","47"
"1947","San Diego St. (CA)","7","3","1","0.68182","191","156","35"
"1948","San Diego St. (CA)","4","7","0","0.36364","158","190","-32"
"1949","San Diego St. (CA)","6","3","0","0.66667","195","200","-5"
"1950","San Diego St. (CA)","5","3","1","0.61111","212","186","26"
"1951","San Diego St. (CA)","10","0","1","0.95455","386","133","253"
"1952","San Diego St. (CA)","4","5","0","0.44444","238","267","-29"
"1953","San Diego St. (CA)","5","3","1","0.61111","230","142","88"
"1954","San Diego St. (CA)","5","4","0","0.55556","177","141","36"
"1955","San Diego St. (CA)","2","8","0","0.20000","65","231","-166"
"1956","San Diego St. (CA)","4","3","2","0.55556","149","217","-68"
"1957","San Diego St. (CA)","2","7","0","0.22222","77","243","-166"
"1958","San Diego St. (CA)","3","5","0","0.37500","84","200","-116"
"1959","San Diego St. (CA)","1","6","1","0.18750","74","208","-134"
"1960","San Diego St. (CA)","1","6","1","0.18750","53","207","-154"
"1961","San Diego St. (CA)","7","2","1","0.75000","231","154","77"
"1962","San Diego St. (CA)","8","2","0","0.80000","294","135","159"
"1963","San Diego St. (CA)","7","2","0","0.77778","317","118","199"
"1964","San Diego St. (CA)","8","2","0","0.80000","423","71","352"
"1965","San Diego St. (CA)","8","2","0","0.80000","353","87","266"
"1966","San Diego St. (CA)","11","0","0","1.00000","317","105","212"
"1967","San Diego St. (CA)","10","1","0","0.90909","319","135","184"
"1968","San Diego St. (CA)","9","0","1","0.95000","377","155","222"
"1969","San Diego St. (CA)","11","0","0","1.00000","492","194","298"
"1970","San Diego St. (CA)","9","2","0","0.81818","364","123","241"
"1971","San Diego St. (CA)","6","5","0","0.54545","245","230","15"
"1972","San Diego St. (CA)","10","1","0","0.90909","266","143","123"
"1973","San Diego St. (CA)","9","1","1","0.86364","321","129","192"
"1974","San Diego St. (CA)","8","2","1","0.77273","291","170","121"
"1975","San Diego St. (CA)","8","3","0","0.72727","320","145","175"
"1976","San Diego St. (CA)","10","1","0","0.90909","197","125","72"
"1977","San Diego St. (CA)","10","1","0","0.90909","349","165","184"
"1978","San Diego St. (CA)","4","7","0","0.36364","242","257","-15"
"1979","San Diego St. (CA)","8","3","0","0.72727","286","276","10"
"1980","San Diego St. (CA)","4","8","0","0.33333","161","294","-133"
"1984","San Jose St. (CA)","6","5","0","0.54545","260","225","35"
"1985","San Jose St. (CA)","2","8","1","0.22727","212","339","-127"
"1986","San Jose St. (CA)","10","2","0","0.83333","397","232","165"
"1987","San Jose St. (CA)","10","2","0","0.83333","417","223","194"
"1988","San Jose St. (CA)","4","8","0","0.33333","316","334","-18"
"1989","San Jose St. (CA)","6","5","0","0.54545","309","277","32"
"1966","Pacific (CA)","4","7","0","0.36364","211","303","-92"
"1967","Pacific (CA)","4","5","0","0.44444","201","158","43"
"1968","Pacific (CA)","6","4","0","0.60000","179","158","21"
"1969","Pacific (CA)","7","3","0","0.70000","284","146","138"
"1981","San Diego St. (CA)","6","5","0","0.54545","279","227","52"
"1982","San Diego St. (CA)","7","5","0","0.58333","308","320","-12"
"1983","San Diego St. (CA)","2","9","1","0.20833","221","352","-131"
"1984","San Diego St. (CA)","4","7","1","0.37500","265","250","15"
"1985","San Diego St. (CA)","5","6","1","0.45833","342","317","25"
"1965","Alma (MI)","3","5","0","0.37500","79","147","-68"
"1966","Alma (MI)","4","5","0","0.44444","102","93","9"
"1967","Alma (MI)","8","0","0","1.00000","217","41","176"
"1968","Alma (MI)","8","0","0","1.00000","248","65","183"
"1969","Alma (MI)","6","3","0","0.66667","218","113","105"
"1970","Alma (MI)","5","3","0","0.62500","195","104","91"
"1973","Michigan St.","5","6","0","0.45455","114","164","-50"
"1974","Michigan St.","7","3","1","0.68182","270","196","74"
"1975","Michigan St.","7","4","0","0.63636","222","167","55"
"1977","Bowling Green (OH)","5","7","0","0.41667","275","296","-21"
"1978","Bowling Green (OH)","4","7","0","0.36364","277","267","10"
"1979","Bowling Green (OH)","4","7","0","0.36364","194","265","-71"
"1980","Bowling Green (OH)","4","7","0","0.36364","189","186","3"
"1981","Bowling Green (OH)","5","5","1","0.50000","155","132","23"
"1982","Bowling Green (OH)","7","5","0","0.58333","265","199","66"
"1983","Bowling Green (OH)","8","3","0","0.72727","277","242","35"
"1984","Bowling Green (OH)","8","3","0","0.72727","327","198","129"
"1985","Bowling Green (OH)","11","1","0","0.91667","355","223","132"
"1986","San Diego St. (CA)","8","4","0","0.66667","292","279","13"
"1987","San Diego St. (CA)","5","7","0","0.41667","357","428","-71"
"1988","San Diego St. (CA)","3","8","0","0.27273","204","384","-180"
"1989","San Diego St. (CA)","6","5","1","0.54167","368","378","-10"
"1990","San Diego St. (CA)","6","5","0","0.54545","459","386","73"
"1991","San Diego St. (CA)","8","4","1","0.65385","420","365","55"
"1992","San Diego St. (CA)","5","5","1","0.50000","334","338","-4"
"1993","San Diego St. (CA)","6","6","0","0.50000","413","392","21"
"1983","Southern California","4","6","1","0.40909","210","238","-28"
"1984","Southern California","9","3","0","0.75000","220","173","47"
"1985","Southern California","6","6","0","0.50000","223","187","36"
"1986","Southern California","7","5","0","0.58333","264","239","25"
"1994","San Diego St. (CA)","4","7","0","0.36364","332","339","-7"
"1995","San Diego St. (CA)","8","4","0","0.66667","401","283","118"
"1996","San Diego St. (CA)","8","3","0","0.72727","428","303","125"
"1997","San Diego St. (CA)","5","7","0","0.41667","257","333","-76"
"1998","San Diego St. (CA)","7","5","0","0.58333","243","244","-1"
"1999","San Diego St. (CA)","5","6","0","0.45455","272","226","46"
"2000","San Diego St. (CA)","3","8","0","0.27273","170","273","-103"
"2001","San Diego St. (CA)","3","8","0","0.27273","184","290","-106"
"2002","San Diego St. (CA)","4","9","0","0.30769","309","411","-102"
"2003","San Diego St. (CA)","6","6","0","0.50000","224","207","17"
"2004","San Diego St. (CA)","4","7","0","0.36364","234","282","-48"
"2005","San Diego St. (CA)","5","7","0","0.41667","323","325","-2"
"2006","San Diego St. (CA)","3","9","0","0.25000","170","325","-155"
"2007","San Diego St. (CA)","4","8","0","0.33333","300","413","-113"
"2008","San Diego St. (CA)","2","10","0","0.16667","231","446","-215"
"2003","Ball St. (IN)","4","8","0","0.33333","261","386","-125"
"2004","Ball St. (IN)","2","9","0","0.18182","225","405","-180"
"2005","Ball St. (IN)","4","7","0","0.36364","233","416","-183"
"2006","Ball St. (IN)","5","7","0","0.41667","326","309","17"
"2007","Ball St. (IN)","7","6","0","0.53846","409","368","41"
"2008","Ball St. (IN)","12","1","0","0.92308","476","242","234"
"2009","San Diego St. (CA)","4","8","0","0.33333","280","366","-86"
"2010","San Diego St. (CA)","9","4","0","0.69231","455","287","168"
"2011","Michigan","11","2","0","0.84615","433","226","207"
"2012","Michigan","8","5","0","0.61538","388","258","130"
"2013","Michigan","7","6","0","0.53846","419","349","70"
"1998","New Mexico","3","9","0","0.25000","274","397","-123"
"1999","New Mexico","4","7","0","0.36364","240","298","-58"
"2000","New Mexico","5","7","0","0.41667","229","249","-20"
"2001","New Mexico","6","5","0","0.54545","304","243","61"
"2002","New Mexico","7","7","0","0.50000","341","358","-17"
"2003","New Mexico","8","5","0","0.61538","391","290","101"
"2004","New Mexico","7","5","0","0.58333","244","224","20"
"2005","New Mexico","6","5","0","0.54545","326","327","-1"
"2006","New Mexico","6","7","0","0.46154","284","312","-28"
"2007","New Mexico","9","4","0","0.69231","321","247","74"
"2008","New Mexico","4","8","0","0.33333","253","273","-20"
"2011","San Diego St. (CA)","8","5","0","0.61538","387","325","62"
"2012","San Diego St. (CA)","9","4","0","0.69231","427","317","110"
"2013","San Diego St. (CA)","8","5","0","0.61538","387","412","-25"
"1872","Stevens Tech (NJ)","0","1","0","0.00000","0","6","-6"
"1873","New York (NY)","3","3","0","0.50000","15","13","2"
"1874","Stevens Tech (NJ)","2","3","0","0.40000","10","20","-10"
"1875","Stevens Tech (NJ)","4","4","0","0.50000","21","20","1"
"1876","New York (NY)","2","3","1","0.41667","16","19","-3"
"1877","Stevens Tech (NJ)","3","1","2","0.66667","9","14","-5"
"1878","Stevens Tech (NJ)","3","3","3","0.50000","3","9","-6"
"1879","Stevens Tech (NJ)","2","3","5","0.45000","8","14","-6"
"1880","Stevens Tech (NJ)","1","5","0","0.16667","3","16","-13"
"1881","Stevens Tech (NJ)","3","8","3","0.32143","16","29","-13"
"1882","Lawrence (WI)","7","8","1","0.46875","17","25","-8"
"1883","Stevens Tech (NJ)","7","6","1","0.53571","187","128","59"
"1884","Fordham (NY)","9","10","0","0.47368","221","261","-40"
"1885","Georgetown (DC)","5","17","1","0.23913","359","612","-253"
"1886","New York (NY)","9","15","2","0.38462","180","565","-385"
"1887","Fordham (NY)","8","12","1","0.40476","157","445","-288"
"1888","Amherst (MA)","6","17","3","0.28846","192","791","-599"
"1889","New York (NY)","8","21","4","0.30303","278","647","-369"
"1890","New York (NY)","25","14","2","0.63415","727","538","189"
"1891","Delaware","32","30","7","0.51449","966","971","-5"
"1892","Beloit (WI)","29","31","3","0.48413","726","797","-71"
"1893","Marquette (WI)","39","34","3","0.53289","1091","885","206"
"1894","Manhattan (NY)","32","29","7","0.52206","853","692","161"
"1895","Delaware","44","35","6","0.55294","889","813","76"
"1896","Manhattan (NY)","51","49","6","0.50943","949","1164","-215"
"1897","Stevens Tech (NJ)","37","50","4","0.42857","661","1048","-387"
"1898","Manhattan (NY)","37","43","9","0.46629","781","1050","-269"
"1899","Manhattan (NY)","34","40","6","0.46250","594","1063","-469"
"1900","Manhattan (NY)","43","47","11","0.48020","991","1049","-58"
"1901","Ferris St. (MI)","51","44","7","0.53431","906","852","54"
"1902","Indiana St.","56","48","5","0.53670","1053","927","126"
"1903","Manhattan (NY)","30","49","7","0.38953","762","1319","-557"
"1904","Saint Francis (NY)","44","53","9","0.45755","787","1363","-576"
"1905","Bluffton (OH)","38","59","5","0.39706","850","1433","-583"
"1906","Ferris St. (MI)","32","43","12","0.43678","677","854","-177"
"1907","Ferris St. (MI)","32","48","10","0.41111","722","1208","-486"
"1908","Western Illinois","36","45","10","0.45055","760","1069","-309"
"1909","Delaware Valley (PA)","27","52","2","0.34568","682","1287","-605"
"1910","East Stroudsburg (PA)","23","31","3","0.42982","583","738","-155"
"1911","Western Illinois","32","44","7","0.42771","661","902","-241"
"1912","Indiana (PA)","36","56","7","0.39899","1134","1463","-329"
"1913","Saint Francis (NY)","52","67","8","0.44094","1672","2360","-688"
"1914","Delaware Valley (PA)","41","50","6","0.45361","1217","1585","-368"
"1915","Western Illinois","34","35","11","0.49375","932","1217","-285"
"1916","Morgan St. (MD)","44","43","7","0.50532","1493","1270","223"
"1917","Morgan St. (MD)","21","21","2","0.50000","408","883","-475"
"1918","Oklahoma Baptist University","7","16","2","0.32000","258","358","-100"
"1919","Western Illinois","53","41","8","0.55882","1478","1056","422"
"1920","Virginia Union","28","39","2","0.42029","506","893","-387"
"1921","Cooper Union (NY)","19","34","3","0.36607","441","1112","-671"
"1922","Cooper Union (NY)","27","34","6","0.44776","703","832","-129"
"1923","Cooper Union (NY)","31","45","2","0.41026","718","1112","-394"
"1924","East Stroudsburg (PA)","34","40","6","0.46250","946","1175","-229"
"1925","Saint Anselm (NH)","32","28","10","0.52857","847","802","45"
"1926","Saint Anselm (NH)","22","30","4","0.42857","515","702","-187"
"1927","Bethune-Cookman (FL)","20","29","8","0.42105","674","783","-109"
"1928","Saint Anselm (NH)","28","24","7","0.53390","564","1095","-531"
"1929","Saint Anselm (NH)","25","32","5","0.44355","616","843","-227"
"1930","Saint Anselm (NH)","31","27","10","0.52941","643","549","94"
"1931","Campbell (NC)","21","17","4","0.54762","465","428","37"
"1932","Campbell (NC)","7","30","3","0.21250","254","760","-506"
"1933","Campbell (NC)","11","13","3","0.46296","262","324","-62"
"1934","Bowie St. (MD)","4","7","2","0.38462","116","94","22"
"1935","Florida Southern","7","12","1","0.37500","170","162","8"
"1936","Bowie St. (MD)","5","2","1","0.68750","154","97","57"
"1937","Bowie St. (MD)","6","3","0","0.66667","98","87","11"
"1938","West Alabama","7","5","0","0.58333","151","88","63"
"1939","Elizabeth City St. (NC)","7","13","0","0.35000","150","307","-157"
"1940","Elizabeth City St. (NC)","6","5","4","0.53333","128","67","61"
"1941","Arkansas-Pine Bluff","3","9","5","0.32353","178","223","-45"
"1942","Brevard College (NC)","10","6","2","0.61111","225","189","36"
"1943","Clark Atlanta (GA)","6","8","0","0.42857","127","206","-79"
"1944","Abilene Christian (TX)","9","11","1","0.45238","158","255","-97"
"1945","Benedict (SC)","10","15","2","0.40741","299","296","3"
"1946","Elizabeth City St. (NC)","7","20","3","0.28333","144","540","-396"
"1947","Clark Atlanta (GA)","3","6","2","0.36364","49","230","-181"
"1948","Virginia-Lynchburg","4","6","1","0.40909","77","302","-225"
"1949","Virginia-Lynchburg","0","3","1","0.12500","7","70","-63"
"1950","Virginia-Lynchburg","2","3","0","0.40000","53","98","-45"
"1951","Lane (TN)","8","6","0","0.57143","295","234","61"
"1952","Lane (TN)","9","5","1","0.63333","220","206","14"
"1953","Lane (TN)","1","7","0","0.12500","58","215","-157"
"1954","Lane (TN)","2","6","0","0.25000","105","135","-30"
"1955","Lane (TN)","2","4","0","0.33333","83","129","-46"
"1957","Louisiana College","2","7","0","0.22222","106","179","-73"
"1959","Azusa Pacific (CA)","2","3","0","0.40000","117","90","27"
"1960","Azusa Pacific (CA)","4","3","1","0.56250","103","76","27"
"1961","Azusa Pacific (CA)","3","3","0","0.50000","123","147","-24"
"1963","San Francisco (CA)","2","5","0","0.28571","58","98","-40"
"1964","New York (NY)","0","2","0","0.00000","20","48","-28"
"1965","Adelphi (NY)","4","8","0","0.33333","198","216","-18"
"1966","Fairfield (CT)","18","22","2","0.45238","545","652","-107"
"1967","La Salle (PA)","25","31","0","0.44643","846","1080","-234"
"1968","Centenary (LA)","17","42","2","0.29508","726","1393","-667"
"1969","Bluffton (OH)","33","43","0","0.43421","1058","1548","-490"
"1970","Saint John's (NY)","35","54","1","0.39444","1379","1783","-404"
"1971","Bluffton (OH)","43","45","1","0.48876","1360","1384","-24"
"1972","Marquette (WI)","39","44","2","0.47059","1217","1351","-134"
"1973","Brooklyn (NY)","30","52","1","0.36747","1007","1611","-604"
"1974","Marquette (WI)","33","36","3","0.47917","959","1169","-210"
"1975","Marquette (WI)","31","22","4","0.57895","1042","932","110"
"1976","Bluffton (OH)","23","33","1","0.41228","862","1186","-324"
"1977","Manhattan (NY)","14","28","1","0.33721","568","923","-355"
"1978","Fairfield (CT)","5","7","1","0.42308","194","203","-9"
"1979","Fairfield (CT)","7","8","0","0.46667","247","260","-13"
"1980","Westfield St. (MA)","6","5","4","0.53333","184","196","-12"
"1981","San Francisco (CA)","17","14","0","0.54839","567","498","69"
"1982","Manhattan (NY)","18","16","0","0.52941","580","644","-64"
"1983","SUNY-Stony Brook (NY)","15","11","0","0.57692","474","453","21"
"1984","Stonehill (MA)","7","12","0","0.36842","231","439","-208"
"1985","Manhattan (NY)","10","10","0","0.50000","313","316","-3"
"1986","Marquette (WI)","13","17","0","0.43333","497","564","-67"
"1987","Marquette (WI)","10","17","0","0.37037","389","487","-98"
"1988","Marquette (WI)","1","5","0","0.16667","80","125","-45"
"1989","Marquette (WI)","4","4","0","0.50000","209","151","58"
"1990","Marquette (WI)","1","7","0","0.12500","80","180","-100"
"1991","Marquette (WI)","1","5","0","0.16667","106","182","-76"
"1992","Marquette (WI)","2","5","0","0.28571","81","129","-48"
"1993","Marquette (WI)","7","1","0","0.87500","212","126","86"
"1994","Marquette (WI)","1","6","0","0.14286","125","184","-59"
"1995","Marquette (WI)","3","4","0","0.42857","141","191","-50"
"1996","Marquette (WI)","3","5","0","0.37500","139","182","-43"
"1998","Madison College (WI)","2","15","0","0.11765","221","613","-392"
"1999","Marquette (WI)","0","7","0","0.00000","110","298","-188"
"2000","Marquette (WI)","1","5","0","0.16667","60","96","-36"
"2001","Marquette (WI)","2","6","0","0.25000","144","179","-35"
"2002","Marquette (WI)","3","4","0","0.42857","127","208","-81"
"2003","Marquette (WI)","1","6","0","0.14286","71","151","-80"
"2004","Marquette (WI)","0","6","0","0.00000","53","238","-185"
"2005","Marquette (WI)","2","5","0","0.28571","92","226","-134"
"2006","Marquette (WI)","1","6","0","0.14286","62","206","-144"
"2007","Marquette (WI)","2","5","0","0.28571","140","215","-75"
"2008","Marquette (WI)","0","7","0","0.00000","61","304","-243"
"2009","Marquette (WI)","0","1","0","0.00000","0","22","-22"
"1893","San Jose St. (CA)","0","1","0","0.00000","0","18","-18"
"1895","San Jose St. (CA)","0","0","1","0.50000","6","6","0"
"1898","San Jose St. (CA)","5","0","1","0.91667","80","17","63"
"1899","San Jose St. (CA)","6","3","1","0.65000","120","69","51"
"1900","San Jose St. (CA)","3","3","1","0.50000","23","64","-41"
"1921","San Jose St. (CA)","1","5","0","0.16667","35","141","-106"
"1922","San Jose St. (CA)","2","5","1","0.31250","34","127","-93"
"1923","San Jose St. (CA)","0","6","0","0.00000","3","262","-259"
"1924","San Jose St. (CA)","1","4","0","0.20000","25","89","-64"
"1925","San Jose St. (CA)","2","5","0","0.28571","66","144","-78"
"1926","San Jose St. (CA)","1","5","1","0.21429","26","94","-68"
"1927","San Jose St. (CA)","4","5","0","0.44444","121","67","54"
"1928","San Jose St. (CA)","5","2","1","0.68750","117","64","53"
"1929","San Jose St. (CA)","3","3","1","0.50000","104","78","26"
"1930","San Jose St. (CA)","2","3","3","0.43750","50","79","-29"
"1931","San Jose St. (CA)","1","8","0","0.11111","20","126","-106"
"1932","San Jose St. (CA)","7","0","2","0.88889","116","27","89"
"1933","San Jose St. (CA)","4","4","0","0.50000","102","78","24"
"1934","San Jose St. (CA)","3","3","4","0.50000","90","126","-36"
"1935","San Jose St. (CA)","5","5","1","0.50000","116","101","15"
"1936","San Jose St. (CA)","5","4","0","0.55556","136","93","43"
"1937","San Jose St. (CA)","11","2","1","0.82143","296","79","217"
"1938","San Jose St. (CA)","11","1","0","0.91667","322","56","266"
"1939","San Jose St. (CA)","13","0","0","1.00000","324","29","295"
"1948","West Virginia","9","3","0","0.75000","257","140","117"
"1949","West Virginia","4","6","1","0.40909","227","275","-48"
"1950","New Mexico","2","8","0","0.20000","160","337","-177"
"1951","New Mexico","4","7","0","0.36364","213","262","-49"
"1952","New Mexico","7","2","0","0.77778","119","46","73"
"1940","San Jose St. (CA)","11","1","0","0.91667","263","62","201"
"1941","San Jose St. (CA)","5","3","3","0.59091","149","96","53"
"1942","San Jose St. (CA)","7","2","0","0.77778","183","46","137"
"1946","San Jose St. (CA)","9","1","1","0.86364","227","94","133"
"1947","San Jose St. (CA)","9","3","0","0.75000","317","125","192"
"1948","San Jose St. (CA)","9","3","0","0.75000","373","168","205"
"1949","San Jose St. (CA)","9","4","0","0.69231","477","215","262"
"1950","San Jose St. (CA)","6","3","1","0.65000","201","118","83"
"1951","San Jose St. (CA)","2","7","1","0.25000","106","222","-116"
"1952","San Jose St. (CA)","6","3","0","0.66667","251","164","87"
"1953","San Jose St. (CA)","4","4","1","0.50000","156","220","-64"
"1954","San Jose St. (CA)","7","3","0","0.70000","191","151","40"
"1955","San Jose St. (CA)","5","3","1","0.61111","159","114","45"
"1956","San Jose St. (CA)","2","7","1","0.25000","186","301","-115"
"1953","New Mexico","5","3","1","0.61111","154","103","51"
"1954","New Mexico","5","5","0","0.50000","152","168","-16"
"1955","New Mexico","2","8","0","0.20000","61","213","-152"
"1957","San Jose St. (CA)","3","7","0","0.30000","123","196","-73"
"1958","San Jose St. (CA)","4","5","0","0.44444","174","106","68"
"1959","San Jose St. (CA)","4","6","0","0.40000","192","278","-86"
"1960","San Jose St. (CA)","5","4","0","0.55556","175","176","-1"
"1961","San Jose St. (CA)","6","4","0","0.60000","183","185","-2"
"1962","San Jose St. (CA)","2","8","1","0.22727","133","261","-128"
"1963","San Jose St. (CA)","5","5","0","0.50000","187","194","-7"
"1964","San Jose St. (CA)","4","6","0","0.40000","151","145","6"
"1965","San Jose St. (CA)","5","5","0","0.50000","184","192","-8"
"1966","San Jose St. (CA)","3","7","0","0.30000","151","198","-47"
"1967","San Jose St. (CA)","2","7","0","0.22222","166","286","-120"
"1968","San Jose St. (CA)","3","7","0","0.30000","148","403","-255"
"1950","Stetson (FL)","8","2","0","0.80000","300","133","167"
"1951","Stetson (FL)","8","1","2","0.81818","340","122","218"
"1954","Akron (OH)","3","5","0","0.37500","169","233","-64"
"1955","Akron (OH)","6","2","0","0.75000","245","73","172"
"1956","Akron (OH)","3","5","1","0.38889","216","171","45"
"1957","Akron (OH)","7","1","1","0.83333","208","87","121"
"1958","Akron (OH)","6","2","1","0.72222","166","82","84"
"1959","Akron (OH)","4","5","0","0.44444","111","155","-44"
"1960","Akron (OH)","1","8","0","0.11111","70","269","-199"
"1969","San Jose St. (CA)","2","8","0","0.20000","152","346","-194"
"1970","San Jose St. (CA)","1","2","0","0.33333","60","78","-18"
"1970","San Jose St. (CA)","1","7","0","0.12500","148","215","-67"
"1971","San Jose St. (CA)","5","6","1","0.45833","258","289","-31"
"1972","San Jose St. (CA)","4","7","0","0.36364","197","287","-90"
"1973","Wheaton (IL)","2","7","0","0.22222","134","190","-56"
"1974","Wheaton (IL)","4","5","0","0.44444","194","177","17"
"1975","Wheaton (IL)","5","4","0","0.55556","214","172","42"
"1976","Wheaton (IL)","6","3","0","0.66667","279","148","131"
"1977","Wheaton (IL)","5","4","0","0.55556","232","165","67"
"1978","Wheaton (IL)","6","3","0","0.66667","220","124","96"
"1979","Wheaton (IL)","1","8","0","0.11111","92","178","-86"
"1966","Fresno St. (CA)","7","3","0","0.70000","158","214","-56"
"1967","Fresno St. (CA)","3","8","0","0.27273","240","267","-27"
"1968","Fresno St. (CA)","7","4","0","0.63636","269","226","43"
"1969","Fresno St. (CA)","6","4","0","0.60000","237","227","10"
"1970","Fresno St. (CA)","8","4","0","0.66667","289","273","16"
"1971","Fresno St. (CA)","6","5","0","0.54545","215","165","50"
"1972","Fresno St. (CA)","6","4","1","0.59091","237","158","79"
"1973","San Jose St. (CA)","5","4","2","0.54545","193","173","20"
"1974","San Jose St. (CA)","8","3","1","0.70833","323","199","124"
"1975","San Jose St. (CA)","9","2","0","0.81818","291","152","139"
"1976","Michigan St.","4","6","1","0.40909","236","278","-42"
"1977","Michigan St.","7","3","1","0.68182","260","162","98"
"1978","Michigan St.","8","3","0","0.72727","411","170","241"
"1979","Michigan St.","5","6","0","0.45455","240","253","-13"
"1980","Arizona St.","7","4","0","0.63636","311","216","95"
"1981","Arizona St.","9","2","0","0.81818","394","193","201"
"1982","Arizona St.","10","2","0","0.83333","294","145","149"
"1983","Arizona St.","6","4","1","0.59091","320","200","120"
"1984","Arizona St.","5","6","0","0.45455","297","203","94"
"1976","San Jose St. (CA)","7","4","0","0.63636","354","213","141"
"1977","San Jose St. (CA)","4","7","0","0.36364","231","299","-68"
"1978","San Jose St. (CA)","7","5","0","0.58333","259","248","11"
"1979","San Jose St. (CA)","6","4","1","0.59091","327","301","26"
"1980","San Jose St. (CA)","7","4","0","0.63636","294","259","35"
"1981","San Jose St. (CA)","9","3","0","0.75000","380","254","126"
"1982","San Jose St. (CA)","8","3","0","0.72727","331","199","132"
"1983","San Jose St. (CA)","5","6","0","0.45455","256","253","3"
"1984","Stanford (CA)","5","6","0","0.45455","239","279","-40"
"1985","Stanford (CA)","4","7","0","0.36364","245","313","-68"
"1986","Stanford (CA)","8","4","0","0.66667","279","191","88"
"1987","Stanford (CA)","5","6","0","0.45455","262","268","-6"
"1988","Stanford (CA)","3","6","2","0.36364","238","216","22"
"1973","San Diego St. (CA)","9","1","1","0.86364","321","129","192"
"1974","San Diego St. (CA)","8","2","1","0.77273","291","170","121"
"1975","San Diego St. (CA)","8","3","0","0.72727","320","145","175"
"1976","San Diego St. (CA)","10","1","0","0.90909","197","125","72"
"1977","San Diego St. (CA)","10","1","0","0.90909","349","165","184"
"1978","San Diego St. (CA)","4","7","0","0.36364","242","257","-15"
"1979","San Diego St. (CA)","8","3","0","0.72727","286","276","10"
"1980","San Diego St. (CA)","4","8","0","0.33333","161","294","-133"
"1984","San Jose St. (CA)","6","5","0","0.54545","260","225","35"
"1985","San Jose St. (CA)","2","8","1","0.22727","212","339","-127"
"1986","San Jose St. (CA)","10","2","0","0.83333","397","232","165"
"1987","San Jose St. (CA)","10","2","0","0.83333","417","223","194"
"1988","San Jose St. (CA)","4","8","0","0.33333","316","334","-18"
"1989","San Jose St. (CA)","6","5","0","0.54545","309","277","32"
"1990","San Jose St. (CA)","9","2","1","0.79167","435","228","207"
"1991","San Jose St. (CA)","6","4","1","0.59091","372","298","74"
"1996","Rutgers (NJ)","2","9","0","0.18182","143","380","-237"
"1997","Rutgers (NJ)","0","11","0","0.00000","191","496","-305"
"1998","Rutgers (NJ)","5","6","0","0.45455","206","376","-170"
"1999","Rutgers (NJ)","2","9","0","0.18182","155","427","-272"
"2000","Rutgers (NJ)","3","8","0","0.27273","233","399","-166"
"1992","San Jose St. (CA)","7","4","0","0.63636","330","309","21"
"1997","Illinois","0","11","0","0.00000","119","368","-249"
"1998","Illinois","3","8","0","0.27273","149","326","-177"
"1999","Illinois","8","4","0","0.66667","388","275","113"
"2000","Illinois","5","6","0","0.45455","294","286","8"
"2001","Illinois","10","2","0","0.83333","390","285","105"
"2002","Illinois","5","7","0","0.41667","346","307","39"
"2003","Illinois","1","11","0","0.08333","203","398","-195"
"2004","Illinois","3","8","0","0.27273","240","323","-83"
"2013","Florida International","1","11","0","0.08333","117","444","-327"
"1959","Utah St.","5","6","0","0.45455","181","185","-4"
"1960","Utah St.","9","2","0","0.81818","274","85","189"
"1961","Utah St.","9","1","1","0.86364","396","102","294"
"1962","Utah St.","8","2","0","0.80000","273","139","134"
"1963","Stanford (CA)","3","7","0","0.30000","154","199","-45"
"1964","Stanford (CA)","5","5","0","0.50000","150","138","12"
"1965","Stanford (CA)","6","3","1","0.65000","144","149","-5"
"1966","Stanford (CA)","5","5","0","0.50000","149","146","3"
"1967","Stanford (CA)","5","5","0","0.50000","157","179","-22"
"1968","Stanford (CA)","6","3","1","0.65000","268","162","106"
"1969","Stanford (CA)","7","2","1","0.75000","349","172","177"
"1970","Stanford (CA)","9","3","0","0.75000","343","206","137"
"1971","Stanford (CA)","9","3","0","0.75000","261","135","126"
"1993","San Jose St. (CA)","2","9","0","0.18182","282","337","-55"
"1994","San Jose St. (CA)","3","8","0","0.27273","200","377","-177"
"1995","San Jose St. (CA)","3","8","0","0.27273","271","378","-107"
"1996","San Jose St. (CA)","3","9","0","0.25000","221","448","-227"
"1997","San Jose St. (CA)","4","7","0","0.36364","225","387","-162"
"1998","San Jose St. (CA)","4","8","0","0.33333","274","385","-111"
"1999","San Jose St. (CA)","3","7","0","0.30000","258","402","-144"
"2000","San Jose St. (CA)","7","5","0","0.58333","374","357","17"
"2001","San Jose St. (CA)","3","9","0","0.25000","295","461","-166"
"2002","San Jose St. (CA)","6","7","0","0.46154","376","467","-91"
"2003","San Jose St. (CA)","3","8","0","0.27273","259","386","-127"
"2004","San Jose St. (CA)","2","9","0","0.18182","312","469","-157"
"1977","Hawaii","5","6","0","0.45455","250","233","17"
"1978","Hawaii","6","5","0","0.54545","251","280","-29"
"1979","Hawaii","6","5","0","0.54545","330","213","117"
"1980","Hawaii","8","3","0","0.72727","260","212","48"
"1981","Hawaii","9","2","0","0.81818","328","130","198"
"1982","Hawaii","6","5","0","0.54545","240","230","10"
"1983","Hawaii","5","5","1","0.50000","251","236","15"
"1984","Hawaii","7","4","0","0.63636","217","181","36"
"1985","Hawaii","4","6","2","0.41667","269","262","7"
"1986","Hawaii","7","5","0","0.58333","238","235","3"
"1987","Arizona","4","4","3","0.50000","263","220","43"
"1988","Arizona","7","4","0","0.63636","279","218","61"
"1989","Arizona","8","4","0","0.66667","248","178","70"
"1990","Arizona","7","5","0","0.58333","267","311","-44"
"1991","Arizona","4","7","0","0.36364","248","361","-113"
"1992","Arizona","6","5","1","0.54167","232","118","114"
"1993","Arizona","10","2","0","0.83333","294","161","133"
"1994","Arizona","8","4","0","0.66667","278","190","88"
"1995","Arizona","6","5","0","0.54545","207","199","8"
"1996","Arizona","5","6","0","0.45455","310","280","30"
"1997","Arizona","7","5","0","0.58333","317","312","5"
"1998","Arizona","12","1","0","0.92308","439","236","203"
"1999","Arizona","6","6","0","0.50000","339","364","-25"
"2000","Arizona","5","6","0","0.45455","254","237","17"
"2005","San Jose St. (CA)","3","8","0","0.27273","248","357","-109"
"2006","San Jose St. (CA)","9","4","0","0.69231","324","270","54"
"2007","San Jose St. (CA)","5","7","0","0.41667","245","352","-107"
"2008","San Jose St. (CA)","6","6","0","0.50000","224","259","-35"
"2009","San Jose St. (CA)","2","10","0","0.16667","165","414","-249"
"2010","San Jose St. (CA)","1","12","0","0.07692","209","451","-242"
"2011","San Jose St. (CA)","5","7","0","0.41667","294","364","-70"
"2012","San Jose St. (CA)","10","2","0","0.83333","423","257","166"
"2013","Colorado","4","8","0","0.33333","305","459","-154"
"2004","Notre Dame (IN)","0","1","0","0.00000","21","38","-17"
"2012","San Jose St. (CA)","1","0","0","1.00000","29","20","9"
"2007","San Diego (CA)","9","2","0","0.81818","488","287","201"
"2008","San Diego (CA)","9","2","0","0.81818","388","208","180"
"2009","San Diego (CA)","4","7","0","0.36364","241","239","2"
"2010","San Diego (CA)","5","6","0","0.45455","237","241","-4"
"2011","San Diego (CA)","9","2","0","0.81818","342","260","82"
"2012","San Diego (CA)","8","3","0","0.72727","323","212","111"
"2013","San Jose St. (CA)","6","6","0","0.50000","389","421","-32"
"2007","Birmingham-Southern (AL)","3","7","0","0.30000","227","298","-71"
"2009","South Alabama","7","0","0","1.00000","321","41","280"
"2010","South Alabama","10","0","0","1.00000","413","130","283"
"2011","South Alabama","6","4","0","0.60000","244","217","27"
"2012","South Alabama","2","11","0","0.15385","240","383","-143"
"2013","South Alabama","6","6","0","0.50000","353","302","51"
"1869","Rutgers (NJ)","2","2","0","0.50000","18","18","0"
"1870","Rutgers (NJ)","2","2","0","0.50000","17","17","0"
"1872","Columbia (NY)","5","4","0","0.55556","22","16","6"
"1873","Rutgers (NJ)","7","4","1","0.62500","31","26","5"
"1874","Harvard (MA)","9","7","0","0.56250","54","41","13"
"1875","Harvard (MA)","12","6","2","0.65000","52","29","23"
"1876","Harvard (MA)","13","8","1","0.61364","45","29","16"
"1877","Harvard (MA)","9","7","3","0.55263","31","21","10"
"1878","Pennsylvania","14","9","5","0.58929","42","24","18"
"1879","Harvard (MA)","13","9","12","0.55882","46","27","19"
"1880","Harvard (MA)","18","11","4","0.60606","75","53","22"
"1881","Rutgers (NJ)","22","18","8","0.54167","70","47","23"
"1882","Rutgers (NJ)","41","28","2","0.59155","176","111","65"
"1883","Rutgers (NJ)","38","32","1","0.54225","1288","965","323"
"1884","Pennsylvania","47","29","5","0.61111","1728","1184","544"
"1885","Michigan","34","17","4","0.65455","1437","612","825"
"1886","Lehigh (PA)","48","21","4","0.68493","1850","637","1213"
"1887","California","67","35","3","0.65238","2660","935","1725"
"1888","Princeton (NJ)","70","56","6","0.55303","2468","1899","569"
"1889","Brown (RI)","82","51","11","0.60764","2879","1796","1083"
"1890","Brown (RI)","77","76","9","0.50309","3002","2455","547"
"1891","Southern California","94","76","13","0.54918","2813","2189","624"
"1892","Minnesota","93","80","9","0.53571","2972","2394","578"
"1893","Duke (NC)","79","94","9","0.45879","2176","2912","-736"
"1894","Colorado St.","50","62","4","0.44828","1161","1518","-357"
"1895","Boston (MA)","31","44","11","0.42442","692","1031","-339"
"1896","Rhode Island","54","62","12","0.46875","1126","1201","-75"
"1897","Boston (MA)","32","40","6","0.44872","792","785","7"
"1898","Miami (OH)","47","23","4","0.66216","921","644","277"
"1899","New Hampshire","33","32","6","0.50704","571","522","49"
"1900","New Hampshire","22","35","11","0.40441","442","686","-244"
"1901","Marshall (WV)","18","34","3","0.35455","302","917","-615"
"1902","Saint John's (MN)","9","22","4","0.31429","148","460","-312"
"1903","Wichita St. (KS)","14","25","2","0.36585","376","546","-170"
"1904","Oklahoma St.","11","14","1","0.44231","194","394","-200"
"1905","Miami (OH)","7","25","5","0.25676","245","494","-249"
"1906","Rensselaer Tech (NY)","3","7","4","0.35714","92","107","-15"
"1907","Marshall (WV)","5","10","2","0.35294","71","238","-167"
"1908","Fort Hays St. (KS)","5","6","1","0.45833","56","91","-35"
"1909","Fort Hays St. (KS)","1","3","1","0.30000","12","68","-56"
"1910","Texas St.","0","1","0","0.00000","0","19","-19"
"1912","Fort Hays St. (KS)","1","2","0","0.33333","20","132","-112"
"1913","Eureka (IL)","1","6","0","0.14286","39","203","-164"
"1914","Eureka (IL)","3","4","0","0.42857","57","201","-144"
"1915","Texas St.","1","1","1","0.50000","13","20","-7"
"1916","Texas St.","0","2","1","0.16667","0","106","-106"
"1917","Boston (MA)","4","4","0","0.50000","73","136","-63"
"1918","Monmouth (IL)","1","7","0","0.12500","26","137","-111"
"1930","Troy (AL)","1","2","0","0.33333","7","73","-66"
"2013","Grambling St. (LA)","0","1","0","0.00000","0","0","0"
"1896","South Carolina","1","3","0","0.25000","20","30","-10"
"1897","South Carolina","0","3","0","0.00000","6","30","-24"
"1895","Wofford (SC)","3","1","0","0.75000","66","34","32"
"1897","Richmond (VA)","3","5","0","0.37500","40","146","-106"
"1898","South Carolina","1","2","0","0.33333","16","35","-19"
"1899","South Carolina","2","3","0","0.40000","22","62","-40"
"1900","South Carolina","4","3","0","0.57143","66","66","0"
"1901","South Carolina","3","4","0","0.42857","85","52","33"
"1906","Lehigh (PA)","5","5","1","0.50000","108","150","-42"
"1907","Lehigh (PA)","7","2","1","0.75000","198","45","153"
"1908","Lehigh (PA)","4","3","0","0.57143","45","50","-5"
"1909","Lehigh (PA)","4","3","2","0.55556","83","79","4"
"1910","Bucknell (PA)","2","6","0","0.25000","48","137","-89"
"1911","Bucknell (PA)","6","3","1","0.65000","89","38","51"
"1912","Bucknell (PA)","6","3","1","0.65000","207","64","143"
"1913","Bucknell (PA)","6","4","0","0.60000","198","172","26"
"1919","Franklin & Marshall (PA)","2","4","2","0.37500","48","40","8"
"1902","South Carolina","6","1","0","0.85714","195","16","179"
"1903","South Carolina","8","2","0","0.80000","239","35","204"
"1904","Davidson (NC)","6","1","1","0.81250","115","8","107"
"1905","Davidson (NC)","3","3","0","0.50000","93","28","65"
"1906","Clemson (SC)","4","0","3","0.78571","38","4","34"
"1907","Virginia Tech","7","2","0","0.77778","157","30","127"
"1909","Clemson (SC)","6","3","0","0.66667","93","43","50"
"1913","Clemson (SC)","4","4","0","0.50000","112","98","14"
"1914","Clemson (SC)","6","3","1","0.65000","197","123","74"
"1915","Clemson (SC)","2","4","2","0.37500","113","48","65"
"1904","South Carolina","4","3","1","0.56250","61","43","18"
"1905","South Carolina","4","2","1","0.64286","91","78","13"
"1908","South Carolina","3","5","1","0.38889","64","103","-39"
"1909","South Carolina","2","6","0","0.25000","36","128","-92"
"1907","South Carolina","3","0","0","1.00000","30","4","26"
"1909","Virginia","7","1","0","0.87500","155","11","144"
"1910","South Carolina","4","4","0","0.50000","67","109","-42"
"1911","South Carolina","1","4","2","0.28571","22","102","-80"
"1912","South Carolina","5","2","1","0.68750","204","47","157"
"1913","South Carolina","4","3","0","0.57143","95","122","-27"
"1914","South Carolina","5","5","1","0.50000","168","191","-23"
"1915","South Carolina","5","3","1","0.61111","190","93","97"
"1916","South Carolina","2","7","0","0.22222","85","168","-83"
"1917","South Carolina","3","5","0","0.37500","137","96","41"
"1919","South Carolina","1","7","1","0.16667","25","105","-80"
"1910","Clemson (SC)","4","3","1","0.56250","106","54","52"
"1911","Clemson (SC)","3","5","0","0.37500","70","109","-39"
"1912","Clemson (SC)","4","4","0","0.50000","177","126","51"
"1913","Richmond (VA)","5","3","1","0.61111","102","138","-36"
"1914","Richmond (VA)","5","4","0","0.55556","114","152","-38"
"1915","Richmond (VA)","4","4","1","0.50000","109","122","-13"
"1916","Richmond (VA)","5","4","2","0.54545","130","91","39"
"1917","Richmond (VA)","4","2","1","0.64286","161","55","106"
"1918","South Carolina","2","1","1","0.62500","33","51","-18"
"1919","Richmond (VA)","5","2","2","0.66667","94","35","59"
"1920","Richmond (VA)","6","2","0","0.75000","160","49","111"
"1921","Richmond (VA)","4","3","1","0.56250","140","76","64"
"1922","Richmond (VA)","6","2","1","0.72222","160","64","96"
"1923","Richmond (VA)","3","5","0","0.37500","39","149","-110"
"1924","Richmond (VA)","2","6","1","0.27778","40","123","-83"
"1925","Richmond (VA)","3","6","0","0.33333","41","81","-40"
"1926","Richmond (VA)","2","7","0","0.22222","54","100","-46"
"1927","Richmond (VA)","4","4","1","0.50000","50","168","-118"
"1928","Richmond (VA)","3","4","2","0.44444","146","76","70"
"1929","Richmond (VA)","3","5","1","0.38889","63","142","-79"
"1930","Richmond (VA)","2","4","2","0.37500","45","57","-12"
"1931","Richmond (VA)","4","5","0","0.44444","48","99","-51"
"1932","Richmond (VA)","4","2","2","0.62500","44","49","-5"
"1933","Richmond (VA)","5","4","0","0.55556","100","55","45"
"1936","Maryland","6","5","0","0.54545","117","59","58"
"1937","Maryland","8","2","0","0.80000","127","65","62"
"1938","Maryland","2","7","0","0.22222","86","235","-149"
"1939","Maryland","2","7","0","0.22222","64","106","-42"
"1904","Baylor (TX)","2","5","1","0.31250","34","106","-72"
"1908","Pennsylvania","11","0","1","0.95833","215","28","187"
"1909","Oregon St.","4","2","1","0.64286","54","41","13"
"1914","West Virginia","5","4","0","0.55556","159","96","63"
"1915","West Virginia","5","2","1","0.68750","208","20","188"
"1920","South Carolina","5","4","0","0.55556","82","140","-58"
"1921","South Carolina","5","1","2","0.75000","116","28","88"
"1922","South Carolina","5","4","0","0.55556","93","69","24"
"1923","South Carolina","4","6","0","0.40000","104","77","27"
"1924","South Carolina","7","3","0","0.70000","120","48","72"
"1908","Georgia","5","2","1","0.68750","71","45","26"
"1909","Virginia Tech","6","1","0","0.85714","148","27","121"
"1910","Virginia Tech","6","2","0","0.75000","109","18","91"
"1911","North Carolina","6","1","1","0.81250","66","31","35"
"1912","Virginia Tech","5","4","0","0.55556","202","92","110"
"1913","Virginia Tech","7","1","1","0.83333","175","60","115"
"1914","Virginia Tech","6","2","1","0.72222","143","33","110"
"1915","Virginia Tech","4","4","0","0.50000","91","109","-18"
"1920","Louisiana St.","5","3","1","0.61111","206","63","143"
"1921","Louisiana St.","6","1","1","0.81250","180","56","124"
"1925","South Carolina","7","3","0","0.70000","150","27","123"
"1926","South Carolina","6","4","0","0.60000","159","62","97"
"1928","William & Mary (VA)","6","3","2","0.63636","218","54","164"
"1929","William & Mary (VA)","8","2","0","0.80000","250","77","173"
"1930","William & Mary (VA)","7","2","1","0.75000","247","39","208"
"1936","William & Mary (VA)","1","8","0","0.11111","51","112","-61"
"1937","William & Mary (VA)","4","5","0","0.44444","129","103","26"
"1938","William & Mary (VA)","3","7","0","0.30000","105","154","-49"
"1927","South Carolina","4","5","0","0.44444","46","172","-126"
"1916","Furman (SC)","4","5","0","0.44444","164","180","-16"
"1917","Furman (SC)","3","5","0","0.37500","59","147","-88"
"1918","Furman (SC)","3","5","1","0.38889","92","244","-152"
"1919","Furman (SC)","6","2","1","0.72222","148","141","7"
"1920","Furman (SC)","9","1","0","0.90000","286","16","270"
"1921","Furman (SC)","7","2","1","0.75000","288","103","185"
"1922","Furman (SC)","8","3","0","0.72727","242","65","177"
"1923","Furman (SC)","9","2","0","0.81818","274","47","227"
"1924","Furman (SC)","5","5","0","0.50000","40","94","-54"
"1925","Furman (SC)","7","3","0","0.70000","116","75","41"
"1926","Furman (SC)","8","1","1","0.85000","169","46","123"
"1927","Furman (SC)","10","1","0","0.90909","285","59","226"
"1928","South Carolina","6","2","2","0.70000","96","70","26"
"1929","South Carolina","6","5","0","0.54545","163","174","-11"
"1930","South Carolina","6","4","0","0.60000","108","123","-15"
"1931","South Carolina","5","4","1","0.55000","146","79","67"
"1932","South Carolina","5","4","2","0.54545","93","68","25"
"1933","South Carolina","6","3","1","0.65000","111","91","20"
"1934","South Carolina","5","4","0","0.55556","96","71","25"
"1935","South Carolina","3","7","0","0.30000","73","187","-114"
"1936","South Carolina","5","7","0","0.41667","100","139","-39"
"1937","South Carolina","5","6","1","0.45833","192","166","26"
"1938","South Carolina","6","4","1","0.59091","168","86","82"
"1939","South Carolina","3","6","1","0.35000","40","163","-123"
"1940","South Carolina","3","6","0","0.33333","107","146","-39"
"1941","South Carolina","4","4","1","0.50000","100","103","-3"
"1942","South Carolina","1","7","1","0.16667","46","130","-84"
"1946","South Carolina","5","3","0","0.62500","107","133","-26"
"1947","South Carolina","6","2","1","0.72222","113","85","28"
"1948","South Carolina","3","5","0","0.37500","106","126","-20"
"1949","South Carolina","4","6","0","0.40000","145","168","-23"
"1950","South Carolina","3","4","2","0.44444","110","114","-4"
"1951","South Carolina","5","4","0","0.55556","175","135","40"
"1952","South Carolina","5","5","0","0.50000","175","161","14"
"1953","South Carolina","7","3","0","0.70000","198","97","101"
"1954","South Carolina","6","4","0","0.60000","172","153","19"
"1955","South Carolina","3","6","0","0.33333","120","209","-89"
"1943","South Carolina","5","2","0","0.71429","118","56","62"
"1932","Davidson (NC)","4","4","1","0.50000","82","52","30"
"1933","Davidson (NC)","6","2","1","0.72222","109","70","39"
"1934","Davidson (NC)","4","4","1","0.50000","105","123","-18"
"1935","Davidson (NC)","4","3","2","0.55556","69","80","-11"
"1937","North Carolina St.","5","3","1","0.61111","91","92","-1"
"1938","North Carolina St.","3","7","1","0.31818","59","100","-41"
"1939","North Carolina St.","2","8","0","0.20000","49","191","-142"
"1940","North Carolina St.","3","6","0","0.33333","120","161","-41"
"1941","North Carolina St.","4","5","2","0.45455","122","143","-21"
"1942","North Carolina St.","4","4","2","0.50000","70","142","-72"
"1943","North Carolina St.","3","6","0","0.33333","78","227","-149"
"1944","South Carolina","3","4","2","0.44444","135","106","29"
"1945","South Carolina","2","4","3","0.38889","113","192","-79"
"1953","Citadel (SC)","2","7","0","0.22222","77","264","-187"
"1954","Citadel (SC)","2","8","0","0.20000","94","256","-162"
"1956","South Carolina","7","3","0","0.70000","126","67","59"
"1957","South Carolina","5","5","0","0.50000","202","147","55"
"1958","South Carolina","7","3","0","0.70000","168","116","52"
"1959","South Carolina","6","4","0","0.60000","170","169","1"
"1960","South Carolina","3","6","1","0.35000","117","186","-69"
"1951","William & Mary (VA)","7","3","0","0.70000","172","220","-48"
"1961","South Carolina","4","6","0","0.40000","128","187","-59"
"1962","South Carolina","4","5","1","0.45000","187","148","39"
"1963","South Carolina","1","8","1","0.15000","104","170","-66"
"1964","South Carolina","3","5","2","0.40000","95","176","-81"
"1965","South Carolina","5","5","0","0.50000","151","167","-16"
"1955","Louisiana St.","3","5","2","0.40000","139","149","-10"
"1956","Louisiana St.","3","7","0","0.30000","104","197","-93"
"1957","Louisiana St.","5","5","0","0.50000","159","110","49"
"1958","Louisiana St.","11","0","0","1.00000","282","53","229"
"1959","Louisiana St.","9","2","0","0.81818","164","50","114"
"1960","Louisiana St.","5","4","1","0.55000","105","50","55"
"1961","Louisiana St.","10","1","0","0.90909","259","57","202"
"1962","Army (NY)","6","4","0","0.60000","152","104","48"
"1963","Army (NY)","7","3","0","0.70000","177","97","80"
"1964","Army (NY)","4","6","0","0.40000","118","143","-25"
"1965","Army (NY)","4","5","1","0.45000","119","132","-13"
"1966","South Carolina","1","9","0","0.10000","95","216","-121"
"1967","South Carolina","5","5","0","0.50000","159","166","-7"
"1968","South Carolina","4","6","0","0.40000","214","223","-9"
"1969","South Carolina","7","4","0","0.63636","189","195","-6"
"1970","South Carolina","4","6","1","0.40909","285","253","32"
"1971","South Carolina","6","5","0","0.54545","191","196","-5"
"1972","South Carolina","4","7","0","0.36364","214","232","-18"
"1973","South Carolina","7","4","0","0.63636","347","261","86"
"1974","South Carolina","4","7","0","0.36364","223","312","-89"
"1966","West Virginia","3","5","2","0.40000","158","197","-39"
"1967","West Virginia","5","4","1","0.55000","188","117","71"
"1968","West Virginia","7","3","0","0.70000","207","141","66"
"1969","West Virginia","10","1","0","0.90909","302","113","189"
"1970","Texas Tech","8","4","0","0.66667","222","165","57"
"1971","Texas Tech","4","7","0","0.36364","131","138","-7"
"1972","Texas Tech","8","4","0","0.66667","282","188","94"
"1973","Texas Tech","11","1","0","0.91667","342","187","155"
"1974","Texas Tech","6","4","2","0.58333","193","158","35"
"1975","South Carolina","7","5","0","0.58333","328","274","54"
"1976","South Carolina","6","5","0","0.54545","195","143","52"
"1977","South Carolina","5","7","0","0.41667","215","202","13"
"1978","South Carolina","5","5","1","0.50000","238","181","57"
"1979","South Carolina","8","4","0","0.66667","246","205","41"
"1980","South Carolina","8","4","0","0.66667","348","200","148"
"1981","South Carolina","6","6","0","0.50000","225","222","3"
"1982","South Carolina","4","7","0","0.36364","224","259","-35"
"1973","Tennessee-Chattanooga","4","7","0","0.36364","131","241","-110"
"1974","Tennessee-Chattanooga","4","7","0","0.36364","181","252","-71"
"1975","Tennessee-Chattanooga","5","5","1","0.50000","176","195","-19"
"1976","Tennessee-Chattanooga","6","4","1","0.59091","232","205","27"
"1977","Tennessee-Chattanooga","9","1","1","0.86364","265","167","98"
"1978","Tennessee-Chattanooga","7","3","1","0.68182","306","192","114"
"1979","Tennessee-Chattanooga","9","2","0","0.81818","349","217","132"
"1980","New Mexico","4","7","0","0.36364","246","364","-118"
"1981","New Mexico","4","7","1","0.37500","225","231","-6"
"1982","New Mexico","10","1","0","0.90909","374","225","149"
"1983","South Carolina","5","6","0","0.45455","231","237","-6"
"1984","South Carolina","10","2","0","0.83333","371","258","113"
"1985","South Carolina","5","6","0","0.45455","269","290","-21"
"1986","South Carolina","3","6","2","0.36364","313","286","27"
"1987","South Carolina","8","4","0","0.66667","341","141","200"
"1988","South Carolina","8","4","0","0.66667","232","224","8"
"1984","Appalachian St. (NC)","4","7","0","0.36364","151","218","-67"
"1985","Appalachian St. (NC)","8","3","0","0.72727","260","109","151"
"1986","Appalachian St. (NC)","9","2","1","0.79167","351","176","175"
"1987","Appalachian St. (NC)","11","3","0","0.78571","270","153","117"
"1988","Appalachian St. (NC)","6","4","1","0.59091","324","233","91"
"1989","South Carolina","6","4","1","0.59091","228","250","-22"
"1990","South Carolina","6","5","0","0.54545","282","237","45"
"1991","South Carolina","3","6","2","0.36364","250","268","-18"
"1992","South Carolina","5","6","0","0.45455","160","240","-80"
"1993","South Carolina","5","6","0","0.45455","188","214","-26"
"2008","Virginia Military Institute","4","7","0","0.36364","378","369","9"
"2009","Virginia Military Institute","2","9","0","0.18182","225","338","-113"
"2010","Virginia Military Institute","3","8","0","0.27273","174","311","-137"
"2011","Virginia Military Institute","2","9","0","0.18182","187","351","-164"
"2012","Virginia Military Institute","2","9","0","0.18182","133","338","-205"
"2013","Virginia Military Institute","2","10","0","0.16667","235","416","-181"
"1994","South Carolina","7","5","0","0.58333","300","276","24"
"1995","South Carolina","4","6","1","0.40909","401","393","8"
"1996","South Carolina","6","5","0","0.54545","245","238","7"
"1997","South Carolina","5","6","0","0.45455","258","279","-21"
"1998","South Carolina","1","10","0","0.09091","207","330","-123"
"1969","William & Mary (VA)","3","7","0","0.30000","146","250","-104"
"1970","William & Mary (VA)","5","7","0","0.41667","218","335","-117"
"1971","William & Mary (VA)","5","6","0","0.45455","278","241","37"
"1972","North Carolina St.","8","3","1","0.70833","409","240","169"
"1973","North Carolina St.","9","3","0","0.75000","396","251","145"
"1974","North Carolina St.","9","2","1","0.79167","317","241","76"
"1975","North Carolina St.","7","4","1","0.62500","260","210","50"
"1977","Arkansas","11","1","0","0.91667","389","101","288"
"1978","Arkansas","9","2","1","0.79167","336","147","189"
"1979","Arkansas","10","2","0","0.83333","284","132","152"
"1980","Arkansas","7","5","0","0.58333","272","236","36"
"1981","Arkansas","8","4","0","0.66667","325","219","106"
"1982","Arkansas","9","2","1","0.79167","303","139","164"
"1983","Arkansas","6","5","0","0.54545","204","172","32"
"1984","Minnesota","4","7","0","0.36364","194","316","-122"
"1985","Minnesota","6","5","0","0.54545","273","227","46"
"1986","Notre Dame (IN)","5","6","0","0.45455","299","219","80"
"1987","Notre Dame (IN)","8","4","0","0.66667","339","218","121"
"1988","Notre Dame (IN)","12","0","0","1.00000","393","156","237"
"1989","Notre Dame (IN)","12","1","0","0.92308","427","189","238"
"1990","Notre Dame (IN)","9","3","0","0.75000","359","259","100"
"1991","Notre Dame (IN)","10","3","0","0.76923","465","289","176"
"1992","Notre Dame (IN)","10","1","1","0.87500","437","181","256"
"1993","Notre Dame (IN)","11","1","0","0.91667","427","215","212"
"1994","Notre Dame (IN)","6","5","1","0.54167","342","280","62"
"1995","Notre Dame (IN)","9","3","0","0.75000","392","247","145"
"1996","Notre Dame (IN)","8","3","0","0.72727","407","181","226"
"1999","South Carolina","0","11","0","0.00000","87","278","-191"
"2000","South Carolina","8","4","0","0.66667","283","181","102"
"2001","South Carolina","9","3","0","0.75000","310","230","80"
"2002","South Carolina","5","7","0","0.41667","225","262","-37"
"2003","South Carolina","5","7","0","0.41667","268","314","-46"
"2004","South Carolina","6","5","0","0.54545","243","229","14"
"1987","Duke (NC)","5","6","0","0.45455","301","243","58"
"1988","Duke (NC)","7","3","1","0.68182","324","324","0"
"1989","Duke (NC)","8","4","0","0.66667","377","335","42"
"1990","Florida","9","2","0","0.81818","387","171","216"
"1991","Florida","10","2","0","0.83333","389","191","198"
"1992","Florida","9","4","0","0.69231","315","284","31"
"1993","Florida","11","2","0","0.84615","513","244","269"
"1994","Florida","10","2","1","0.80769","538","228","310"
"1995","Florida","12","1","0","0.92308","558","263","295"
"1996","Florida","12","1","0","0.92308","611","221","390"
"1997","Florida","10","2","0","0.83333","430","205","225"
"1998","Florida","10","2","0","0.83333","380","165","215"
"1999","Florida","9","4","0","0.69231","403","272","131"
"2000","Florida","10","3","0","0.76923","468","273","195"
"2001","Florida","10","2","0","0.83333","538","178","360"
"2005","South Carolina","7","5","0","0.58333","284","279","5"
"2006","South Carolina","8","5","0","0.61538","346","243","103"
"2007","South Carolina","6","6","0","0.50000","313","282","31"
"2008","South Carolina","7","6","0","0.53846","270","274","-4"
"2009","South Carolina","7","6","0","0.53846","268","265","3"
"2010","South Carolina","9","5","0","0.64286","433","324","109"
"2011","South Carolina","11","2","0","0.84615","391","239","152"
"2012","South Carolina","11","2","0","0.84615","410","237","173"
"2013","South Carolina","11","2","0","0.84615","443","264","179"
"1997","South Florida","5","6","0","0.45455","307","181","126"
"1998","South Florida","8","3","0","0.72727","402","178","224"
"1999","South Florida","7","4","0","0.63636","246","248","-2"
"2000","South Florida","7","4","0","0.63636","278","201","77"
"2001","South Florida","8","3","0","0.72727","387","231","156"
"2002","South Florida","9","2","0","0.81818","339","204","135"
"2003","South Florida","7","4","0","0.63636","276","224","52"
"2004","South Florida","4","7","0","0.36364","271","351","-80"
"2005","South Florida","6","6","0","0.50000","276","216","60"
"2006","South Florida","9","4","0","0.69231","299","220","79"
"2007","South Florida","9","4","0","0.69231","451","304","147"
"2008","South Florida","8","5","0","0.61538","359","260","99"
"2009","South Florida","8","5","0","0.61538","344","257","87"
"1994","Connecticut","4","7","0","0.36364","240","264","-24"
"1995","Connecticut","8","3","0","0.72727","279","200","79"
"1996","Connecticut","4","6","0","0.40000","244","191","53"
"1997","Connecticut","7","4","0","0.63636","398","246","152"
"1998","Connecticut","10","3","0","0.76923","461","413","48"
"2005","East Carolina (NC)","5","6","0","0.45455","267","317","-50"
"2006","East Carolina (NC)","7","6","0","0.53846","280","270","10"
"2007","East Carolina (NC)","8","5","0","0.61538","403","395","8"
"2008","East Carolina (NC)","9","5","0","0.64286","328","295","33"
"2009","East Carolina (NC)","9","5","0","0.64286","378","307","71"
"2010","South Florida","8","5","0","0.61538","313","260","53"
"2011","South Florida","5","7","0","0.41667","351","272","79"
"2012","South Florida","3","9","0","0.25000","247","329","-82"
"2013","Louisiana Tech","4","8","0","0.33333","230","315","-85"
"2010","Western Kentucky","2","10","0","0.16667","274","398","-124"
"2011","Western Kentucky","7","5","0","0.58333","275","298","-23"
"2012","Western Kentucky","7","5","0","0.58333","345","307","38"
"2013","South Florida","2","10","0","0.16667","165","343","-178"
"1888","Southern California","2","0","0","1.00000","20","0","20"
"1869","Rutgers (NJ)","2","2","0","0.50000","18","18","0"
"1870","Rutgers (NJ)","2","2","0","0.50000","17","17","0"
"1872","Columbia (NY)","5","4","0","0.55556","22","16","6"
"1873","Rutgers (NJ)","7","4","1","0.62500","31","26","5"
"1874","Harvard (MA)","9","7","0","0.56250","54","41","13"
"1875","Harvard (MA)","12","6","2","0.65000","52","29","23"
"1876","Harvard (MA)","13","8","1","0.61364","45","29","16"
"1877","Harvard (MA)","9","7","3","0.55263","31","21","10"
"1878","Pennsylvania","14","9","5","0.58929","42","24","18"
"1879","Harvard (MA)","13","9","12","0.55882","46","27","19"
"1880","Harvard (MA)","18","11","4","0.60606","75","53","22"
"1881","Rutgers (NJ)","22","18","8","0.54167","70","47","23"
"1882","Rutgers (NJ)","41","28","2","0.59155","176","111","65"
"1883","Rutgers (NJ)","38","32","1","0.54225","1288","965","323"
"1884","Pennsylvania","47","29","5","0.61111","1728","1184","544"
"1885","Michigan","34","17","4","0.65455","1437","612","825"
"1886","Lehigh (PA)","48","21","4","0.68493","1850","637","1213"
"1887","California","67","35","3","0.65238","2660","935","1725"
"1888","Princeton (NJ)","70","56","6","0.55303","2468","1899","569"
"1889","Brown (RI)","82","51","11","0.60764","2879","1796","1083"
"1890","Brown (RI)","77","76","9","0.50309","3002","2455","547"
"1891","Southern California","94","76","13","0.54918","2813","2189","624"
"1892","Minnesota","93","80","9","0.53571","2972","2394","578"
"1893","Duke (NC)","79","94","9","0.45879","2176","2912","-736"
"1894","Colorado St.","50","62","4","0.44828","1161","1518","-357"
"1895","Boston (MA)","31","44","11","0.42442","692","1031","-339"
"1896","Rhode Island","54","62","12","0.46875","1126","1201","-75"
"1897","Boston (MA)","32","40","6","0.44872","792","785","7"
"1898","Miami (OH)","47","23","4","0.66216","921","644","277"
"1899","New Hampshire","33","32","6","0.50704","571","522","49"
"1900","New Hampshire","22","35","11","0.40441","442","686","-244"
"1901","Marshall (WV)","18","34","3","0.35455","302","917","-615"
"1902","Saint John's (MN)","9","22","4","0.31429","148","460","-312"
"1903","Wichita St. (KS)","14","25","2","0.36585","376","546","-170"
"1904","Oklahoma St.","11","14","1","0.44231","194","394","-200"
"1905","Miami (OH)","7","25","5","0.25676","245","494","-249"
"1906","Rensselaer Tech (NY)","3","7","4","0.35714","92","107","-15"
"1907","Marshall (WV)","5","10","2","0.35294","71","238","-167"
"1908","Fort Hays St. (KS)","5","6","1","0.45833","56","91","-35"
"1909","Fort Hays St. (KS)","1","3","1","0.30000","12","68","-56"
"1910","Texas St.","0","1","0","0.00000","0","19","-19"
"1912","Fort Hays St. (KS)","1","2","0","0.33333","20","132","-112"
"1913","Eureka (IL)","1","6","0","0.14286","39","203","-164"
"1914","Eureka (IL)","3","4","0","0.42857","57","201","-144"
"1915","Texas St.","1","1","1","0.50000","13","20","-7"
"1916","Texas St.","0","2","1","0.16667","0","106","-106"
"1917","Boston (MA)","4","4","0","0.50000","73","136","-63"
"1918","Monmouth (IL)","1","7","0","0.12500","26","137","-111"
"1930","Troy (AL)","1","2","0","0.33333","7","73","-66"
"2013","Grambling St. (LA)","0","1","0","0.00000","0","0","0"
"1897","Southern California","5","1","0","0.83333","100","18","82"
"1901","Southern California","0","1","0","0.00000","0","6","-6"
"1903","Southern California","4","2","0","0.66667","58","27","31"
"1900","Utah","2","2","0","0.50000","57","27","30"
"1901","Utah","5","1","0","0.83333","111","6","105"
"1902","Utah","6","2","1","0.72222","162","51","111"
"1903","Utah","3","5","0","0.37500","126","87","39"
"1904","Southern California","6","1","0","0.85714","199","27","172"
"1905","Southern California","6","3","1","0.65000","211","45","166"
"1906","Southern California","2","0","2","0.75000","36","0","36"
"1907","Southern California","5","1","0","0.83333","182","20","162"
"1909","Idaho St.","5","0","0","1.00000","77","10","67"
"1910","Idaho St.","6","1","0","0.85714","183","67","116"
"1911","Idaho St.","5","4","0","0.55556","47","129","-82"
"1912","Idaho St.","1","2","0","0.33333","60","56","4"
"1913","Idaho St.","5","2","0","0.71429","191","31","160"
"1914","Idaho St.","6","1","0","0.85714","146","33","113"
"1908","Southern California","3","1","1","0.70000","63","18","45"
"1909","Southern California","3","1","2","0.66667","133","13","120"
"1910","Southern California","7","0","1","0.93750","189","24","165"
"1916","Southern California","5","3","0","0.62500","129","80","49"
"1917","Southern California","4","2","1","0.64286","127","47","80"
"1918","Southern California","2","2","2","0.50000","61","61","0"
"1910","Baylor (TX)","6","1","1","0.81250","217","17","200"
"1911","Baylor (TX)","3","4","2","0.44444","103","53","50"
"1912","Baylor (TX)","3","5","0","0.37500","79","123","-44"
"1914","Southern California","4","3","0","0.57143","116","88","28"
"1915","Southern California","3","4","0","0.42857","132","119","13"
"1916","Drake (IA)","3","5","0","0.37500","72","162","-90"
"1917","Northern Colorado","0","11","2","0.07692","44","290","-246"
"1918","Northern Colorado","2","1","0","0.66667","35","48","-13"
"1919","Colorado School of Mines","0","4","2","0.16667","15","89","-74"
"1920","Colorado School of Mines","0","6","0","0.00000","23","104","-81"
"1921","Lake Forest (IL)","4","4","0","0.50000","111","87","24"
"1922","Lake Forest (IL)","4","3","2","0.55556","94","88","6"
"1923","Lake Forest (IL)","2","6","1","0.27778","33","161","-128"
"1919","Southern California","4","1","0","0.80000","87","21","66"
"1920","Southern California","6","0","0","1.00000","170","21","149"
"1921","Southern California","10","1","0","0.90909","362","52","310"
"1922","Southern California","10","1","0","0.90909","236","31","205"
"1923","Southern California","6","2","0","0.75000","173","62","111"
"1924","Southern California","9","2","0","0.81818","269","44","225"
"1925","Tulsa (OK)","6","2","0","0.75000","128","91","37"
"1926","Tulsa (OK)","7","2","0","0.77778","169","56","113"
"1927","Tulsa (OK)","8","1","0","0.88889","206","84","122"
"1928","Tulsa (OK)","7","2","1","0.75000","273","80","193"
"1929","Tulsa (OK)","6","3","1","0.65000","107","81","26"
"1930","Tulsa (OK)","7","2","0","0.77778","171","79","92"
"1931","Tulsa (OK)","8","3","0","0.72727","256","55","201"
"1932","Tulsa (OK)","7","1","1","0.83333","175","36","139"
"1933","Tulsa (OK)","6","1","0","0.85714","93","19","74"
"1934","Tulsa (OK)","5","2","1","0.68750","106","39","67"
"1935","Tulsa (OK)","3","6","1","0.35000","58","94","-36"
"1908","Syracuse (NY)","6","3","1","0.65000","171","39","132"
"1909","Yale (CT)","10","0","0","1.00000","209","0","209"
"1910","Ohio St.","6","1","3","0.75000","182","27","155"
"1913","Yale (CT)","5","2","3","0.65000","126","34","92"
"1916","Iowa","4","3","0","0.57143","121","156","-35"
"1917","Iowa","3","6","0","0.33333","91","160","-69"
"1918","Iowa","6","2","1","0.72222","123","36","87"
"1919","Iowa","5","2","0","0.71429","90","44","46"
"1920","Iowa","5","2","0","0.71429","142","54","88"
"1921","Iowa","7","0","0","1.00000","185","36","149"
"1922","Iowa","7","0","0","1.00000","208","33","175"
"1923","Iowa","5","3","0","0.62500","124","55","69"
"1924","Duke (NC)","4","5","0","0.44444","129","99","30"
"1925","Southern California","11","2","0","0.84615","456","55","401"
"1926","Southern California","8","2","0","0.80000","317","52","265"
"1927","Southern California","8","1","1","0.85000","287","64","223"
"1928","Southern California","9","0","1","0.95000","267","59","208"
"1929","Southern California","10","2","0","0.83333","492","69","423"
"1930","Southern California","8","2","0","0.80000","382","66","316"
"1931","Southern California","10","1","0","0.90909","363","52","311"
"1932","Southern California","10","0","0","1.00000","201","13","188"
"1933","Southern California","10","1","1","0.87500","257","30","227"
"1934","Southern California","4","6","1","0.40909","120","110","10"
"1935","Southern California","5","7","0","0.41667","155","124","31"
"1936","Southern California","4","2","3","0.61111","129","65","64"
"1937","Southern California","4","4","2","0.50000","136","98","38"
"1938","Southern California","9","2","0","0.81818","172","65","107"
"1939","Southern California","8","0","2","0.90000","181","33","148"
"1940","Southern California","3","4","2","0.44444","88","98","-10"
"1941","Southern California","2","6","1","0.27778","64","134","-70"
"1929","Denver (CO)","5","1","1","0.78571","92","33","59"
"1930","Denver (CO)","5","4","0","0.55556","140","148","-8"
"1931","Denver (CO)","4","6","0","0.40000","104","143","-39"
"1941","San Francisco (CA)","6","4","0","0.60000","193","206","-13"
"1942","Southern California","5","5","1","0.50000","184","128","56"
"1943","Southern California","8","2","0","0.80000","155","58","97"
"1944","Southern California","8","0","2","0.90000","240","73","167"
"1945","Southern California","7","4","0","0.63636","205","150","55"
"1946","Southern California","6","4","0","0.60000","158","106","52"
"1947","Southern California","7","2","1","0.75000","193","114","79"
"1948","Southern California","6","3","1","0.65000","142","87","55"
"1949","Southern California","5","3","1","0.61111","214","170","44"
"1950","Southern California","2","5","2","0.33333","114","182","-68"
"1951","Southern California","7","3","0","0.70000","224","168","56"
"1952","Southern California","10","1","0","0.90909","254","47","207"
"1953","Southern California","6","3","1","0.65000","199","161","38"
"1954","Southern California","8","4","0","0.66667","258","159","99"
"1955","Southern California","6","4","0","0.60000","265","158","107"
"1956","Southern California","8","2","0","0.80000","218","126","92"
"1957","Southern California","1","9","0","0.10000","86","204","-118"
"1958","Southern California","4","5","1","0.45000","151","120","31"
"1959","Southern California","8","2","0","0.80000","195","90","105"
"1960","Southern California","4","6","0","0.40000","95","152","-57"
"1961","Southern California","4","5","1","0.45000","150","167","-17"
"1962","Southern California","11","0","0","1.00000","261","92","169"
"1963","Southern California","7","3","0","0.70000","207","114","93"
"1964","Southern California","7","3","0","0.70000","207","130","77"
"1965","Southern California","7","2","1","0.75000","262","92","170"
"1966","Southern California","7","4","0","0.63636","199","128","71"
"1967","Southern California","10","1","0","0.90909","258","87","171"
"1968","Southern California","9","1","1","0.86364","259","168","91"
"1969","Southern California","10","0","1","0.95455","261","128","133"
"1970","Southern California","6","4","1","0.59091","343","233","110"
"1971","Southern California","6","4","1","0.59091","229","164","65"
"1972","Southern California","12","0","0","1.00000","467","134","333"
"1973","Southern California","9","2","1","0.79167","322","202","120"
"1974","Southern California","10","1","1","0.87500","363","142","221"
"1975","Southern California","8","4","0","0.66667","247","140","107"
"1976","Southern California","11","1","0","0.91667","386","139","247"
"1977","Southern California","8","4","0","0.66667","357","212","145"
"1978","Southern California","12","1","0","0.92308","318","153","165"
"1979","Southern California","11","0","1","0.95833","389","171","218"
"1980","Southern California","8","2","1","0.77273","265","134","131"
"1981","Southern California","9","3","0","0.75000","294","170","124"
"1982","Southern California","8","3","0","0.72727","302","143","159"
"1993","Southern California","8","5","0","0.61538","348","252","96"
"1994","Southern California","8","3","1","0.70833","356","243","113"
"1995","Southern California","9","2","1","0.79167","355","212","143"
"1996","Southern California","6","6","0","0.50000","325","267","58"
"1997","Southern California","6","5","0","0.54545","233","233","0"
"1999","Nevada-Las Vegas","3","8","0","0.27273","160","324","-164"
"2000","Nevada-Las Vegas","8","5","0","0.61538","370","275","95"
"2001","Nevada-Las Vegas","4","7","0","0.36364","284","270","14"
"2002","Nevada-Las Vegas","5","7","0","0.41667","292","366","-74"
"2003","Nevada-Las Vegas","6","6","0","0.50000","256","272","-16"
"2004","Nevada-Las Vegas","2","9","0","0.18182","229","357","-128"
"1983","Southern California","4","6","1","0.40909","210","238","-28"
"1984","Southern California","9","3","0","0.75000","220","173","47"
"1985","Southern California","6","6","0","0.50000","223","187","36"
"1986","Southern California","7","5","0","0.58333","264","239","25"
"1994","San Diego St. (CA)","4","7","0","0.36364","332","339","-7"
"1995","San Diego St. (CA)","8","4","0","0.66667","401","283","118"
"1996","San Diego St. (CA)","8","3","0","0.72727","428","303","125"
"1997","San Diego St. (CA)","5","7","0","0.41667","257","333","-76"
"1998","San Diego St. (CA)","7","5","0","0.58333","243","244","-1"
"1999","San Diego St. (CA)","5","6","0","0.45455","272","226","46"
"2000","San Diego St. (CA)","3","8","0","0.27273","170","273","-103"
"2001","San Diego St. (CA)","3","8","0","0.27273","184","290","-106"
"1976","Tulane (LA)","2","9","0","0.18182","149","228","-79"
"1977","Tulane (LA)","3","8","0","0.27273","181","289","-108"
"1978","Tulane (LA)","4","7","0","0.36364","183","211","-28"
"1979","Tulane (LA)","9","3","0","0.75000","320","179","141"
"1980","Arizona","5","6","0","0.45455","215","275","-60"
"1981","Arizona","6","5","0","0.54545","253","205","48"
"1982","Arizona","6","4","1","0.59091","311","219","92"
"1983","Arizona","7","3","1","0.68182","343","188","155"
"1984","Arizona","7","4","0","0.63636","272","192","80"
"1985","Arizona","8","3","1","0.70833","252","146","106"
"1986","Arizona","9","3","0","0.75000","352","204","148"
"1987","Southern California","8","4","0","0.66667","321","229","92"
"1988","Southern California","10","2","0","0.83333","370","184","186"
"1989","Southern California","9","2","1","0.79167","336","132","204"
"1990","Southern California","8","4","1","0.65385","348","274","74"
"1991","Southern California","3","8","0","0.27273","229","276","-47"
"1992","Southern California","6","5","1","0.54167","264","249","15"
"1994","Missouri","3","8","1","0.29167","208","325","-117"
"1995","Missouri","3","8","0","0.27273","186","311","-125"
"1996","Missouri","5","6","0","0.45455","278","376","-98"
"1997","Missouri","7","5","0","0.58333","392","367","25"
"1998","Missouri","8","4","0","0.66667","334","236","98"
"1999","Missouri","4","7","0","0.36364","224","371","-147"
"2000","Missouri","3","8","0","0.27273","255","348","-93"
"1989","Pittsburgh (PA)","1","0","0","1.00000","31","28","3"
"1990","Pittsburgh (PA)","3","7","1","0.31818","240","293","-53"
"1991","Pittsburgh (PA)","6","5","0","0.54545","244","241","3"
"1992","Pittsburgh (PA)","3","8","0","0.27273","266","393","-127"
"1998","Southern California","8","5","0","0.61538","346","241","105"
"1999","Southern California","7","5","0","0.58333","348","278","70"
"2000","Southern California","5","7","0","0.41667","309","337","-28"
"2001","Southern California","6","6","0","0.50000","298","207","91"
"2002","Southern California","11","2","0","0.84615","465","240","225"
"2003","Southern California","12","1","0","0.92308","534","239","295"
"2004","Southern California","11","0","0","1.00000","496","169","327"
"2005","Southern California","0","1","0","0.00000","638","297","341"
"2006","Southern California","11","2","0","0.84615","396","197","199"
"2007","Southern California","11","2","0","0.84615","424","208","216"
"2008","Southern California","12","1","0","0.92308","488","117","371"
"2009","Southern California","9","4","0","0.69231","344","258","86"
"2009","Tennessee","7","6","0","0.53846","381","289","92"
"2010","Southern California","8","5","0","0.61538","403","347","56"
"2011","Southern California","10","2","0","0.83333","429","283","146"
"2012","Southern California","7","6","0","0.53846","417","316","101"
"2013","Southern California","3","2","0","0.60000","130","106","24"
"2013","Southern California","1","0","0","1.00000","45","20","25"
"2005","Mississippi","3","8","0","0.27273","148","245","-97"
"2006","Mississippi","4","8","0","0.33333","188","275","-87"
"2007","Mississippi","3","9","0","0.25000","241","342","-101"
"2013","Southern California","6","2","0","0.75000","241","171","70"
"1914","Southwestern (TX)","4","4","0","0.50000","55","174","-119"
"1915","Southwestern (TX)","4","3","0","0.57143","46","82","-36"
"1916","Southwestern (TX)","3","5","1","0.38889","82","133","-51"
"1917","Southern Methodist (TX)","3","2","3","0.56250","74","49","25"
"1918","Southern Methodist (TX)","4","3","0","0.57143","40","46","-6"
"1919","Southern Methodist (TX)","5","4","1","0.55000","162","86","76"
"1920","Southern Methodist (TX)","3","5","2","0.40000","125","90","35"
"1929","Miami (FL)","3","2","0","0.60000","45","26","19"
"1921","Southern Methodist (TX)","1","6","1","0.18750","15","92","-77"
"1922","Southern Methodist (TX)","6","3","1","0.65000","235","69","166"
"1923","Southern Methodist (TX)","9","0","0","1.00000","207","9","198"
"1915","Southern Methodist (TX)","2","5","0","0.28571","20","131","-111"
"1916","Southern Methodist (TX)","0","8","2","0.10000","27","455","-428"
"1918","Vanderbilt (TN)","4","2","0","0.66667","176","31","145"
"1924","Southern Methodist (TX)","5","1","4","0.70000","92","62","30"
"1925","Southern Methodist (TX)","5","2","2","0.66667","148","41","107"
"1926","Southern Methodist (TX)","8","0","1","0.94444","229","47","182"
"1927","Southern Methodist (TX)","7","2","0","0.77778","267","81","186"
"1928","Southern Methodist (TX)","6","3","1","0.65000","254","78","176"
"1929","Southern Methodist (TX)","6","0","4","0.80000","172","36","136"
"1930","Southern Methodist (TX)","6","3","1","0.65000","187","93","94"
"1931","Southern Methodist (TX)","9","1","1","0.86364","160","48","112"
"1932","Southern Methodist (TX)","3","7","2","0.33333","82","112","-30"
"1933","Southern Methodist (TX)","4","7","1","0.37500","99","104","-5"
"1934","Southern Methodist (TX)","8","2","2","0.75000","224","63","161"
"1935","Vanderbilt (TN)","7","3","0","0.70000","179","68","111"
"1936","Vanderbilt (TN)","3","5","1","0.38889","115","87","28"
"1937","Vanderbilt (TN)","7","2","0","0.77778","121","42","79"
"1938","Vanderbilt (TN)","6","3","0","0.66667","86","49","37"
"1939","Vanderbilt (TN)","2","7","1","0.25000","96","165","-69"
"1940","Temple (PA)","4","4","1","0.50000","155","113","42"
"1941","Temple (PA)","7","2","0","0.77778","176","146","30"
"1942","Temple (PA)","2","5","3","0.35000","48","135","-87"
"1943","Temple (PA)","2","6","0","0.25000","65","163","-98"
"1944","Temple (PA)","2","4","2","0.37500","93","96","-3"
"1945","Temple (PA)","7","1","0","0.87500","198","51","147"
"1946","Temple (PA)","2","4","2","0.37500","61","114","-53"
"1947","Temple (PA)","3","6","0","0.33333","91","128","-37"
"1948","Temple (PA)","2","6","1","0.27778","95","182","-87"
"1923","Texas Christian","4","5","0","0.44444","93","137","-44"
"1924","Texas Christian","4","5","0","0.44444","83","96","-13"
"1925","Texas Christian","7","1","1","0.83333","133","54","79"
"1926","Texas Christian","6","1","2","0.77778","110","74","36"
"1927","Texas Christian","4","3","2","0.55556","89","64","25"
"1928","Texas Christian","8","2","0","0.80000","142","28","114"
"1929","Texas A&M","5","4","0","0.55556","203","65","138"
"1930","Texas A&M","2","7","0","0.22222","66","100","-34"
"1931","Texas A&M","7","3","0","0.70000","137","34","103"
"1932","Texas A&M","4","4","2","0.50000","75","78","-3"
"1933","Texas A&M","6","3","1","0.65000","160","89","71"
"1935","Southern Methodist (TX)","12","1","0","0.92308","288","39","249"
"1936","Southern Methodist (TX)","5","4","1","0.55000","119","66","53"
"1937","Southern Methodist (TX)","5","6","0","0.45455","93","83","10"
"1938","Southern Methodist (TX)","6","4","0","0.60000","148","125","23"
"1939","Southern Methodist (TX)","6","3","1","0.65000","118","60","58"
"1940","Southern Methodist (TX)","8","1","1","0.85000","142","75","67"
"1941","Southern Methodist (TX)","5","5","0","0.50000","169","106","63"
"1945","Southern Methodist (TX)","5","6","0","0.45455","201","110","91"
"1946","Southern Methodist (TX)","4","5","1","0.45000","114","100","14"
"1947","Southern Methodist (TX)","9","0","2","0.90909","182","90","92"
"1948","Southern Methodist (TX)","9","1","1","0.86364","250","105","145"
"1949","Southern Methodist (TX)","5","4","1","0.55000","215","204","11"
"1942","Southern Methodist (TX)","3","6","2","0.36364","126","133","-7"
"1943","Southern Methodist (TX)","2","7","0","0.22222","69","115","-46"
"1944","Southern Methodist (TX)","5","5","0","0.50000","131","201","-70"
"1950","Southern Methodist (TX)","6","4","0","0.60000","251","146","105"
"1951","Southern Methodist (TX)","3","6","1","0.35000","164","144","20"
"1952","Southern Methodist (TX)","4","5","1","0.45000","136","163","-27"
"1962","Howard Payne (TX)","1","8","1","0.15000","98","227","-129"
"1963","Howard Payne (TX)","3","7","0","0.30000","97","213","-116"
"1953","Southern Methodist (TX)","5","5","0","0.50000","128","129","-1"
"1954","Southern Methodist (TX)","6","3","1","0.65000","184","135","49"
"1955","Southern Methodist (TX)","4","6","0","0.40000","118","115","3"
"1956","Southern Methodist (TX)","4","6","0","0.40000","125","202","-77"
"1957","Wichita St. (KS)","1","9","0","0.10000","66","250","-184"
"1958","Wichita St. (KS)","4","5","1","0.45000","148","200","-52"
"1959","Wichita St. (KS)","5","4","1","0.55000","181","161","20"
"1951","Kansas St.","0","9","0","0.00000","73","228","-155"
"1952","Kansas St.","1","9","0","0.10000","81","255","-174"
"1953","Kansas St.","6","3","1","0.65000","198","116","82"
"1954","Kansas St.","7","3","0","0.70000","191","154","37"
"1955","Houston (TX)","6","4","0","0.60000","176","139","37"
"1956","Houston (TX)","7","2","1","0.75000","185","90","95"
"1957","Southern Methodist (TX)","4","5","1","0.45000","127","175","-48"
"1958","Southern Methodist (TX)","6","4","0","0.60000","203","134","69"
"1959","Southern Methodist (TX)","5","4","1","0.55000","147","133","14"
"1960","Southern Methodist (TX)","0","9","1","0.05000","31","221","-190"
"1961","Southern Methodist (TX)","2","7","1","0.25000","92","191","-99"
"1968","Utah","3","7","0","0.30000","162","234","-72"
"1969","Utah","8","2","0","0.80000","231","107","124"
"1970","Utah","6","4","0","0.60000","208","176","32"
"1971","Utah","3","8","0","0.27273","244","315","-71"
"1972","Utah","6","5","0","0.54545","354","336","18"
"1973","Utah","7","5","0","0.58333","385","344","41"
"1962","Southern Methodist (TX)","2","8","0","0.20000","88","130","-42"
"1963","Southern Methodist (TX)","4","7","0","0.36364","141","175","-34"
"1964","Southern Methodist (TX)","1","9","0","0.10000","55","177","-122"
"1965","Southern Methodist (TX)","4","5","1","0.45000","123","167","-44"
"1966","Southern Methodist (TX)","8","3","0","0.72727","210","170","40"
"1967","Southern Methodist (TX)","3","7","0","0.30000","135","214","-79"
"1968","Southern Methodist (TX)","8","3","0","0.72727","311","273","38"
"1969","Southern Methodist (TX)","3","7","0","0.30000","186","230","-44"
"1970","Southern Methodist (TX)","5","6","0","0.45455","153","228","-75"
"1971","Southern Methodist (TX)","4","7","0","0.36364","151","227","-76"
"1972","Southern Methodist (TX)","7","4","0","0.63636","269","154","115"
"1973","North Texas","5","5","1","0.50000","153","243","-90"
"1974","North Texas","2","7","2","0.27273","134","248","-114"
"1975","North Texas","7","4","0","0.63636","200","210","-10"
"1976","North Texas","7","4","0","0.63636","232","145","87"
"1977","North Texas","10","1","0","0.90909","320","179","141"
"1978","North Texas","9","2","0","0.81818","275","150","125"
"1979","Iowa","5","6","0","0.45455","239","216","23"
"1980","Iowa","4","7","0","0.36364","154","238","-84"
"1981","Iowa","8","4","0","0.66667","260","157","103"
"1982","Iowa","8","4","0","0.66667","229","230","-1"
"1983","Iowa","9","3","0","0.75000","380","189","191"
"1984","Iowa","8","4","1","0.65385","359","201","158"
"1985","Iowa","10","2","0","0.83333","440","187","253"
"1986","Iowa","9","3","0","0.75000","391","214","177"
"1987","Iowa","10","3","0","0.76923","380","250","130"
"1988","Iowa","6","4","3","0.57692","336","233","103"
"1989","Iowa","5","6","0","0.45455","197","278","-81"
"1990","Iowa","8","4","0","0.66667","427","288","139"
"1991","Iowa","10","1","1","0.87500","343","179","164"
"1992","Iowa","5","7","0","0.41667","243","278","-35"
"1993","Iowa","6","6","0","0.50000","214","293","-79"
"1994","Iowa","5","5","1","0.50000","307","324","-17"
"1995","Iowa","8","4","0","0.66667","368","259","109"
"1996","Iowa","9","3","0","0.75000","339","243","96"
"1997","Iowa","7","5","0","0.58333","411","159","252"
"1998","Iowa","3","8","0","0.27273","172","287","-115"
"1972","Oklahoma St.","7","4","0","0.63636","259","203","56"
"1973","Southern Methodist (TX)","6","4","1","0.59091","259","228","31"
"1974","Southern Methodist (TX)","6","4","1","0.59091","221","240","-19"
"1975","Southern Methodist (TX)","4","7","0","0.36364","208","301","-93"
"1973","Nevada-Las Vegas","8","3","0","0.72727","304","151","153"
"1974","Nevada-Las Vegas","12","1","0","0.92308","444","251","193"
"1975","Nevada-Las Vegas","7","4","0","0.63636","332","212","120"
"1976","Southern Methodist (TX)","3","8","0","0.27273","202","339","-137"
"1977","Southern Methodist (TX)","4","7","0","0.36364","226","319","-93"
"1978","Southern Methodist (TX)","4","6","1","0.40909","300","251","49"
"1979","Southern Methodist (TX)","5","6","0","0.45455","226","236","-10"
"1980","Southern Methodist (TX)","8","4","0","0.66667","324","192","132"
"1981","Southern Methodist (TX)","10","1","0","0.90909","365","137","228"
"1975","Southern Mississippi","8","3","0","0.72727","279","129","150"
"1976","Southern Mississippi","3","8","0","0.27273","145","296","-151"
"1977","Southern Mississippi","6","6","0","0.50000","215","250","-35"
"1978","Southern Mississippi","7","4","0","0.63636","213","185","28"
"1979","Southern Mississippi","6","4","1","0.59091","228","146","82"
"1980","Southern Mississippi","9","3","0","0.75000","290","183","107"
"1981","Southern Mississippi","9","2","1","0.79167","305","108","197"
"1982","Southern Methodist (TX)","11","0","1","0.95833","354","160","194"
"1983","Southern Methodist (TX)","10","2","0","0.83333","274","137","137"
"1984","Southern Methodist (TX)","10","2","0","0.83333","328","198","130"
"1985","Southern Methodist (TX)","6","5","0","0.54545","280","211","69"
"1986","Southern Methodist (TX)","6","5","0","0.54545","245","282","-37"
"1989","Southern Methodist (TX)","2","9","0","0.18182","187","499","-312"
"1990","Southern Methodist (TX)","1","10","0","0.09091","197","426","-229"
"1991","Southern Methodist (TX)","1","10","0","0.09091","141","359","-218"
"1992","Southern Methodist (TX)","5","6","0","0.45455","212","276","-64"
"1993","Southern Methodist (TX)","2","7","2","0.27273","206","277","-71"
"1994","Southern Methodist (TX)","1","9","1","0.13636","197","343","-146"
"1995","Southern Methodist (TX)","1","10","0","0.09091","132","352","-220"
"1996","Southern Methodist (TX)","5","6","0","0.45455","246","267","-21"
"1992","East Tennessee St.","5","6","0","0.45455","219","313","-94"
"1993","East Tennessee St.","5","6","0","0.45455","213","222","-9"
"1994","East Tennessee St.","6","5","0","0.54545","306","266","40"
"1995","East Tennessee St.","4","7","0","0.36364","224","305","-81"
"1996","East Tennessee St.","10","3","0","0.76923","378","286","92"
"1997","Southern Methodist (TX)","6","5","0","0.54545","247","237","10"
"1998","Southern Methodist (TX)","5","7","0","0.41667","225","248","-23"
"1999","Southern Methodist (TX)","4","6","0","0.40000","193","235","-42"
"2000","Southern Methodist (TX)","3","9","0","0.25000","181","352","-171"
"2001","Southern Methodist (TX)","4","7","0","0.36364","226","295","-69"
"2002","Southern Methodist (TX)","3","9","0","0.25000","207","378","-171"
"2003","Southern Methodist (TX)","0","12","0","0.00000","134","386","-252"
"2004","Southern Methodist (TX)","3","8","0","0.27273","202","420","-218"
"2005","Southern Methodist (TX)","5","6","0","0.45455","229","280","-51"
"2006","Southern Methodist (TX)","6","6","0","0.50000","325","294","31"
"2007","Southern Methodist (TX)","1","11","0","0.08333","340","477","-137"
"2010","Pittsburgh (PA)","1","0","0","1.00000","27","10","17"
"1999","Hawaii","9","4","0","0.69231","371","349","22"
"2000","Hawaii","3","9","0","0.25000","294","399","-105"
"2001","Hawaii","9","3","0","0.75000","483","318","165"
"2002","Hawaii","10","4","0","0.71429","502","389","113"
"2003","Hawaii","9","5","0","0.64286","486","427","59"
"2004","Hawaii","8","5","0","0.61538","467","499","-32"
"2005","Hawaii","5","7","0","0.41667","368","428","-60"
"2006","Hawaii","11","3","0","0.78571","656","337","319"
"2007","Hawaii","12","1","0","0.92308","564","331","233"
"2008","Southern Methodist (TX)","1","11","0","0.08333","256","458","-202"
"2009","Southern Methodist (TX)","8","5","0","0.61538","380","359","21"
"2010","Southern Methodist (TX)","7","7","0","0.50000","360","359","1"
"2011","Southern Methodist (TX)","8","5","0","0.61538","336","300","36"
"2012","Southern Methodist (TX)","7","6","0","0.53846","397","334","63"
"2013","Southern Methodist (TX)","5","7","0","0.41667","321","400","-79"
"1912","Southern Mississippi","2","1","0","0.66667","36","6","30"
"1913","Southern Mississippi","1","5","1","0.21429","24","82","-58"
"1914","Southern Mississippi","2","3","1","0.41667","46","86","-40"
"1915","Southern Mississippi","4","4","0","0.50000","114","103","11"
"1916","Southern Mississippi","0","3","0","0.00000","0","193","-193"
"1919","Southern Mississippi","4","1","2","0.71429","100","31","69"
"1920","Southern Mississippi","5","2","1","0.68750","182","82","100"
"1921","Southern Mississippi","3","4","0","0.42857","183","141","42"
"1922","Southern Mississippi","2","6","0","0.25000","63","122","-59"
"1923","Southern Mississippi","3","3","0","0.50000","90","104","-14"
"1924","Southern Mississippi","3","3","2","0.50000","94","152","-58"
"1925","Southern Mississippi","0","7","0","0.00000","19","207","-188"
"1926","Southern Mississippi","3","4","1","0.43750","77","129","-52"
"1927","Southern Mississippi","3","4","1","0.43750","52","98","-46"
"1928","Southern Mississippi","4","5","0","0.44444","62","234","-172"
"1929","Southern Mississippi","2","6","1","0.27778","74","104","-30"
"1930","Southern Mississippi","3","5","1","0.38889","162","117","45"
"1931","Southern Mississippi","2","5","0","0.28571","67","124","-57"
"1932","Southern Mississippi","5","4","0","0.55556","80","158","-78"
"1933","Southern Mississippi","3","5","2","0.40000","67","180","-113"
"1934","Southern Mississippi","3","4","2","0.44444","63","109","-46"
"1935","Southern Mississippi","6","4","0","0.60000","101","112","-11"
"1936","Southern Mississippi","7","2","1","0.75000","137","54","83"
"1937","Virginia Military Institute","5","5","0","0.50000","134","94","40"
"1938","Virginia Military Institute","6","1","4","0.72727","159","86","73"
"1939","Virginia Military Institute","6","3","1","0.65000","125","100","25"
"1940","Virginia Military Institute","7","2","1","0.75000","127","52","75"
"1941","Virginia Military Institute","4","6","0","0.40000","134","173","-39"
"1942","Virginia Military Institute","3","5","1","0.38889","111","130","-19"
"1943","Virginia Military Institute","2","6","0","0.25000","46","183","-137"
"1944","Virginia Military Institute","1","8","0","0.11111","65","237","-172"
"1945","Virginia Military Institute","5","4","0","0.55556","155","138","17"
"1946","Virginia Military Institute","4","5","1","0.45000","133","189","-56"
"1937","Southern Mississippi","7","3","0","0.70000","222","24","198"
"1938","Southern Mississippi","7","2","0","0.77778","203","26","177"
"1939","Southern Mississippi","4","2","3","0.61111","77","67","10"
"1940","Southern Mississippi","7","4","0","0.63636","220","80","140"
"1941","Southern Mississippi","9","0","1","0.95000","246","40","206"
"1942","Southern Mississippi","4","0","0","1.00000","142","7","135"
"1946","Southern Mississippi","7","3","0","0.70000","243","52","191"
"1947","Southern Mississippi","7","3","0","0.70000","154","102","52"
"1948","Southern Mississippi","7","3","0","0.70000","277","127","150"
"1949","Southern Mississippi","7","3","0","0.70000","299","274","25"
"1950","Southern Mississippi","5","5","0","0.50000","134","233","-99"
"1951","Southern Mississippi","6","5","0","0.54545","306","132","174"
"1952","Southern Mississippi","10","2","0","0.83333","409","189","220"
"1953","Southern Mississippi","9","2","0","0.81818","280","122","158"
"1954","Southern Mississippi","6","4","0","0.60000","172","103","69"
"1955","Southern Mississippi","9","1","0","0.90000","277","49","228"
"1956","Southern Mississippi","7","2","1","0.75000","219","92","127"
"1957","Southern Mississippi","8","3","0","0.72727","152","72","80"
"1958","Southern Mississippi","9","0","0","1.00000","210","55","155"
"1959","Southern Mississippi","6","4","0","0.60000","171","122","49"
"1960","Southern Mississippi","6","4","0","0.60000","189","96","93"
"1961","Southern Mississippi","8","2","0","0.80000","183","68","115"
"1962","Southern Mississippi","9","1","0","0.90000","265","67","198"
"1963","Southern Mississippi","5","3","1","0.61111","128","64","64"
"1964","Southern Mississippi","6","3","0","0.66667","143","144","-1"
"1965","Southern Mississippi","7","2","0","0.77778","127","60","67"
"1966","Southern Mississippi","6","4","0","0.60000","156","103","53"
"1967","Southern Mississippi","6","3","0","0.66667","201","114","87"
"1968","Southern Mississippi","4","6","0","0.40000","228","231","-3"
"1969","Southern Mississippi","5","5","0","0.50000","162","307","-145"
"1970","Southern Mississippi","5","6","0","0.45455","228","299","-71"
"1971","Southern Mississippi","6","5","0","0.54545","202","192","10"
"1972","Southern Mississippi","3","7","1","0.31818","182","231","-49"
"1973","Southern Mississippi","6","4","1","0.59091","227","166","61"
"1974","Southern Mississippi","6","5","0","0.54545","160","195","-35"
"1975","Southern Mississippi","8","3","0","0.72727","279","129","150"
"1976","Southern Mississippi","3","8","0","0.27273","145","296","-151"
"1977","Southern Mississippi","6","6","0","0.50000","215","250","-35"
"1978","Southern Mississippi","7","4","0","0.63636","213","185","28"
"1979","Southern Mississippi","6","4","1","0.59091","228","146","82"
"1980","Southern Mississippi","9","3","0","0.75000","290","183","107"
"1981","Southern Mississippi","9","2","1","0.79167","305","108","197"
"1982","Southern Methodist (TX)","11","0","1","0.95833","354","160","194"
"1983","Southern Methodist (TX)","10","2","0","0.83333","274","137","137"
"1984","Southern Methodist (TX)","10","2","0","0.83333","328","198","130"
"1985","Southern Methodist (TX)","6","5","0","0.54545","280","211","69"
"1986","Southern Methodist (TX)","6","5","0","0.54545","245","282","-37"
"1982","Southern Mississippi","7","4","0","0.63636","304","180","124"
"1983","Southern Mississippi","7","4","0","0.63636","235","128","107"
"1984","Southern Mississippi","4","7","0","0.36364","188","243","-55"
"1985","Southern Mississippi","7","4","0","0.63636","255","159","96"
"1986","Southern Mississippi","6","5","0","0.54545","198","252","-54"
"1987","Southern Mississippi","6","5","0","0.54545","270","296","-26"
"1988","Southern Mississippi","10","2","0","0.83333","353","284","69"
"1989","Southern Mississippi","5","6","0","0.45455","240","252","-12"
"1990","Southern Mississippi","8","3","0","0.72727","193","141","52"
"1991","Louisiana St.","5","6","0","0.45455","248","263","-15"
"1992","Louisiana St.","2","9","0","0.18182","175","261","-86"
"1993","Louisiana St.","5","6","0","0.45455","190","308","-118"
"1994","Louisiana St.","4","7","0","0.36364","270","271","-1"
"1990","Southern Mississippi","0","1","0","0.00000","27","31","-4"
"1991","Southern Mississippi","4","7","0","0.36364","212","225","-13"
"1992","Southern Mississippi","7","4","0","0.63636","219","195","24"
"1993","Southern Mississippi","3","7","1","0.31818","214","311","-97"
"1994","Southern Mississippi","6","5","0","0.54545","278","261","17"
"1995","Southern Mississippi","6","5","0","0.54545","284","241","43"
"1996","Southern Mississippi","8","3","0","0.72727","287","247","40"
"1997","Southern Mississippi","9","3","0","0.75000","337","210","127"
"1998","Southern Mississippi","7","5","0","0.58333","384","238","146"
"1999","Southern Mississippi","9","3","0","0.75000","333","189","144"
"2000","Southern Mississippi","8","4","0","0.66667","314","203","111"
"2001","Southern Mississippi","6","5","0","0.54545","278","186","92"
"2002","Southern Mississippi","7","6","0","0.53846","282","238","44"
"2003","Southern Mississippi","9","4","0","0.69231","293","226","67"
"2004","Southern Mississippi","7","5","0","0.58333","309","298","11"
"2005","Southern Mississippi","7","5","0","0.58333","355","272","83"
"2006","Southern Mississippi","9","5","0","0.64286","356","260","96"
"2007","Southern Mississippi","7","6","0","0.53846","361","314","47"
"2008","Southern Mississippi","7","6","0","0.53846","398","313","85"
"2009","Southern Mississippi","7","6","0","0.53846","428","336","92"
"2010","Southern Mississippi","8","5","0","0.61538","479","384","95"
"2011","Southern Mississippi","12","2","0","0.85714","516","291","225"
"2012","North Carolina","8","4","0","0.66667","487","308","179"
"2013","North Carolina","7","6","0","0.53846","425","318","107"
"1983","Gardner-Webb (NC)","5","6","0","0.45455","175","189","-14"
"2001","Citadel (SC)","3","7","0","0.30000","172","183","-11"
"2002","Citadel (SC)","3","9","0","0.25000","305","338","-33"
"2003","Citadel (SC)","6","6","0","0.50000","261","311","-50"
"2012","Southern Mississippi","0","12","0","0.00000","236","454","-218"
"2013","Southern Mississippi","1","11","0","0.08333","205","503","-298"
"1869","Rutgers (NJ)","2","2","0","0.50000","18","18","0"
"1870","Rutgers (NJ)","2","2","0","0.50000","17","17","0"
"1872","Columbia (NY)","5","4","0","0.55556","22","16","6"
"1873","Rutgers (NJ)","7","4","1","0.62500","31","26","5"
"1874","Harvard (MA)","9","7","0","0.56250","54","41","13"
"1875","Harvard (MA)","12","6","2","0.65000","52","29","23"
"1876","Harvard (MA)","13","8","1","0.61364","45","29","16"
"1877","Harvard (MA)","9","7","3","0.55263","31","21","10"
"1878","Pennsylvania","14","9","5","0.58929","42","24","18"
"1879","Harvard (MA)","13","9","12","0.55882","46","27","19"
"1880","Harvard (MA)","18","11","4","0.60606","75","53","22"
"1881","Rutgers (NJ)","22","18","8","0.54167","70","47","23"
"1882","Rutgers (NJ)","41","28","2","0.59155","176","111","65"
"1883","Rutgers (NJ)","38","32","1","0.54225","1288","965","323"
"1884","Pennsylvania","47","29","5","0.61111","1728","1184","544"
"1885","Michigan","34","17","4","0.65455","1437","612","825"
"1886","Lehigh (PA)","48","21","4","0.68493","1850","637","1213"
"1887","California","67","35","3","0.65238","2660","935","1725"
"1888","Princeton (NJ)","70","56","6","0.55303","2468","1899","569"
"1889","Brown (RI)","82","51","11","0.60764","2879","1796","1083"
"1890","Brown (RI)","77","76","9","0.50309","3002","2455","547"
"1891","Southern California","94","76","13","0.54918","2813","2189","624"
"1892","Minnesota","93","80","9","0.53571","2972","2394","578"
"1893","Duke (NC)","79","94","9","0.45879","2176","2912","-736"
"1894","Colorado St.","50","62","4","0.44828","1161","1518","-357"
"1895","Boston (MA)","31","44","11","0.42442","692","1031","-339"
"1896","Rhode Island","54","62","12","0.46875","1126","1201","-75"
"1897","Boston (MA)","32","40","6","0.44872","792","785","7"
"1898","Miami (OH)","47","23","4","0.66216","921","644","277"
"1899","New Hampshire","33","32","6","0.50704","571","522","49"
"1900","New Hampshire","22","35","11","0.40441","442","686","-244"
"1901","Marshall (WV)","18","34","3","0.35455","302","917","-615"
"1902","Saint John's (MN)","9","22","4","0.31429","148","460","-312"
"1903","Wichita St. (KS)","14","25","2","0.36585","376","546","-170"
"1904","Oklahoma St.","11","14","1","0.44231","194","394","-200"
"1905","Miami (OH)","7","25","5","0.25676","245","494","-249"
"1906","Rensselaer Tech (NY)","3","7","4","0.35714","92","107","-15"
"1907","Marshall (WV)","5","10","2","0.35294","71","238","-167"
"1908","Fort Hays St. (KS)","5","6","1","0.45833","56","91","-35"
"1909","Fort Hays St. (KS)","1","3","1","0.30000","12","68","-56"
"1910","Texas St.","0","1","0","0.00000","0","19","-19"
"1912","Fort Hays St. (KS)","1","2","0","0.33333","20","132","-112"
"1913","Eureka (IL)","1","6","0","0.14286","39","203","-164"
"1914","Eureka (IL)","3","4","0","0.42857","57","201","-144"
"1915","Texas St.","1","1","1","0.50000","13","20","-7"
"1916","Texas St.","0","2","1","0.16667","0","106","-106"
"1917","Boston (MA)","4","4","0","0.50000","73","136","-63"
"1918","Monmouth (IL)","1","7","0","0.12500","26","137","-111"
"1930","Troy (AL)","1","2","0","0.33333","7","73","-66"
"2013","Grambling St. (LA)","0","1","0","0.00000","0","0","0"
"1888","Yale (CT)","13","0","0","1.00000","694","0","694"
"1889","Yale (CT)","15","1","0","0.93750","661","31","630"
"1890","Yale (CT)","13","1","0","0.92857","486","18","468"
"1891","Yale (CT)","13","0","0","1.00000","488","0","488"
"1892","Yale (CT)","17","0","2","0.94737","633","29","604"
"1894","Stanford (CA)","6","3","0","0.66667","100","58","42"
"1895","Stanford (CA)","4","0","1","0.90000","34","8","26"
"1893","Stanford (CA)","9","0","1","0.95000","290","17","273"
"1895","Missouri","7","1","0","0.87500","156","42","114"
"1896","Stanford (CA)","2","1","1","0.62500","40","4","36"
"1898","Stanford (CA)","5","3","1","0.61111","93","62","31"
"1897","Stanford (CA)","4","1","0","0.80000","54","26","28"
"1900","Swarthmore (PA)","6","3","2","0.63636","143","123","20"
"1901","Swarthmore (PA)","8","2","2","0.75000","148","89","59"
"1902","Swarthmore (PA)","6","6","0","0.50000","141","127","14"
"1903","Swarthmore (PA)","6","4","0","0.60000","99","67","32"
"1904","Swarthmore (PA)","6","3","0","0.66667","186","28","158"
"1905","Swarthmore (PA)","7","1","0","0.87500","178","22","156"
"1906","Swarthmore (PA)","7","2","0","0.77778","160","37","123"
"1907","Swarthmore (PA)","6","2","0","0.75000","150","53","97"
"1909","Swarthmore (PA)","2","5","0","0.28571","84","101","-17"
"1910","Swarthmore (PA)","5","3","0","0.62500","144","59","85"
"1911","Swarthmore (PA)","6","1","1","0.81250","84","23","61"
"1912","Swarthmore (PA)","7","1","1","0.83333","150","31","119"
"1913","Pennsylvania","6","3","1","0.65000","169","81","88"
"1914","Pennsylvania","4","4","1","0.50000","89","121","-32"
"1915","Pennsylvania","3","5","2","0.40000","109","88","21"
"1899","Stanford (CA)","2","5","2","0.33333","61","78","-17"
"1903","Navy (MD)","4","7","1","0.37500","77","130","-53"
"1898","Nebraska","8","3","0","0.72727","270","78","192"
"1899","Kansas","10","0","0","1.00000","280","37","243"
"1900","Stanford (CA)","7","2","1","0.75000","154","20","134"
"1901","Michigan","11","0","0","1.00000","550","0","550"
"1902","Michigan","11","0","0","1.00000","644","12","632"
"1903","Michigan","11","0","1","0.95833","565","6","559"
"1904","Michigan","10","0","0","1.00000","567","22","545"
"1905","Michigan","12","1","0","0.92308","495","2","493"
"1906","Michigan","4","1","1","0.75000","72","30","42"
"1907","Michigan","5","1","0","0.83333","107","6","101"
"1908","Michigan","5","2","1","0.68750","128","81","47"
"1909","Michigan","6","1","0","0.85714","115","34","81"
"1910","Michigan","3","0","3","0.75000","29","9","20"
"1911","Michigan","5","1","2","0.75000","90","38","52"
"1912","Michigan","5","2","0","0.71429","158","65","93"
"1913","Michigan","6","1","0","0.85714","175","21","154"
"1914","Michigan","6","3","0","0.66667","233","68","165"
"1915","Michigan","4","3","1","0.56250","130","81","49"
"1916","Michigan","7","2","0","0.77778","253","56","197"
"1917","Michigan","8","2","0","0.80000","304","53","251"
"1918","Michigan","5","0","0","1.00000","96","6","90"
"1919","Michigan","3","4","0","0.42857","93","102","-9"
"1920","Michigan","5","2","0","0.71429","121","21","100"
"1921","Michigan","5","1","1","0.78571","187","21","166"
"1922","Michigan","6","0","1","0.92857","183","13","170"
"1923","Michigan","8","0","0","1.00000","150","12","138"
"1925","Michigan","7","1","0","0.87500","227","3","224"
"1926","Michigan","7","1","0","0.87500","191","38","153"
"1901","Stanford (CA)","3","2","2","0.57143","34","57","-23"
"1897","Washington","1","2","0","0.33333","16","26","-10"
"1902","Stanford (CA)","6","1","0","0.85714","111","37","74"
"1903","Stanford (CA)","8","0","3","0.86364","199","6","193"
"1904","Stanford (CA)","7","2","1","0.75000","206","10","196"
"1905","Stanford (CA)","8","0","0","1.00000","138","13","125"
"1916","Colorado","1","5","1","0.21429","40","162","-122"
"1917","Colorado","6","2","0","0.75000","114","56","58"
"1919","Stanford (CA)","4","3","0","0.57143","130","46","84"
"1919","Montana St.","1","3","1","0.30000","49","97","-48"
"1920","Stanford (CA)","4","3","0","0.57143","82","65","17"
"1916","Texas","7","2","0","0.77778","218","35","183"
"1920","California-Davis","3","4","1","0.43750","61","67","-6"
"1921","Stanford (CA)","4","2","2","0.62500","100","97","3"
"1922","Stanford (CA)","4","5","0","0.44444","63","96","-33"
"1923","Stanford (CA)","7","2","0","0.77778","284","46","238"
"1929","Colgate (NY)","8","1","0","0.88889","315","19","296"
"1930","Colgate (NY)","9","1","0","0.90000","383","27","356"
"1931","Colgate (NY)","8","1","0","0.88889","227","34","193"
"1932","Colgate (NY)","9","0","0","1.00000","264","0","264"
"1933","Colgate (NY)","6","1","1","0.81250","189","12","177"
"1934","Colgate (NY)","7","1","0","0.87500","188","38","150"
"1935","Colgate (NY)","7","3","0","0.70000","224","29","195"
"1936","Colgate (NY)","6","3","0","0.66667","199","67","132"
"1937","Colgate (NY)","3","5","0","0.37500","89","86","3"
"1938","Colgate (NY)","2","5","0","0.28571","39","63","-24"
"1939","Colgate (NY)","2","5","1","0.31250","66","92","-26"
"1940","Colgate (NY)","5","3","0","0.62500","125","76","49"
"1941","Colgate (NY)","3","3","2","0.50000","150","112","38"
"1942","Colgate (NY)","6","2","1","0.72222","172","104","68"
"1943","Colgate (NY)","5","3","1","0.61111","128","91","37"
"1944","Colgate (NY)","2","5","0","0.28571","79","127","-48"
"1945","Colgate (NY)","3","4","1","0.43750","128","111","17"
"1946","Colgate (NY)","4","4","0","0.50000","154","95","59"
"1895","Iowa St.","3","5","0","0.37500","108","56","52"
"1896","Georgia","4","0","0","1.00000","86","22","64"
"1897","Cornell (NY)","5","3","1","0.61111","133","42","91"
"1898","Cornell (NY)","10","2","0","0.83333","296","29","267"
"1899","Carlisle Indian School (PA)","9","2","0","0.81818","365","50","315"
"1900","Carlisle Indian School (PA)","6","4","1","0.59091","212","92","120"
"1901","Carlisle Indian School (PA)","5","7","1","0.42308","133","168","-35"
"1902","Carlisle Indian School (PA)","8","3","0","0.72727","251","51","200"
"1903","Carlisle Indian School (PA)","11","2","1","0.82143","274","52","222"
"1904","Cornell (NY)","7","3","0","0.70000","226","92","134"
"1905","Cornell (NY)","6","4","0","0.60000","173","59","114"
"1906","Cornell (NY)","8","1","2","0.81818","237","37","200"
"1907","Carlisle Indian School (PA)","10","1","0","0.90909","267","62","205"
"1908","Carlisle Indian School (PA)","10","2","1","0.80769","222","55","167"
"1909","Carlisle Indian School (PA)","8","3","1","0.70833","243","94","149"
"1910","Carlisle Indian School (PA)","8","6","0","0.57143","235","69","166"
"1911","Carlisle Indian School (PA)","11","1","0","0.91667","298","49","249"
"1912","Carlisle Indian School (PA)","12","1","1","0.89286","503","120","383"
"1913","Carlisle Indian School (PA)","10","1","1","0.87500","296","63","233"
"1914","Carlisle Indian School (PA)","5","9","1","0.36667","125","174","-49"
"1915","Pittsburgh (PA)","8","0","0","1.00000","247","19","228"
"1916","Pittsburgh (PA)","8","0","0","1.00000","255","25","230"
"1917","Pittsburgh (PA)","10","0","0","1.00000","260","21","239"
"1918","Pittsburgh (PA)","4","1","0","0.80000","140","16","124"
"1919","Pittsburgh (PA)","6","2","1","0.72222","119","66","53"
"1920","Pittsburgh (PA)","6","0","2","0.87500","146","44","102"
"1921","Pittsburgh (PA)","5","3","1","0.61111","133","51","82"
"1922","Pittsburgh (PA)","8","2","0","0.80000","190","43","147"
"1923","Pittsburgh (PA)","5","4","0","0.55556","83","39","44"
"1924","Stanford (CA)","7","1","1","0.83333","179","69","110"
"1925","Stanford (CA)","7","2","0","0.77778","231","71","160"
"1926","Stanford (CA)","10","0","1","0.95455","268","73","195"
"1927","Stanford (CA)","8","2","1","0.77273","162","82","80"
"1928","Stanford (CA)","8","3","1","0.70833","274","69","205"
"1929","Stanford (CA)","9","2","0","0.81818","288","53","235"
"1930","Stanford (CA)","9","1","1","0.86364","252","69","183"
"1931","Stanford (CA)","7","2","2","0.72727","160","44","116"
"1932","Stanford (CA)","6","4","1","0.59091","171","58","113"
"1933","Temple (PA)","5","3","0","0.62500","110","96","14"
"1934","Temple (PA)","7","1","2","0.80000","220","57","163"
"1935","Temple (PA)","7","3","0","0.70000","181","68","113"
"1936","Temple (PA)","6","3","2","0.63636","117","66","51"
"1937","Temple (PA)","3","2","4","0.55556","38","59","-21"
"1938","Temple (PA)","3","6","1","0.35000","97","170","-73"
"1933","Stanford (CA)","8","2","1","0.77273","131","43","88"
"1934","Stanford (CA)","9","1","1","0.86364","224","43","181"
"1935","Stanford (CA)","8","1","0","0.88889","121","13","108"
"1936","Stanford (CA)","2","5","2","0.33333","80","109","-29"
"1937","Stanford (CA)","4","3","2","0.55556","68","53","15"
"1938","Stanford (CA)","3","6","0","0.33333","67","92","-25"
"1939","Stanford (CA)","1","7","1","0.16667","54","146","-92"
"1915","Tulane (LA)","4","4","0","0.50000","118","78","40"
"1916","Tulane (LA)","4","3","1","0.56250","126","149","-23"
"1917","Tulane (LA)","5","3","0","0.62500","159","105","54"
"1918","Tulane (LA)","4","1","1","0.75000","133","16","117"
"1919","Tulane (LA)","6","2","1","0.72222","224","55","169"
"1920","Tulane (LA)","6","2","1","0.72222","181","28","153"
"1922","Tulane (LA)","4","4","0","0.50000","136","100","36"
"1923","Tulane (LA)","6","3","1","0.65000","117","89","28"
"1924","Tulane (LA)","8","1","0","0.88889","201","59","142"
"1925","Tulane (LA)","9","0","1","0.95000","246","23","223"
"1926","Tulane (LA)","3","5","1","0.38889","71","60","11"
"1927","Loyola (LA)","6","2","2","0.70000","130","41","89"
"1928","Loyola (LA)","7","3","0","0.70000","220","85","135"
"1929","Loyola (LA)","4","5","2","0.45455","150","129","21"
"1930","Loyola (LA)","9","1","0","0.90000","217","52","165"
"1931","Loyola (LA)","5","4","0","0.55556","154","91","63"
"1932","Loyola (LA)","6","4","1","0.59091","134","77","57"
"1933","Chicago (IL)","3","3","2","0.50000","118","56","62"
"1934","Chicago (IL)","4","4","0","0.50000","113","106","7"
"1935","Chicago (IL)","4","4","0","0.50000","102","110","-8"
"1936","Chicago (IL)","2","5","1","0.31250","68","166","-98"
"1937","Chicago (IL)","1","6","0","0.14286","45","143","-98"
"1938","Chicago (IL)","1","6","1","0.18750","75","241","-166"
"1939","Chicago (IL)","2","6","0","0.25000","37","308","-271"
"1940","Stanford (CA)","10","0","0","1.00000","196","85","111"
"1941","Stanford (CA)","6","3","0","0.66667","160","95","65"
"1942","Maryland","7","2","0","0.77778","198","124","74"
"1943","Pittsburgh (PA)","3","5","0","0.37500","114","180","-66"
"1944","Pittsburgh (PA)","4","5","0","0.44444","147","293","-146"
"1945","Pittsburgh (PA)","3","7","0","0.30000","87","141","-54"
"1946","Maryland","3","6","0","0.33333","136","193","-57"
"1965","Hawaii","1","8","1","0.15000","85","227","-142"
"1935","Creighton (NE)","3","5","1","0.38889","58","112","-54"
"1936","Creighton (NE)","4","4","0","0.50000","102","72","30"
"1937","Creighton (NE)","2","7","0","0.22222","45","141","-96"
"1938","Creighton (NE)","6","1","1","0.81250","179","40","139"
"1939","Creighton (NE)","4","5","0","0.44444","164","143","21"
"1942","Stanford (CA)","6","4","0","0.60000","204","121","83"
"1946","Stanford (CA)","6","3","1","0.65000","222","147","75"
"1947","Stanford (CA)","0","9","0","0.00000","73","214","-141"
"1948","Stanford (CA)","4","6","0","0.40000","164","159","5"
"1949","Stanford (CA)","7","3","1","0.68182","366","121","245"
"1950","Stanford (CA)","5","3","2","0.60000","188","124","64"
"1951","Stanford (CA)","9","2","0","0.81818","229","181","48"
"1952","Stanford (CA)","5","5","0","0.50000","187","226","-39"
"1953","Stanford (CA)","6","3","1","0.65000","246","148","98"
"1954","Stanford (CA)","4","6","0","0.40000","123","229","-106"
"1955","Stanford (CA)","6","3","1","0.65000","198","135","63"
"1956","Stanford (CA)","4","6","0","0.40000","218","213","5"
"1957","Stanford (CA)","6","4","0","0.60000","227","158","69"
"1940","West Texas A&M","7","3","0","0.70000","238","101","137"
"1941","West Texas A&M","8","2","0","0.80000","298","107","191"
"1946","Texas-El Paso","3","6","0","0.33333","136","150","-14"
"1947","Texas-El Paso","5","3","1","0.61111","159","79","80"
"1948","Texas-El Paso","8","2","1","0.77273","361","182","179"
"1949","Texas-El Paso","8","2","1","0.77273","292","113","179"
"1950","Utah","3","4","3","0.45000","240","254","-14"
"1951","Utah","7","4","0","0.63636","236","247","-11"
"1952","Utah","6","3","1","0.65000","188","128","60"
"1953","Utah","8","2","0","0.80000","264","150","114"
"1954","Utah","4","7","0","0.36364","172","212","-40"
"1955","Utah","6","3","0","0.66667","182","136","46"
"1956","Utah","5","5","0","0.50000","227","177","50"
"1957","Utah","6","4","0","0.60000","262","136","126"
"1958","Stanford (CA)","2","8","0","0.20000","93","226","-133"
"1959","Stanford (CA)","3","7","0","0.30000","232","261","-29"
"1960","Stanford (CA)","0","10","0","0.00000","111","254","-143"
"1961","Stanford (CA)","4","6","0","0.40000","105","163","-58"
"1962","Stanford (CA)","5","5","0","0.50000","124","174","-50"
"1959","Utah St.","5","6","0","0.45455","181","185","-4"
"1960","Utah St.","9","2","0","0.81818","274","85","189"
"1961","Utah St.","9","1","1","0.86364","396","102","294"
"1962","Utah St.","8","2","0","0.80000","273","139","134"
"1963","Stanford (CA)","3","7","0","0.30000","154","199","-45"
"1964","Stanford (CA)","5","5","0","0.50000","150","138","12"
"1965","Stanford (CA)","6","3","1","0.65000","144","149","-5"
"1966","Stanford (CA)","5","5","0","0.50000","149","146","3"
"1967","Stanford (CA)","5","5","0","0.50000","157","179","-22"
"1968","Stanford (CA)","6","3","1","0.65000","268","162","106"
"1969","Stanford (CA)","7","2","1","0.75000","349","172","177"
"1970","Stanford (CA)","9","3","0","0.75000","343","206","137"
"1971","Stanford (CA)","9","3","0","0.75000","261","135","126"
"1993","San Jose St. (CA)","2","9","0","0.18182","282","337","-55"
"1994","San Jose St. (CA)","3","8","0","0.27273","200","377","-177"
"1995","San Jose St. (CA)","3","8","0","0.27273","271","378","-107"
"1996","San Jose St. (CA)","3","9","0","0.25000","221","448","-227"
"1972","Stanford (CA)","6","5","0","0.54545","266","183","83"
"1973","Stanford (CA)","7","4","0","0.63636","244","240","4"
"1974","Stanford (CA)","5","4","2","0.54545","197","228","-31"
"1975","Stanford (CA)","6","4","1","0.59091","322","279","43"
"1976","Stanford (CA)","6","5","0","0.54545","239","284","-45"
"1977","Stanford (CA)","9","3","0","0.75000","285","279","6"
"1978","Stanford (CA)","8","4","0","0.66667","326","221","105"
"1992","Stanford (CA)","10","3","0","0.76923","320","196","124"
"1993","Stanford (CA)","4","7","0","0.36364","291","389","-98"
"1994","Stanford (CA)","3","7","1","0.31818","327","359","-32"
"1979","Stanford (CA)","5","5","1","0.50000","259","239","20"
"1995","Vanderbilt (TN)","2","9","0","0.18182","122","281","-159"
"1996","Vanderbilt (TN)","2","9","0","0.18182","122","234","-112"
"1980","Stanford (CA)","6","5","0","0.54545","312","275","37"
"1981","Stanford (CA)","4","7","0","0.36364","314","281","33"
"1982","Stanford (CA)","5","6","0","0.45455","328","297","31"
"1983","Stanford (CA)","1","10","0","0.09091","159","293","-134"
"1979","San Jose St. (CA)","6","4","1","0.59091","327","301","26"
"1980","San Jose St. (CA)","7","4","0","0.63636","294","259","35"
"1981","San Jose St. (CA)","9","3","0","0.75000","380","254","126"
"1982","San Jose St. (CA)","8","3","0","0.72727","331","199","132"
"1983","San Jose St. (CA)","5","6","0","0.45455","256","253","3"
"1984","Stanford (CA)","5","6","0","0.45455","239","279","-40"
"1985","Stanford (CA)","4","7","0","0.36364","245","313","-68"
"1986","Stanford (CA)","8","4","0","0.66667","279","191","88"
"1987","Stanford (CA)","5","6","0","0.45455","262","268","-6"
"1988","Stanford (CA)","3","6","2","0.36364","238","216","22"
"1981","Northwestern (IL)","0","11","0","0.00000","82","505","-423"
"1982","Northwestern (IL)","3","8","0","0.27273","206","379","-173"
"1983","Northwestern (IL)","2","9","0","0.18182","101","398","-297"
"1984","Northwestern (IL)","2","9","0","0.18182","138","349","-211"
"1985","Northwestern (IL)","3","8","0","0.27273","170","332","-162"
"1989","Stanford (CA)","3","8","0","0.27273","187","258","-71"
"1990","Stanford (CA)","5","6","0","0.45455","263","284","-21"
"1991","Stanford (CA)","8","4","0","0.66667","368","246","122"
"1995","Stanford (CA)","7","4","1","0.62500","344","307","37"
"1996","Stanford (CA)","7","5","0","0.58333","247","229","18"
"1997","Stanford (CA)","5","6","0","0.45455","276","317","-41"
"1998","Stanford (CA)","3","8","0","0.27273","261","365","-104"
"1999","Stanford (CA)","8","4","0","0.66667","418","364","54"
"2000","Stanford (CA)","5","6","0","0.45455","261","294","-33"
"2001","Stanford (CA)","9","3","0","0.75000","422","339","83"
"2002","Notre Dame (IN)","10","3","0","0.76923","290","217","73"
"2003","Notre Dame (IN)","5","7","0","0.41667","243","315","-72"
"2004","Notre Dame (IN)","6","5","0","0.54545","268","251","17"
"2005","Washington","2","9","0","0.18182","237","337","-100"
"2006","Washington","5","7","0","0.41667","262","311","-49"
"2007","Washington","4","9","0","0.30769","380","411","-31"
"2008","Washington","0","12","0","0.00000","159","463","-304"
"1985","Maine","6","5","0","0.54545","268","211","57"
"1986","Maine","7","4","0","0.63636","297","213","84"
"1987","Dartmouth (NH)","2","8","0","0.20000","110","302","-192"
"1988","Dartmouth (NH)","5","5","0","0.50000","209","198","11"
"1989","Dartmouth (NH)","5","5","0","0.50000","170","178","-8"
"1990","Dartmouth (NH)","7","2","1","0.75000","211","121","90"
"1991","Dartmouth (NH)","7","2","1","0.75000","283","209","74"
"1992","Tulane (LA)","2","9","0","0.18182","146","349","-203"
"1993","Tulane (LA)","4","8","0","0.33333","154","355","-201"
"1994","Tulane (LA)","1","10","0","0.09091","135","358","-223"
"1995","Tulane (LA)","2","9","0","0.18182","187","303","-116"
"1996","Tulane (LA)","2","9","0","0.18182","213","268","-55"
"2002","Stanford (CA)","2","9","0","0.18182","225","377","-152"
"2003","Stanford (CA)","4","7","0","0.36364","186","324","-138"
"2004","Stanford (CA)","4","7","0","0.36364","242","233","9"
"2005","Dartmouth (NH)","2","8","0","0.20000","126","260","-134"
"2006","Dartmouth (NH)","2","8","0","0.20000","147","254","-107"
"2007","Dartmouth (NH)","3","7","0","0.30000","271","347","-76"
"2008","Dartmouth (NH)","0","10","0","0.00000","129","343","-214"
"2009","Dartmouth (NH)","2","8","0","0.20000","161","282","-121"
"2010","Dartmouth (NH)","6","4","0","0.60000","264","212","52"
"2011","Dartmouth (NH)","5","5","0","0.50000","220","219","1"
"2012","Dartmouth (NH)","6","4","0","0.60000","251","210","41"
"2013","Dartmouth (NH)","6","4","0","0.60000","286","195","91"
"1989","Pacific (CA)","2","10","0","0.16667","179","406","-227"
"1990","Pacific (CA)","4","7","0","0.36364","353","411","-58"
"1991","Pacific (CA)","5","7","0","0.41667","435","481","-46"
"1997","Pittsburgh (PA)","6","6","0","0.50000","333","354","-21"
"1998","Pittsburgh (PA)","2","9","0","0.18182","234","334","-100"
"1999","Pittsburgh (PA)","5","6","0","0.45455","281","278","3"
"2000","Pittsburgh (PA)","7","5","0","0.58333","296","247","49"
"2001","Pittsburgh (PA)","7","5","0","0.58333","296","245","51"
"2002","Pittsburgh (PA)","9","4","0","0.69231","331","232","99"
"2003","Pittsburgh (PA)","8","5","0","0.61538","389","311","78"
"2004","Pittsburgh (PA)","8","4","0","0.66667","325","288","37"
"2005","Stanford (CA)","5","6","0","0.45455","269","337","-68"
"2006","Stanford (CA)","1","11","0","0.08333","127","377","-250"
"2004","San Diego (CA)","7","4","0","0.63636","397","266","131"
"2005","San Diego (CA)","11","1","0","0.91667","511","205","306"
"2006","San Diego (CA)","11","1","0","0.91667","514","155","359"
"2007","Stanford (CA)","4","8","0","0.33333","235","339","-104"
"2008","Stanford (CA)","5","7","0","0.41667","315","329","-14"
"2009","Stanford (CA)","8","5","0","0.61538","461","345","116"
"2010","Stanford (CA)","12","1","0","0.92308","524","226","298"
"2011","Stanford (CA)","11","2","0","0.84615","561","285","276"
"2012","Stanford (CA)","12","2","0","0.85714","390","241","149"
"2013","Stanford (CA)","11","3","0","0.78571","452","266","186"
"1890","Syracuse (NY)","8","3","0","0.72727","140","84","56"
"1894","Georgia","5","1","0","0.83333","156","20","136"
"1891","Syracuse (NY)","4","6","0","0.40000","122","229","-107"
"1892","Syracuse (NY)","0","8","1","0.05556","4","218","-214"
"1869","Rutgers (NJ)","2","2","0","0.50000","18","18","0"
"1870","Rutgers (NJ)","2","2","0","0.50000","17","17","0"
"1872","Columbia (NY)","5","4","0","0.55556","22","16","6"
"1873","Rutgers (NJ)","7","4","1","0.62500","31","26","5"
"1874","Harvard (MA)","9","7","0","0.56250","54","41","13"
"1875","Harvard (MA)","12","6","2","0.65000","52","29","23"
"1876","Harvard (MA)","13","8","1","0.61364","45","29","16"
"1877","Harvard (MA)","9","7","3","0.55263","31","21","10"
"1878","Pennsylvania","14","9","5","0.58929","42","24","18"
"1879","Harvard (MA)","13","9","12","0.55882","46","27","19"
"1880","Harvard (MA)","18","11","4","0.60606","75","53","22"
"1881","Rutgers (NJ)","22","18","8","0.54167","70","47","23"
"1882","Rutgers (NJ)","41","28","2","0.59155","176","111","65"
"1883","Rutgers (NJ)","38","32","1","0.54225","1288","965","323"
"1884","Pennsylvania","47","29","5","0.61111","1728","1184","544"
"1885","Michigan","34","17","4","0.65455","1437","612","825"
"1886","Lehigh (PA)","48","21","4","0.68493","1850","637","1213"
"1887","California","67","35","3","0.65238","2660","935","1725"
"1888","Princeton (NJ)","70","56","6","0.55303","2468","1899","569"
"1889","Brown (RI)","82","51","11","0.60764","2879","1796","1083"
"1890","Brown (RI)","77","76","9","0.50309","3002","2455","547"
"1891","Southern California","94","76","13","0.54918","2813","2189","624"
"1892","Minnesota","93","80","9","0.53571","2972","2394","578"
"1893","Duke (NC)","79","94","9","0.45879","2176","2912","-736"
"1894","Colorado St.","50","62","4","0.44828","1161","1518","-357"
"1895","Boston (MA)","31","44","11","0.42442","692","1031","-339"
"1896","Rhode Island","54","62","12","0.46875","1126","1201","-75"
"1897","Boston (MA)","32","40","6","0.44872","792","785","7"
"1898","Miami (OH)","47","23","4","0.66216","921","644","277"
"1899","New Hampshire","33","32","6","0.50704","571","522","49"
"1900","New Hampshire","22","35","11","0.40441","442","686","-244"
"1901","Marshall (WV)","18","34","3","0.35455","302","917","-615"
"1902","Saint John's (MN)","9","22","4","0.31429","148","460","-312"
"1903","Wichita St. (KS)","14","25","2","0.36585","376","546","-170"
"1904","Oklahoma St.","11","14","1","0.44231","194","394","-200"
"1905","Miami (OH)","7","25","5","0.25676","245","494","-249"
"1906","Rensselaer Tech (NY)","3","7","4","0.35714","92","107","-15"
"1907","Marshall (WV)","5","10","2","0.35294","71","238","-167"
"1908","Fort Hays St. (KS)","5","6","1","0.45833","56","91","-35"
"1909","Fort Hays St. (KS)","1","3","1","0.30000","12","68","-56"
"1910","Texas St.","0","1","0","0.00000","0","19","-19"
"1912","Fort Hays St. (KS)","1","2","0","0.33333","20","132","-112"
"1913","Eureka (IL)","1","6","0","0.14286","39","203","-164"
"1914","Eureka (IL)","3","4","0","0.42857","57","201","-144"
"1915","Texas St.","1","1","1","0.50000","13","20","-7"
"1916","Texas St.","0","2","1","0.16667","0","106","-106"
"1917","Boston (MA)","4","4","0","0.50000","73","136","-63"
"1918","Monmouth (IL)","1","7","0","0.12500","26","137","-111"
"1930","Troy (AL)","1","2","0","0.33333","7","73","-66"
"2013","Grambling St. (LA)","0","1","0","0.00000","0","0","0"
"1894","Syracuse (NY)","6","5","0","0.54545","180","157","23"
"1895","Syracuse (NY)","5","2","2","0.66667","142","46","96"
"1896","Syracuse (NY)","5","3","2","0.60000","194","78","116"
"1895","DePauw (IN)","3","3","1","0.50000","70","68","2"
"1897","Syracuse (NY)","5","3","1","0.61111","160","48","112"
"1898","Syracuse (NY)","8","2","1","0.77273","192","69","123"
"1899","Syracuse (NY)","4","4","0","0.50000","63","63","0"
"1899","Hamilton (NY)","8","2","1","0.77273","282","67","215"
"1900","Syracuse (NY)","7","2","1","0.75000","208","60","148"
"1901","Syracuse (NY)","7","1","0","0.87500","185","27","158"
"1902","Syracuse (NY)","6","2","1","0.72222","172","93","79"
"1903","Hamilton (NY)","6","3","0","0.66667","136","91","45"
"1904","Ohio St.","6","5","0","0.54545","219","123","96"
"1905","Ohio St.","8","2","2","0.75000","197","63","134"
"1908","Colgate (NY)","4","3","0","0.57143","78","25","53"
"1909","Kentucky","9","1","0","0.90000","261","29","232"
"1910","Kentucky","7","2","0","0.77778","140","29","111"
"1911","Miami (OH)","2","4","2","0.37500","57","45","12"
"1912","Kentucky","7","2","0","0.77778","250","41","209"
"1913","West Virginia","3","4","2","0.44444","109","137","-28"
"1914","Tulane (LA)","3","3","1","0.50000","145","147","-2"
"1903","Syracuse (NY)","5","4","0","0.55556","200","69","131"
"1904","Syracuse (NY)","6","3","0","0.66667","405","57","348"
"1905","Syracuse (NY)","8","3","0","0.72727","224","69","155"
"1906","Wisconsin","5","0","0","1.00000","78","15","63"
"1907","Wisconsin","3","1","1","0.70000","50","51","-1"
"1902","Colgate (NY)","5","3","1","0.61111","167","55","112"
"1904","Colgate (NY)","8","1","1","0.85000","268","30","238"
"1905","Colgate (NY)","5","4","0","0.55556","217","83","134"
"1906","Syracuse (NY)","6","3","0","0.66667","168","75","93"
"1907","Syracuse (NY)","5","3","1","0.61111","133","64","69"
"1913","Syracuse (NY)","6","4","0","0.60000","271","126","145"
"1914","Syracuse (NY)","5","3","2","0.60000","202","95","107"
"1915","Syracuse (NY)","9","2","2","0.76923","338","29","309"
"1917","Syracuse (NY)","8","1","1","0.85000","197","61","136"
"1918","Syracuse (NY)","5","1","0","0.83333","141","21","120"
"1919","Syracuse (NY)","8","3","0","0.72727","123","41","82"
"1920","Columbia (NY)","4","4","0","0.50000","96","120","-24"
"1921","Columbia (NY)","2","6","0","0.25000","89","148","-59"
"1922","Columbia (NY)","4","5","0","0.44444","147","188","-41"
"1908","Syracuse (NY)","6","3","1","0.65000","171","39","132"
"1909","Yale (CT)","10","0","0","1.00000","209","0","209"
"1910","Ohio St.","6","1","3","0.75000","182","27","155"
"1913","Yale (CT)","5","2","3","0.65000","126","34","92"
"1916","Iowa","4","3","0","0.57143","121","156","-35"
"1917","Iowa","3","6","0","0.33333","91","160","-69"
"1918","Iowa","6","2","1","0.72222","123","36","87"
"1919","Iowa","5","2","0","0.71429","90","44","46"
"1920","Iowa","5","2","0","0.71429","142","54","88"
"1921","Iowa","7","0","0","1.00000","185","36","149"
"1922","Iowa","7","0","0","1.00000","208","33","175"
"1923","Iowa","5","3","0","0.62500","124","55","69"
"1924","Duke (NC)","4","5","0","0.44444","129","99","30"
"1925","Southern California","11","2","0","0.84615","456","55","401"
"1926","Southern California","8","2","0","0.80000","317","52","265"
"1927","Southern California","8","1","1","0.85000","287","64","223"
"1928","Southern California","9","0","1","0.95000","267","59","208"
"1929","Southern California","10","2","0","0.83333","492","69","423"
"1930","Southern California","8","2","0","0.80000","382","66","316"
"1931","Southern California","10","1","0","0.90909","363","52","311"
"1932","Southern California","10","0","0","1.00000","201","13","188"
"1933","Southern California","10","1","1","0.87500","257","30","227"
"1934","Southern California","4","6","1","0.40909","120","110","10"
"1935","Southern California","5","7","0","0.41667","155","124","31"
"1936","Southern California","4","2","3","0.61111","129","65","64"
"1937","Southern California","4","4","2","0.50000","136","98","38"
"1938","Southern California","9","2","0","0.81818","172","65","107"
"1939","Southern California","8","0","2","0.90000","181","33","148"
"1940","Southern California","3","4","2","0.44444","88","98","-10"
"1909","Syracuse (NY)","4","5","1","0.45000","110","100","10"
"1910","Syracuse (NY)","5","4","1","0.55000","53","42","11"
"1916","Yale (CT)","8","1","0","0.88889","182","44","138"
"1917","Yale (CT)","3","0","0","1.00000","47","0","47"
"1920","Yale (CT)","5","3","0","0.62500","137","67","70"
"1921","Yale (CT)","8","1","0","0.88889","202","31","171"
"1922","Yale (CT)","6","3","1","0.65000","192","29","163"
"1923","Yale (CT)","8","0","0","1.00000","230","38","192"
"1924","Yale (CT)","6","0","2","0.87500","144","36","108"
"1925","Yale (CT)","5","2","1","0.68750","204","76","128"
"1926","Yale (CT)","4","4","0","0.50000","103","79","24"
"1927","Yale (CT)","7","1","0","0.87500","157","32","125"
"1911","Syracuse (NY)","5","3","2","0.60000","63","59","4"
"1912","Syracuse (NY)","4","5","0","0.44444","95","160","-65"
"1909","Penn St.","5","0","2","0.85714","166","11","155"
"1910","Missouri","4","2","2","0.62500","77","17","60"
"1911","Penn St.","8","0","1","0.94444","199","15","184"
"1912","Penn St.","8","0","0","1.00000","285","6","279"
"1913","Penn St.","2","6","0","0.25000","78","94","-16"
"1914","Penn St.","5","3","1","0.61111","121","52","69"
"1916","Syracuse (NY)","5","4","0","0.55556","276","87","189"
"1920","Syracuse (NY)","6","2","1","0.72222","201","27","174"
"1921","Syracuse (NY)","7","2","0","0.77778","194","59","135"
"1922","Syracuse (NY)","6","1","2","0.77778","176","41","135"
"1923","Syracuse (NY)","8","1","0","0.88889","237","19","218"
"1924","Syracuse (NY)","8","2","1","0.77273","154","58","96"
"1925","New York (NY)","6","2","1","0.72222","168","45","123"
"1926","New York (NY)","8","1","0","0.88889","172","25","147"
"1927","New York (NY)","7","1","2","0.80000","345","65","280"
"1928","New York (NY)","8","2","0","0.80000","316","71","245"
"1929","New York (NY)","7","3","0","0.70000","184","92","92"
"1930","New York (NY)","7","3","0","0.70000","201","40","161"
"1931","New York (NY)","6","3","1","0.65000","212","47","165"
"1932","Manhattan (NY)","6","3","2","0.63636","144","53","91"
"1933","Manhattan (NY)","5","3","1","0.61111","104","107","-3"
"1934","Manhattan (NY)","3","5","1","0.38889","65","150","-85"
"1935","Manhattan (NY)","5","3","1","0.61111","248","117","131"
"1936","Manhattan (NY)","6","4","0","0.60000","145","92","53"
"1937","Manhattan (NY)","6","3","1","0.65000","86","84","2"
"1914","Hamilton (NY)","3","4","0","0.42857","54","158","-104"
"1915","Hamilton (NY)","5","1","2","0.75000","90","37","53"
"1916","Hamilton (NY)","3","4","0","0.42857","66","91","-25"
"1919","Bucknell (PA)","5","4","1","0.55000","142","62","80"
"1920","Bucknell (PA)","6","3","0","0.66667","244","37","207"
"1921","Bucknell (PA)","5","3","1","0.61111","179","59","120"
"1922","Bucknell (PA)","7","4","0","0.63636","260","94","166"
"1923","Bucknell (PA)","4","4","1","0.50000","160","94","66"
"1925","Syracuse (NY)","8","1","1","0.85000","202","27","175"
"1926","Syracuse (NY)","7","2","1","0.75000","227","58","169"
"1927","Syracuse (NY)","5","3","2","0.60000","116","81","35"
"1928","Syracuse (NY)","4","4","1","0.50000","136","79","57"
"1929","Syracuse (NY)","6","3","0","0.66667","259","46","213"
"1930","Syracuse (NY)","5","2","2","0.66667","207","79","128"
"1931","Syracuse (NY)","7","1","1","0.83333","238","56","182"
"1932","Syracuse (NY)","4","4","1","0.50000","137","96","41"
"1933","Syracuse (NY)","4","4","0","0.50000","131","79","52"
"1934","Syracuse (NY)","6","2","0","0.75000","141","42","99"
"1935","Syracuse (NY)","6","1","1","0.81250","112","56","56"
"1936","Syracuse (NY)","1","7","0","0.12500","45","116","-71"
"1921","Drake (IA)","5","2","0","0.71429","149","40","109"
"1922","Drake (IA)","7","0","0","1.00000","155","26","129"
"1923","Drake (IA)","5","2","0","0.71429","168","49","119"
"1924","Drake (IA)","5","2","1","0.68750","106","56","50"
"1925","Drake (IA)","5","3","0","0.62500","65","41","24"
"1926","Drake (IA)","2","6","0","0.25000","60","118","-58"
"1927","Drake (IA)","3","6","0","0.33333","89","158","-69"
"1928","Drake (IA)","7","1","0","0.87500","141","52","89"
"1929","Drake (IA)","5","3","1","0.61111","145","79","66"
"1930","Drake (IA)","5","4","0","0.55556","166","120","46"
"1931","Drake (IA)","5","6","0","0.45455","130","226","-96"
"1932","Iowa","1","7","0","0.12500","62","171","-109"
"1933","Iowa","5","3","0","0.62500","131","56","75"
"1934","Iowa","2","5","1","0.31250","98","153","-55"
"1935","Iowa","4","2","2","0.62500","122","39","83"
"1936","Iowa","3","4","1","0.43750","85","103","-18"
"1937","Syracuse (NY)","5","2","1","0.68750","132","57","75"
"1938","Syracuse (NY)","5","3","0","0.62500","137","102","35"
"1939","Syracuse (NY)","3","3","2","0.50000","63","92","-29"
"1940","Syracuse (NY)","3","4","1","0.43750","114","134","-20"
"1941","Syracuse (NY)","5","2","1","0.68750","190","86","104"
"1942","Syracuse (NY)","6","3","0","0.66667","152","61","91"
"1944","Syracuse (NY)","2","4","1","0.35714","102","152","-50"
"1945","Syracuse (NY)","1","6","0","0.14286","38","106","-68"
"1946","Syracuse (NY)","4","5","0","0.44444","146","158","-12"
"1947","Michigan St.","7","2","0","0.77778","167","101","66"
"1948","Michigan St.","6","2","2","0.70000","359","130","229"
"1949","Michigan St.","6","3","0","0.66667","309","107","202"
"1950","Michigan St.","8","1","0","0.88889","243","107","136"
"1951","Michigan St.","9","0","0","1.00000","270","114","156"
"1952","Michigan St.","9","0","0","1.00000","312","84","228"
"1953","Michigan St.","9","1","0","0.90000","240","110","130"
"1947","Syracuse (NY)","3","6","0","0.33333","77","167","-90"
"1948","Syracuse (NY)","1","8","0","0.11111","89","244","-155"
"1949","Syracuse (NY)","4","5","0","0.44444","207","215","-8"
"1950","Syracuse (NY)","5","5","0","0.50000","199","139","60"
"1951","Syracuse (NY)","5","4","0","0.55556","180","147","33"
"1952","Syracuse (NY)","7","3","0","0.70000","203","202","1"
"1953","Syracuse (NY)","5","3","1","0.61111","197","99","98"
"1954","Syracuse (NY)","4","4","0","0.50000","135","147","-12"
"1955","Syracuse (NY)","5","3","0","0.62500","180","130","50"
"1956","Syracuse (NY)","7","2","0","0.77778","230","117","113"
"1957","Syracuse (NY)","5","3","1","0.61111","183","110","73"
"1958","Syracuse (NY)","8","2","0","0.80000","270","80","190"
"1959","Syracuse (NY)","11","0","0","1.00000","413","73","340"
"1960","Syracuse (NY)","7","2","0","0.77778","203","74","129"
"1961","Syracuse (NY)","8","3","0","0.72727","268","131","137"
"1962","Syracuse (NY)","5","5","0","0.50000","159","110","49"
"1963","Syracuse (NY)","8","2","0","0.80000","255","101","154"
"1964","Syracuse (NY)","7","4","0","0.63636","264","157","107"
"1965","Syracuse (NY)","7","3","0","0.70000","237","146","91"
"1966","Syracuse (NY)","8","3","0","0.72727","266","156","110"
"1967","Syracuse (NY)","8","2","0","0.80000","210","127","83"
"1968","Syracuse (NY)","6","4","0","0.60000","252","154","98"
"1969","Syracuse (NY)","5","5","0","0.50000","169","126","43"
"1970","Syracuse (NY)","6","4","0","0.60000","248","208","40"
"1971","Syracuse (NY)","5","5","1","0.50000","197","179","18"
"1972","Syracuse (NY)","5","6","0","0.45455","141","229","-88"
"1973","Syracuse (NY)","2","9","0","0.18182","129","288","-159"
"1974","Syracuse (NY)","2","9","0","0.18182","121","271","-150"
"1975","Syracuse (NY)","6","5","0","0.54545","174","182","-8"
"1976","Syracuse (NY)","3","8","0","0.27273","154","263","-109"
"1977","Syracuse (NY)","6","5","0","0.54545","218","234","-16"
"1978","Syracuse (NY)","3","8","0","0.27273","192","295","-103"
"1979","Syracuse (NY)","7","5","0","0.58333","324","293","31"
"1980","Syracuse (NY)","5","6","0","0.45455","207","222","-15"
"1971","Massachusetts","4","4","1","0.50000","147","209","-62"
"1972","Massachusetts","9","2","0","0.81818","369","155","214"
"1973","Massachusetts","6","5","0","0.54545","231","244","-13"
"1974","Massachusetts","5","6","0","0.45455","219","232","-13"
"1975","Massachusetts","8","2","0","0.80000","210","102","108"
"1976","Massachusetts","5","5","0","0.50000","146","178","-32"
"1977","Massachusetts","8","3","0","0.72727","274","145","129"
"1981","Syracuse (NY)","4","6","1","0.40909","248","265","-17"
"1982","Syracuse (NY)","2","9","0","0.18182","159","244","-85"
"1983","Syracuse (NY)","6","5","0","0.54545","178","200","-22"
"1984","Syracuse (NY)","6","5","0","0.54545","151","151","0"
"1985","Syracuse (NY)","7","5","0","0.58333","284","195","89"
"1986","Syracuse (NY)","5","6","0","0.45455","241","266","-25"
"1987","Syracuse (NY)","11","0","1","0.95833","379","169","210"
"1988","Syracuse (NY)","10","2","0","0.83333","341","189","152"
"1989","Syracuse (NY)","8","4","0","0.66667","286","242","44"
"1990","Syracuse (NY)","7","4","2","0.61538","341","213","128"
"1982","Western Connecticut St.","2","7","0","0.22222","90","188","-98"
"1983","Western Connecticut St.","7","3","0","0.70000","192","129","63"
"1984","Western Connecticut St.","9","1","0","0.90000","282","96","186"
"1985","Western Connecticut St.","10","2","0","0.83333","374","170","204"
"1986","Western Connecticut St.","6","4","0","0.60000","221","166","55"
"1991","Syracuse (NY)","10","2","0","0.83333","321","200","121"
"1992","Syracuse (NY)","10","2","0","0.83333","340","205","135"
"1993","Syracuse (NY)","6","4","1","0.59091","281","288","-7"
"1994","Syracuse (NY)","7","4","0","0.63636","256","259","-3"
"1995","Syracuse (NY)","9","3","0","0.75000","375","213","162"
"1996","Syracuse (NY)","9","3","0","0.75000","437","208","229"
"1997","Syracuse (NY)","9","4","0","0.69231","441","226","215"
"1998","Syracuse (NY)","8","4","0","0.66667","478","300","178"
"1999","Syracuse (NY)","7","5","0","0.58333","300","256","44"
"2000","Syracuse (NY)","6","5","0","0.54545","294","212","82"
"2001","Syracuse (NY)","10","3","0","0.76923","334","247","87"
"2002","Syracuse (NY)","4","8","0","0.33333","347","406","-59"
"2003","Syracuse (NY)","6","6","0","0.50000","320","301","19"
"2004","Syracuse (NY)","6","6","0","0.50000","287","344","-57"
"2011","Connecticut","5","7","0","0.41667","291","292","-1"
"2012","Connecticut","5","7","0","0.41667","213","238","-25"
"2013","Connecticut","0","4","0","0.00000","72","130","-58"
"2005","Syracuse (NY)","1","10","0","0.09091","152","295","-143"
"2006","Syracuse (NY)","4","8","0","0.33333","209","295","-86"
"2007","Syracuse (NY)","2","10","0","0.16667","197","418","-221"
"2008","Syracuse (NY)","3","9","0","0.25000","217","392","-175"
"2009","Syracuse (NY)","4","8","0","0.33333","254","335","-81"
"2010","Syracuse (NY)","8","5","0","0.61538","288","251","37"
"2011","Syracuse (NY)","5","7","0","0.41667","290","342","-52"
"2012","Syracuse (NY)","8","5","0","0.61538","390","322","68"
"2013","Syracuse (NY)","7","6","0","0.53846","295","330","-35"
"1894","Temple (PA)","4","1","0","0.80000","70","32","38"
"1895","Temple (PA)","1","4","1","0.25000","30","89","-59"
"1896","Temple (PA)","3","2","0","0.60000","50","32","18"
"1897","Temple (PA)","3","3","0","0.50000","100","85","15"
"1898","Temple (PA)","2","5","0","0.28571","32","133","-101"
"1899","Temple (PA)","1","4","1","0.25000","27","127","-100"
"1900","Temple (PA)","3","4","1","0.43750","95","69","26"
"1899","Franklin & Marshall (PA)","3","5","1","0.38889","158","146","12"
"1901","Temple (PA)","3","2","0","0.60000","37","65","-28"
"1902","Temple (PA)","1","4","1","0.25000","29","62","-33"
"1903","Temple (PA)","4","1","0","0.80000","56","18","38"
"1904","Temple (PA)","3","2","0","0.60000","65","23","42"
"1905","Temple (PA)","2","0","1","0.83333","48","12","36"
"1907","Temple (PA)","4","0","2","0.83333","82","40","42"
"1908","Temple (PA)","3","2","1","0.58333","55","73","-18"
"1909","Temple (PA)","0","4","1","0.10000","0","99","-99"
"1910","Temple (PA)","3","4","0","0.42857","64","140","-76"
"1911","Temple (PA)","6","1","0","0.85714","90","54","36"
"1912","Temple (PA)","3","4","0","0.42857","44","119","-75"
"1913","Temple (PA)","1","4","2","0.28571","31","109","-78"
"1914","Temple (PA)","5","4","1","0.55000","163","89","74"
"1915","Temple (PA)","3","1","1","0.70000","32","40","-8"
"1916","Temple (PA)","4","1","2","0.71429","67","14","53"
"1917","Temple (PA)","0","6","1","0.07143","6","12","-6"
"1872","Stevens Tech (NJ)","0","1","0","0.00000","0","6","-6"
"1873","New York (NY)","3","3","0","0.50000","15","13","2"
"1874","Stevens Tech (NJ)","2","3","0","0.40000","10","20","-10"
"1875","Stevens Tech (NJ)","4","4","0","0.50000","21","20","1"
"1876","New York (NY)","2","3","1","0.41667","16","19","-3"
"1877","Stevens Tech (NJ)","3","1","2","0.66667","9","14","-5"
"1878","Stevens Tech (NJ)","3","3","3","0.50000","3","9","-6"
"1879","Stevens Tech (NJ)","2","3","5","0.45000","8","14","-6"
"1880","Stevens Tech (NJ)","1","5","0","0.16667","3","16","-13"
"1881","Stevens Tech (NJ)","3","8","3","0.32143","16","29","-13"
"1882","Lawrence (WI)","7","8","1","0.46875","17","25","-8"
"1883","Stevens Tech (NJ)","7","6","1","0.53571","187","128","59"
"1884","Fordham (NY)","9","10","0","0.47368","221","261","-40"
"1885","Georgetown (DC)","5","17","1","0.23913","359","612","-253"
"1886","New York (NY)","9","15","2","0.38462","180","565","-385"
"1887","Fordham (NY)","8","12","1","0.40476","157","445","-288"
"1888","Amherst (MA)","6","17","3","0.28846","192","791","-599"
"1889","New York (NY)","8","21","4","0.30303","278","647","-369"
"1890","New York (NY)","25","14","2","0.63415","727","538","189"
"1891","Delaware","32","30","7","0.51449","966","971","-5"
"1892","Beloit (WI)","29","31","3","0.48413","726","797","-71"
"1893","Marquette (WI)","39","34","3","0.53289","1091","885","206"
"1894","Manhattan (NY)","32","29","7","0.52206","853","692","161"
"1895","Delaware","44","35","6","0.55294","889","813","76"
"1896","Manhattan (NY)","51","49","6","0.50943","949","1164","-215"
"1897","Stevens Tech (NJ)","37","50","4","0.42857","661","1048","-387"
"1898","Manhattan (NY)","37","43","9","0.46629","781","1050","-269"
"1899","Manhattan (NY)","34","40","6","0.46250","594","1063","-469"
"1900","Manhattan (NY)","43","47","11","0.48020","991","1049","-58"
"1901","Ferris St. (MI)","51","44","7","0.53431","906","852","54"
"1902","Indiana St.","56","48","5","0.53670","1053","927","126"
"1903","Manhattan (NY)","30","49","7","0.38953","762","1319","-557"
"1904","Saint Francis (NY)","44","53","9","0.45755","787","1363","-576"
"1905","Bluffton (OH)","38","59","5","0.39706","850","1433","-583"
"1906","Ferris St. (MI)","32","43","12","0.43678","677","854","-177"
"1907","Ferris St. (MI)","32","48","10","0.41111","722","1208","-486"
"1908","Western Illinois","36","45","10","0.45055","760","1069","-309"
"1909","Delaware Valley (PA)","27","52","2","0.34568","682","1287","-605"
"1910","East Stroudsburg (PA)","23","31","3","0.42982","583","738","-155"
"1911","Western Illinois","32","44","7","0.42771","661","902","-241"
"1912","Indiana (PA)","36","56","7","0.39899","1134","1463","-329"
"1913","Saint Francis (NY)","52","67","8","0.44094","1672","2360","-688"
"1914","Delaware Valley (PA)","41","50","6","0.45361","1217","1585","-368"
"1915","Western Illinois","34","35","11","0.49375","932","1217","-285"
"1916","Morgan St. (MD)","44","43","7","0.50532","1493","1270","223"
"1917","Morgan St. (MD)","21","21","2","0.50000","408","883","-475"
"1918","Oklahoma Baptist University","7","16","2","0.32000","258","358","-100"
"1919","Western Illinois","53","41","8","0.55882","1478","1056","422"
"1920","Virginia Union","28","39","2","0.42029","506","893","-387"
"1921","Cooper Union (NY)","19","34","3","0.36607","441","1112","-671"
"1922","Cooper Union (NY)","27","34","6","0.44776","703","832","-129"
"1923","Cooper Union (NY)","31","45","2","0.41026","718","1112","-394"
"1924","East Stroudsburg (PA)","34","40","6","0.46250","946","1175","-229"
"1925","Saint Anselm (NH)","32","28","10","0.52857","847","802","45"
"1926","Saint Anselm (NH)","22","30","4","0.42857","515","702","-187"
"1927","Bethune-Cookman (FL)","20","29","8","0.42105","674","783","-109"
"1928","Saint Anselm (NH)","28","24","7","0.53390","564","1095","-531"
"1929","Saint Anselm (NH)","25","32","5","0.44355","616","843","-227"
"1930","Saint Anselm (NH)","31","27","10","0.52941","643","549","94"
"1931","Campbell (NC)","21","17","4","0.54762","465","428","37"
"1932","Campbell (NC)","7","30","3","0.21250","254","760","-506"
"1933","Campbell (NC)","11","13","3","0.46296","262","324","-62"
"1934","Bowie St. (MD)","4","7","2","0.38462","116","94","22"
"1935","Florida Southern","7","12","1","0.37500","170","162","8"
"1936","Bowie St. (MD)","5","2","1","0.68750","154","97","57"
"1937","Bowie St. (MD)","6","3","0","0.66667","98","87","11"
"1938","West Alabama","7","5","0","0.58333","151","88","63"
"1939","Elizabeth City St. (NC)","7","13","0","0.35000","150","307","-157"
"1940","Elizabeth City St. (NC)","6","5","4","0.53333","128","67","61"
"1941","Arkansas-Pine Bluff","3","9","5","0.32353","178","223","-45"
"1942","Brevard College (NC)","10","6","2","0.61111","225","189","36"
"1943","Clark Atlanta (GA)","6","8","0","0.42857","127","206","-79"
"1944","Abilene Christian (TX)","9","11","1","0.45238","158","255","-97"
"1945","Benedict (SC)","10","15","2","0.40741","299","296","3"
"1946","Elizabeth City St. (NC)","7","20","3","0.28333","144","540","-396"
"1947","Clark Atlanta (GA)","3","6","2","0.36364","49","230","-181"
"1948","Virginia-Lynchburg","4","6","1","0.40909","77","302","-225"
"1949","Virginia-Lynchburg","0","3","1","0.12500","7","70","-63"
"1950","Virginia-Lynchburg","2","3","0","0.40000","53","98","-45"
"1951","Lane (TN)","8","6","0","0.57143","295","234","61"
"1952","Lane (TN)","9","5","1","0.63333","220","206","14"
"1953","Lane (TN)","1","7","0","0.12500","58","215","-157"
"1954","Lane (TN)","2","6","0","0.25000","105","135","-30"
"1955","Lane (TN)","2","4","0","0.33333","83","129","-46"
"1957","Louisiana College","2","7","0","0.22222","106","179","-73"
"1959","Azusa Pacific (CA)","2","3","0","0.40000","117","90","27"
"1960","Azusa Pacific (CA)","4","3","1","0.56250","103","76","27"
"1961","Azusa Pacific (CA)","3","3","0","0.50000","123","147","-24"
"1963","San Francisco (CA)","2","5","0","0.28571","58","98","-40"
"1964","New York (NY)","0","2","0","0.00000","20","48","-28"
"1965","Adelphi (NY)","4","8","0","0.33333","198","216","-18"
"1966","Fairfield (CT)","18","22","2","0.45238","545","652","-107"
"1967","La Salle (PA)","25","31","0","0.44643","846","1080","-234"
"1968","Centenary (LA)","17","42","2","0.29508","726","1393","-667"
"1969","Bluffton (OH)","33","43","0","0.43421","1058","1548","-490"
"1970","Saint John's (NY)","35","54","1","0.39444","1379","1783","-404"
"1971","Bluffton (OH)","43","45","1","0.48876","1360","1384","-24"
"1972","Marquette (WI)","39","44","2","0.47059","1217","1351","-134"
"1973","Brooklyn (NY)","30","52","1","0.36747","1007","1611","-604"
"1974","Marquette (WI)","33","36","3","0.47917","959","1169","-210"
"1975","Marquette (WI)","31","22","4","0.57895","1042","932","110"
"1976","Bluffton (OH)","23","33","1","0.41228","862","1186","-324"
"1977","Manhattan (NY)","14","28","1","0.33721","568","923","-355"
"1978","Fairfield (CT)","5","7","1","0.42308","194","203","-9"
"1979","Fairfield (CT)","7","8","0","0.46667","247","260","-13"
"1980","Westfield St. (MA)","6","5","4","0.53333","184","196","-12"
"1981","San Francisco (CA)","17","14","0","0.54839","567","498","69"
"1982","Manhattan (NY)","18","16","0","0.52941","580","644","-64"
"1983","SUNY-Stony Brook (NY)","15","11","0","0.57692","474","453","21"
"1984","Stonehill (MA)","7","12","0","0.36842","231","439","-208"
"1985","Manhattan (NY)","10","10","0","0.50000","313","316","-3"
"1986","Marquette (WI)","13","17","0","0.43333","497","564","-67"
"1987","Marquette (WI)","10","17","0","0.37037","389","487","-98"
"1988","Marquette (WI)","1","5","0","0.16667","80","125","-45"
"1989","Marquette (WI)","4","4","0","0.50000","209","151","58"
"1990","Marquette (WI)","1","7","0","0.12500","80","180","-100"
"1991","Marquette (WI)","1","5","0","0.16667","106","182","-76"
"1992","Marquette (WI)","2","5","0","0.28571","81","129","-48"
"1993","Marquette (WI)","7","1","0","0.87500","212","126","86"
"1994","Marquette (WI)","1","6","0","0.14286","125","184","-59"
"1995","Marquette (WI)","3","4","0","0.42857","141","191","-50"
"1996","Marquette (WI)","3","5","0","0.37500","139","182","-43"
"1998","Madison College (WI)","2","15","0","0.11765","221","613","-392"
"1999","Marquette (WI)","0","7","0","0.00000","110","298","-188"
"2000","Marquette (WI)","1","5","0","0.16667","60","96","-36"
"2001","Marquette (WI)","2","6","0","0.25000","144","179","-35"
"2002","Marquette (WI)","3","4","0","0.42857","127","208","-81"
"2003","Marquette (WI)","1","6","0","0.14286","71","151","-80"
"2004","Marquette (WI)","0","6","0","0.00000","53","238","-185"
"2005","Marquette (WI)","2","5","0","0.28571","92","226","-134"
"2006","Marquette (WI)","1","6","0","0.14286","62","206","-144"
"2007","Marquette (WI)","2","5","0","0.28571","140","215","-75"
"2008","Marquette (WI)","0","7","0","0.00000","61","304","-243"
"2009","Marquette (WI)","0","1","0","0.00000","0","22","-22"
"1922","Temple (PA)","1","4","1","0.25000","26","123","-97"
"1923","Temple (PA)","0","5","0","0.00000","13","101","-88"
"1924","Temple (PA)","1","4","0","0.20000","15","106","-91"
"1925","Temple (PA)","5","2","2","0.66667","104","39","65"
"1926","Temple (PA)","5","3","0","0.62500","89","93","-4"
"1927","Temple (PA)","7","1","0","0.87500","351","60","291"
"1928","Temple (PA)","7","1","2","0.80000","224","23","201"
"1929","Temple (PA)","6","3","1","0.65000","141","65","76"
"1930","Temple (PA)","7","3","0","0.70000","224","110","114"
"1931","Temple (PA)","8","1","1","0.85000","158","42","116"
"1932","Temple (PA)","5","1","2","0.75000","105","53","52"
"1895","Iowa St.","3","5","0","0.37500","108","56","52"
"1896","Georgia","4","0","0","1.00000","86","22","64"
"1897","Cornell (NY)","5","3","1","0.61111","133","42","91"
"1898","Cornell (NY)","10","2","0","0.83333","296","29","267"
"1899","Carlisle Indian School (PA)","9","2","0","0.81818","365","50","315"
"1900","Carlisle Indian School (PA)","6","4","1","0.59091","212","92","120"
"1901","Carlisle Indian School (PA)","5","7","1","0.42308","133","168","-35"
"1902","Carlisle Indian School (PA)","8","3","0","0.72727","251","51","200"
"1903","Carlisle Indian School (PA)","11","2","1","0.82143","274","52","222"
"1904","Cornell (NY)","7","3","0","0.70000","226","92","134"
"1905","Cornell (NY)","6","4","0","0.60000","173","59","114"
"1906","Cornell (NY)","8","1","2","0.81818","237","37","200"
"1907","Carlisle Indian School (PA)","10","1","0","0.90909","267","62","205"
"1908","Carlisle Indian School (PA)","10","2","1","0.80769","222","55","167"
"1909","Carlisle Indian School (PA)","8","3","1","0.70833","243","94","149"
"1910","Carlisle Indian School (PA)","8","6","0","0.57143","235","69","166"
"1911","Carlisle Indian School (PA)","11","1","0","0.91667","298","49","249"
"1912","Carlisle Indian School (PA)","12","1","1","0.89286","503","120","383"
"1913","Carlisle Indian School (PA)","10","1","1","0.87500","296","63","233"
"1914","Carlisle Indian School (PA)","5","9","1","0.36667","125","174","-49"
"1915","Pittsburgh (PA)","8","0","0","1.00000","247","19","228"
"1916","Pittsburgh (PA)","8","0","0","1.00000","255","25","230"
"1917","Pittsburgh (PA)","10","0","0","1.00000","260","21","239"
"1918","Pittsburgh (PA)","4","1","0","0.80000","140","16","124"
"1919","Pittsburgh (PA)","6","2","1","0.72222","119","66","53"
"1920","Pittsburgh (PA)","6","0","2","0.87500","146","44","102"
"1921","Pittsburgh (PA)","5","3","1","0.61111","133","51","82"
"1922","Pittsburgh (PA)","8","2","0","0.80000","190","43","147"
"1923","Pittsburgh (PA)","5","4","0","0.55556","83","39","44"
"1924","Stanford (CA)","7","1","1","0.83333","179","69","110"
"1925","Stanford (CA)","7","2","0","0.77778","231","71","160"
"1926","Stanford (CA)","10","0","1","0.95455","268","73","195"
"1927","Stanford (CA)","8","2","1","0.77273","162","82","80"
"1928","Stanford (CA)","8","3","1","0.70833","274","69","205"
"1929","Stanford (CA)","9","2","0","0.81818","288","53","235"
"1930","Stanford (CA)","9","1","1","0.86364","252","69","183"
"1931","Stanford (CA)","7","2","2","0.72727","160","44","116"
"1932","Stanford (CA)","6","4","1","0.59091","171","58","113"
"1933","Temple (PA)","5","3","0","0.62500","110","96","14"
"1934","Temple (PA)","7","1","2","0.80000","220","57","163"
"1935","Temple (PA)","7","3","0","0.70000","181","68","113"
"1936","Temple (PA)","6","3","2","0.63636","117","66","51"
"1937","Temple (PA)","3","2","4","0.55556","38","59","-21"
"1938","Temple (PA)","3","6","1","0.35000","97","170","-73"
"1939","Temple (PA)","2","7","0","0.22222","51","96","-45"
"1915","Southern Methodist (TX)","2","5","0","0.28571","20","131","-111"
"1916","Southern Methodist (TX)","0","8","2","0.10000","27","455","-428"
"1918","Vanderbilt (TN)","4","2","0","0.66667","176","31","145"
"1924","Southern Methodist (TX)","5","1","4","0.70000","92","62","30"
"1925","Southern Methodist (TX)","5","2","2","0.66667","148","41","107"
"1926","Southern Methodist (TX)","8","0","1","0.94444","229","47","182"
"1927","Southern Methodist (TX)","7","2","0","0.77778","267","81","186"
"1928","Southern Methodist (TX)","6","3","1","0.65000","254","78","176"
"1929","Southern Methodist (TX)","6","0","4","0.80000","172","36","136"
"1930","Southern Methodist (TX)","6","3","1","0.65000","187","93","94"
"1931","Southern Methodist (TX)","9","1","1","0.86364","160","48","112"
"1932","Southern Methodist (TX)","3","7","2","0.33333","82","112","-30"
"1933","Southern Methodist (TX)","4","7","1","0.37500","99","104","-5"
"1934","Southern Methodist (TX)","8","2","2","0.75000","224","63","161"
"1935","Vanderbilt (TN)","7","3","0","0.70000","179","68","111"
"1936","Vanderbilt (TN)","3","5","1","0.38889","115","87","28"
"1937","Vanderbilt (TN)","7","2","0","0.77778","121","42","79"
"1938","Vanderbilt (TN)","6","3","0","0.66667","86","49","37"
"1939","Vanderbilt (TN)","2","7","1","0.25000","96","165","-69"
"1940","Temple (PA)","4","4","1","0.50000","155","113","42"
"1941","Temple (PA)","7","2","0","0.77778","176","146","30"
"1942","Temple (PA)","2","5","3","0.35000","48","135","-87"
"1943","Temple (PA)","2","6","0","0.25000","65","163","-98"
"1944","Temple (PA)","2","4","2","0.37500","93","96","-3"
"1945","Temple (PA)","7","1","0","0.87500","198","51","147"
"1946","Temple (PA)","2","4","2","0.37500","61","114","-53"
"1947","Temple (PA)","3","6","0","0.33333","91","128","-37"
"1948","Temple (PA)","2","6","1","0.27778","95","182","-87"
"1947","Drake (IA)","1","7","1","0.16667","97","191","-94"
"1948","Drake (IA)","7","3","0","0.70000","199","105","94"
"1949","Temple (PA)","5","4","0","0.55556","156","225","-69"
"1950","Temple (PA)","4","4","1","0.50000","173","132","41"
"1951","Temple (PA)","6","4","0","0.60000","168","176","-8"
"1952","Temple (PA)","2","7","1","0.25000","128","221","-93"
"1953","Temple (PA)","4","4","1","0.50000","134","157","-23"
"1954","Temple (PA)","3","5","0","0.37500","95","148","-53"
"1955","Southern Illinois","4","4","2","0.50000","136","120","16"
"1956","Southern Illinois","4","5","0","0.44444","167","152","15"
"1957","Southern Illinois","5","4","0","0.55556","201","140","61"
"1958","Southern Illinois","7","2","0","0.77778","202","114","88"
"1920","Mercer (GA)","2","7","0","0.22222","97","179","-82"
"1921","Mercer (GA)","3","6","0","0.33333","92","145","-53"
"1922","Mercer (GA)","5","6","0","0.45455","134","201","-67"
"1927","Clemson (SC)","5","3","1","0.61111","74","84","-10"
"1928","Clemson (SC)","8","3","0","0.72727","192","77","115"
"1929","Clemson (SC)","8","3","0","0.72727","236","110","126"
"1930","Clemson (SC)","8","2","0","0.80000","239","82","157"
"1936","Florida","4","6","0","0.40000","99","125","-26"
"1937","Florida","4","7","0","0.36364","86","89","-3"
"1938","Florida","4","6","1","0.40909","112","149","-37"
"1939","Florida","5","5","1","0.50000","78","66","12"
"1955","Temple (PA)","0","8","0","0.00000","49","223","-174"
"1956","Temple (PA)","3","5","0","0.37500","94","126","-32"
"1957","Temple (PA)","1","6","0","0.14286","62","210","-148"
"1958","Temple (PA)","0","8","0","0.00000","56","251","-195"
"1959","Temple (PA)","0","9","0","0.00000","73","270","-197"
"1960","Temple (PA)","2","7","0","0.22222","113","137","-24"
"1961","Temple (PA)","2","5","2","0.33333","86","129","-43"
"1962","Temple (PA)","3","6","0","0.33333","133","115","18"
"1963","Temple (PA)","5","3","1","0.61111","209","130","79"
"1964","Temple (PA)","7","2","0","0.77778","247","128","119"
"1965","Temple (PA)","5","5","0","0.50000","203","210","-7"
"1966","Temple (PA)","6","3","0","0.66667","266","196","70"
"1967","Temple (PA)","7","2","0","0.77778","201","224","-23"
"1968","Temple (PA)","4","6","0","0.40000","240","241","-1"
"1969","Temple (PA)","4","5","1","0.45000","180","144","36"
"1959","Navy (MD)","5","4","1","0.55000","199","166","33"
"1960","Navy (MD)","9","2","0","0.81818","262","103","159"
"1961","Navy (MD)","7","3","0","0.70000","201","136","65"
"1962","Navy (MD)","5","5","0","0.50000","184","174","10"
"1963","Navy (MD)","9","2","0","0.81818","320","165","155"
"1964","Navy (MD)","3","6","1","0.35000","140","185","-45"
"1970","Temple (PA)","7","3","0","0.70000","190","151","39"
"1971","Temple (PA)","6","2","1","0.72222","248","136","112"
"1972","Temple (PA)","5","4","0","0.55556","164","176","-12"
"1973","Temple (PA)","9","1","0","0.90000","353","167","186"
"1974","Temple (PA)","8","2","0","0.80000","335","142","193"
"1975","Temple (PA)","6","5","0","0.54545","289","225","64"
"1976","Temple (PA)","4","6","0","0.40000","196","216","-20"
"1977","Temple (PA)","5","5","1","0.50000","229","286","-57"
"1978","Temple (PA)","7","3","1","0.68182","280","203","77"
"1979","Temple (PA)","10","2","0","0.83333","399","198","201"
"1980","Temple (PA)","4","7","0","0.36364","170","262","-92"
"1981","Temple (PA)","5","5","0","0.50000","181","195","-14"
"1982","Temple (PA)","4","7","0","0.36364","220","202","18"
"1983","Temple (PA)","4","7","0","0.36364","170","241","-71"
"1984","Temple (PA)","6","5","0","0.54545","226","180","46"
"1985","Temple (PA)","4","7","0","0.36364","233","223","10"
"1986","Temple (PA)","0","11","0","0.00000","308","271","37"
"1987","Temple (PA)","3","8","0","0.27273","154","251","-97"
"1988","Temple (PA)","4","7","0","0.36364","207","317","-110"
"1979","DePauw (IN)","2","7","0","0.22222","64","171","-107"
"1980","DePauw (IN)","7","2","1","0.75000","235","159","76"
"1981","Pennsylvania","1","9","0","0.10000","133","324","-191"
"1982","Pennsylvania","7","3","0","0.70000","221","192","29"
"1983","Pennsylvania","6","3","1","0.65000","225","204","21"
"1984","Pennsylvania","8","1","0","0.88889","286","152","134"
"1985","Pennsylvania","7","2","1","0.75000","197","161","36"
"1986","Rice (TX)","4","7","0","0.36364","185","330","-145"
"1987","Rice (TX)","2","9","0","0.18182","237","427","-190"
"1988","Rice (TX)","0","11","0","0.00000","165","358","-193"
"1989","Temple (PA)","1","10","0","0.09091","141","387","-246"
"1990","Temple (PA)","7","4","0","0.63636","261","269","-8"
"1991","Temple (PA)","2","9","0","0.18182","145","290","-145"
"1992","Temple (PA)","1","10","0","0.09091","132","383","-251"
"1993","Temple (PA)","1","10","0","0.09091","115","527","-412"
"1994","Temple (PA)","2","9","0","0.18182","244","417","-173"
"1995","Temple (PA)","1","10","0","0.09091","187","358","-171"
"1996","Temple (PA)","1","10","0","0.09091","218","386","-168"
"1997","Temple (PA)","3","8","0","0.27273","212","371","-159"
"1998","Alabama St.","5","6","0","0.45455","261","280","-19"
"1999","Alabama St.","2","9","0","0.18182","240","363","-123"
"2010","Lambuth (TN)","4","6","0","0.40000","202","280","-78"
"1988","North Alabama","2","8","0","0.20000","173","282","-109"
"1989","North Alabama","6","5","0","0.54545","208","155","53"
"1990","North Alabama","8","3","0","0.72727","317","169","148"
"1991","North Alabama","3","7","0","0.30000","160","251","-91"
"1992","North Alabama","7","4","1","0.62500","221","163","58"
"1993","North Alabama","14","0","0","1.00000","557","265","292"
"1994","North Alabama","13","1","0","0.92857","458","165","293"
"1995","North Alabama","14","0","0","1.00000","514","155","359"
"1996","North Alabama","6","5","0","0.54545","307","202","105"
"1997","North Alabama","9","3","0","0.75000","344","224","120"
"1998","Temple (PA)","2","9","0","0.18182","198","360","-162"
"1999","Temple (PA)","2","9","0","0.18182","153","366","-213"
"2000","Temple (PA)","4","7","0","0.36364","224","269","-45"
"2001","Temple (PA)","4","7","0","0.36364","198","311","-113"
"2002","Temple (PA)","4","8","0","0.33333","242","351","-109"
"2003","Temple (PA)","1","11","0","0.08333","235","393","-158"
"2004","Temple (PA)","2","9","0","0.18182","238","399","-161"
"2005","Temple (PA)","0","11","0","0.00000","107","498","-391"
"2006","West Alabama","6","5","0","0.54545","301","235","66"
"2007","West Alabama","1","9","0","0.10000","200","329","-129"
"2008","West Alabama","4","7","0","0.36364","283","273","10"
"2009","West Alabama","8","5","0","0.61538","415","365","50"
"2010","West Alabama","7","4","0","0.63636","327","245","82"
"2012","North Alabama","5","5","0","0.50000","261","231","30"
"2013","North Alabama","10","3","0","0.76923","517","257","260"
"2006","Temple (PA)","1","11","0","0.08333","131","496","-365"
"2007","Temple (PA)","4","8","0","0.33333","197","315","-118"
"2008","Temple (PA)","5","7","0","0.41667","281","277","4"
"2009","Temple (PA)","9","4","0","0.69231","384","290","94"
"2010","Temple (PA)","8","4","0","0.66667","300","229","71"
"2011","Miami (FL)","6","6","0","0.50000","318","241","77"
"2012","Miami (FL)","7","5","0","0.58333","377","366","11"
"2013","Miami (FL)","9","4","0","0.69231","440","348","92"
"2011","Temple (PA)","9","4","0","0.69231","398","181","217"
"2012","Temple (PA)","4","7","0","0.36364","272","343","-71"
"2013","Boston College (MA)","7","6","0","0.53846","360","376","-16"
"2013","Temple (PA)","2","10","0","0.16667","299","358","-59"
"1869","Rutgers (NJ)","2","2","0","0.50000","18","18","0"
"1870","Rutgers (NJ)","2","2","0","0.50000","17","17","0"
"1872","Columbia (NY)","5","4","0","0.55556","22","16","6"
"1873","Rutgers (NJ)","7","4","1","0.62500","31","26","5"
"1874","Harvard (MA)","9","7","0","0.56250","54","41","13"
"1875","Harvard (MA)","12","6","2","0.65000","52","29","23"
"1876","Harvard (MA)","13","8","1","0.61364","45","29","16"
"1877","Harvard (MA)","9","7","3","0.55263","31","21","10"
"1878","Pennsylvania","14","9","5","0.58929","42","24","18"
"1879","Harvard (MA)","13","9","12","0.55882","46","27","19"
"1880","Harvard (MA)","18","11","4","0.60606","75","53","22"
"1881","Rutgers (NJ)","22","18","8","0.54167","70","47","23"
"1882","Rutgers (NJ)","41","28","2","0.59155","176","111","65"
"1883","Rutgers (NJ)","38","32","1","0.54225","1288","965","323"
"1884","Pennsylvania","47","29","5","0.61111","1728","1184","544"
"1885","Michigan","34","17","4","0.65455","1437","612","825"
"1886","Lehigh (PA)","48","21","4","0.68493","1850","637","1213"
"1887","California","67","35","3","0.65238","2660","935","1725"
"1888","Princeton (NJ)","70","56","6","0.55303","2468","1899","569"
"1889","Brown (RI)","82","51","11","0.60764","2879","1796","1083"
"1890","Brown (RI)","77","76","9","0.50309","3002","2455","547"
"1891","Southern California","94","76","13","0.54918","2813","2189","624"
"1892","Minnesota","93","80","9","0.53571","2972","2394","578"
"1893","Duke (NC)","79","94","9","0.45879","2176","2912","-736"
"1894","Colorado St.","50","62","4","0.44828","1161","1518","-357"
"1895","Boston (MA)","31","44","11","0.42442","692","1031","-339"
"1896","Rhode Island","54","62","12","0.46875","1126","1201","-75"
"1897","Boston (MA)","32","40","6","0.44872","792","785","7"
"1898","Miami (OH)","47","23","4","0.66216","921","644","277"
"1899","New Hampshire","33","32","6","0.50704","571","522","49"
"1900","New Hampshire","22","35","11","0.40441","442","686","-244"
"1901","Marshall (WV)","18","34","3","0.35455","302","917","-615"
"1902","Saint John's (MN)","9","22","4","0.31429","148","460","-312"
"1903","Wichita St. (KS)","14","25","2","0.36585","376","546","-170"
"1904","Oklahoma St.","11","14","1","0.44231","194","394","-200"
"1905","Miami (OH)","7","25","5","0.25676","245","494","-249"
"1906","Rensselaer Tech (NY)","3","7","4","0.35714","92","107","-15"
"1907","Marshall (WV)","5","10","2","0.35294","71","238","-167"
"1908","Fort Hays St. (KS)","5","6","1","0.45833","56","91","-35"
"1909","Fort Hays St. (KS)","1","3","1","0.30000","12","68","-56"
"1910","Texas St.","0","1","0","0.00000","0","19","-19"
"1912","Fort Hays St. (KS)","1","2","0","0.33333","20","132","-112"
"1913","Eureka (IL)","1","6","0","0.14286","39","203","-164"
"1914","Eureka (IL)","3","4","0","0.42857","57","201","-144"
"1915","Texas St.","1","1","1","0.50000","13","20","-7"
"1916","Texas St.","0","2","1","0.16667","0","106","-106"
"1917","Boston (MA)","4","4","0","0.50000","73","136","-63"
"1918","Monmouth (IL)","1","7","0","0.12500","26","137","-111"
"1930","Troy (AL)","1","2","0","0.33333","7","73","-66"
"2013","Grambling St. (LA)","0","1","0","0.00000","0","0","0"
"1899","Tennessee","6","2","0","0.75000","87","56","31"
"1900","Tennessee","3","2","1","0.58333","67","51","16"
"1901","Tennessee","3","3","2","0.50000","42","56","-14"
"1902","Tennessee","6","2","0","0.75000","88","39","49"
"1903","Tennessee","4","5","0","0.44444","76","110","-34"
"1904","Tennessee","3","5","1","0.38889","45","77","-32"
"1905","Tennessee","3","5","1","0.38889","162","151","11"
"1906","Tennessee","1","6","2","0.22222","15","127","-112"
"1907","Tennessee","7","2","1","0.75000","169","17","152"
"1908","Tennessee","7","2","0","0.77778","124","41","83"
"1909","Tennessee","1","6","2","0.22222","11","113","-102"
"1922","Wake Forest (NC)","3","5","2","0.40000","62","144","-82"
"1910","Tennessee","3","5","1","0.38889","50","134","-84"
"1911","Tennessee","3","4","2","0.44444","82","93","-11"
"1912","Tennessee","4","4","0","0.50000","294","80","214"
"1913","Tennessee","6","3","0","0.66667","283","37","246"
"1914","Tennessee","9","0","0","1.00000","374","37","337"
"1915","Tennessee","4","4","0","0.50000","303","58","245"
"1916","Kansas St.","6","1","1","0.81250","154","36","118"
"1917","Kansas St.","6","2","0","0.75000","215","25","190"
"1918","Kansas St.","4","1","0","0.80000","95","29","66"
"1919","Kansas St.","3","5","1","0.38889","72","109","-37"
"1906","Washington St.","6","0","0","1.00000","44","0","44"
"1907","Washington St.","7","1","0","0.87500","282","19","263"
"1912","Washington St.","2","3","0","0.40000","17","71","-54"
"1913","Washington St.","4","4","0","0.50000","111","61","50"
"1914","Washington St.","2","4","0","0.33333","10","75","-65"
"1915","Kansas St.","3","4","1","0.43750","43","84","-41"
"1916","Tennessee","8","0","1","0.94444","168","19","149"
"1919","Tennessee","3","3","3","0.50000","103","62","41"
"1920","Tennessee","7","2","0","0.77778","243","40","203"
"1913","Ohio","2","5","1","0.31250","55","159","-104"
"1914","Ohio","4","4","0","0.50000","119","99","20"
"1915","Ohio","7","2","0","0.77778","168","49","119"
"1916","Ohio","5","2","1","0.68750","154","109","45"
"1917","Ohio","3","5","0","0.37500","85","114","-29"
"1918","Drake (IA)","3","2","0","0.60000","84","117","-33"
"1919","Drake (IA)","4","3","0","0.57143","68","46","22"
"1920","Drake (IA)","4","5","1","0.45000","170","128","42"
"1921","Tennessee","6","2","1","0.72222","102","35","67"
"1922","Tennessee","8","2","0","0.80000","239","45","194"
"1923","Tennessee","5","4","1","0.55000","82","167","-85"
"1924","Tennessee","3","5","0","0.37500","83","135","-52"
"1925","Tennessee","5","2","1","0.68750","129","73","56"
"1926","Tennessee","8","1","0","0.88889","151","34","117"
"1927","Tennessee","8","0","1","0.94444","245","26","219"
"1928","Tennessee","9","0","1","0.95000","249","51","198"
"1929","Tennessee","9","0","1","0.95000","330","19","311"
"1930","Tennessee","9","1","0","0.90000","209","31","178"
"1931","Tennessee","9","0","1","0.95000","243","15","228"
"1932","Tennessee","9","0","1","0.95000","238","36","202"
"1933","Tennessee","7","3","0","0.70000","176","47","129"
"1934","Tennessee","8","2","0","0.80000","175","58","117"
"1936","Tennessee","6","2","2","0.70000","147","52","95"
"1937","Tennessee","6","3","1","0.65000","189","47","142"
"1938","Tennessee","11","0","0","1.00000","293","16","277"
"1939","Tennessee","10","1","0","0.90909","212","14","198"
"1940","Tennessee","10","1","0","0.90909","331","45","286"
"1946","Tennessee","9","2","0","0.81818","175","97","78"
"1947","Tennessee","5","5","0","0.50000","164","152","12"
"1948","Tennessee","4","4","2","0.50000","140","98","42"
"1949","Tennessee","7","2","1","0.75000","214","104","110"
"1950","Tennessee","11","1","0","0.91667","335","71","264"
"1951","Tennessee","10","1","0","0.90909","386","116","270"
"1952","Tennessee","8","2","1","0.77273","259","79","180"
"1935","Tennessee","4","5","0","0.44444","98","155","-57"
"1941","Tennessee","8","2","0","0.80000","182","73","109"
"1942","Tennessee","9","1","1","0.86364","259","61","198"
"1944","Tennessee","7","1","1","0.83333","173","73","100"
"1945","Tennessee","8","1","0","0.88889","238","52","186"
"1946","Arkansas","6","3","2","0.63636","136","92","44"
"1947","Arkansas","6","4","1","0.59091","191","145","46"
"1948","Arkansas","5","5","0","0.50000","227","136","91"
"1949","Arkansas","5","5","0","0.50000","167","175","-8"
"1953","Tennessee","6","4","1","0.59091","240","153","87"
"1954","Tennessee","4","6","0","0.40000","105","164","-59"
"1947","Wyoming","4","5","0","0.44444","175","168","7"
"1948","Wyoming","4","5","0","0.44444","270","145","125"
"1949","Wyoming","9","1","0","0.90000","381","65","316"
"1950","Wyoming","10","0","0","1.00000","363","59","304"
"1951","Wyoming","7","2","1","0.75000","220","82","138"
"1952","Wyoming","5","4","0","0.55556","114","102","12"
"1953","Arkansas","3","7","0","0.30000","116","161","-45"
"1954","Arkansas","8","3","0","0.72727","195","104","91"
"1955","Tennessee","6","3","1","0.65000","188","92","96"
"1956","Tennessee","10","1","0","0.90909","275","88","187"
"1957","Tennessee","8","3","0","0.72727","164","75","89"
"1958","Tennessee","4","6","0","0.40000","77","122","-45"
"1959","Tennessee","5","4","1","0.55000","112","118","-6"
"1960","Tennessee","6","2","2","0.70000","209","79","130"
"1961","Tennessee","6","4","0","0.60000","221","149","72"
"1962","Tennessee","4","6","0","0.40000","179","134","45"
"1963","Tennessee","5","5","0","0.50000","168","121","47"
"1964","Tennessee","4","5","1","0.45000","80","121","-41"
"1965","Tennessee","8","1","2","0.81818","220","98","122"
"1966","Tennessee","8","3","0","0.72727","240","99","141"
"1967","Tennessee","9","2","0","0.81818","283","141","142"
"1968","Tennessee","8","2","1","0.77273","261","146","115"
"1969","Tennessee","9","2","0","0.81818","328","179","149"
"1970","Florida","7","4","0","0.63636","224","256","-32"
"1971","Florida","4","7","0","0.36364","174","298","-124"
"1972","Florida","5","5","1","0.50000","218","144","74"
"1973","Florida","7","5","0","0.58333","187","187","0"
"1974","Florida","8","4","0","0.66667","261","197","64"
"1975","Florida","9","3","0","0.75000","302","117","185"
"1976","Florida","8","4","0","0.66667","328","292","36"
"1977","Florida","6","4","1","0.59091","251","235","16"
"1978","Florida","4","7","0","0.36364","249","223","26"
"1970","Tennessee","11","1","0","0.91667","370","116","254"
"1971","Tennessee","10","2","0","0.83333","270","121","149"
"1972","Tennessee","10","2","0","0.83333","297","100","197"
"1973","Tennessee","8","4","0","0.66667","291","247","44"
"1974","Tennessee","7","3","2","0.66667","211","181","30"
"1975","Tennessee","7","5","0","0.58333","253","193","60"
"1976","Tennessee","6","5","0","0.54545","237","162","75"
"1968","Iowa St.","3","7","0","0.30000","178","263","-85"
"1969","Iowa St.","3","7","0","0.30000","152","231","-79"
"1970","Iowa St.","5","6","0","0.45455","248","284","-36"
"1971","Iowa St.","8","4","0","0.66667","337","250","87"
"1972","Iowa St.","5","6","1","0.45833","319","238","81"
"1973","Pittsburgh (PA)","6","5","1","0.54167","225","211","14"
"1974","Pittsburgh (PA)","7","4","0","0.63636","227","202","25"
"1975","Pittsburgh (PA)","8","4","0","0.66667","322","161","161"
"1976","Pittsburgh (PA)","12","0","0","1.00000","381","133","248"
"1977","Tennessee","4","7","0","0.36364","229","229","0"
"1978","Tennessee","5","5","1","0.50000","251","209","42"
"1979","Tennessee","7","5","0","0.58333","311","235","76"
"1980","Tennessee","5","6","0","0.45455","256","189","67"
"1981","Tennessee","8","4","0","0.66667","244","265","-21"
"1982","Tennessee","6","5","1","0.54167","281","239","42"
"1983","Tennessee","9","3","0","0.75000","282","165","117"
"1984","Tennessee","7","4","1","0.62500","327","276","51"
"1985","Tennessee","9","1","2","0.83333","325","140","185"
"1986","Tennessee","7","5","0","0.58333","293","249","44"
"1987","Tennessee","10","2","1","0.80769","422","246","176"
"1988","Tennessee","5","6","0","0.45455","212","286","-74"
"1989","Tennessee","11","1","0","0.91667","346","217","129"
"1990","Tennessee","9","2","2","0.76923","465","220","245"
"1991","Tennessee","9","3","0","0.75000","352","263","89"
"1992","Tennessee","5","3","0","0.62500","206","125","81"
"1993","Pittsburgh (PA)","3","8","0","0.27273","168","371","-203"
"1994","Pittsburgh (PA)","3","8","0","0.27273","246","307","-61"
"1995","Pittsburgh (PA)","2","9","0","0.18182","217","329","-112"
"1996","Pittsburgh (PA)","4","7","0","0.36364","214","430","-216"
"1992","Tennessee","4","0","0","1.00000","141","71","70"
"1993","Tennessee","10","2","0","0.83333","484","175","309"
"1994","Tennessee","8","4","0","0.66667","363","208","155"
"1995","Tennessee","11","1","0","0.91667","431","228","203"
"1996","Tennessee","10","2","0","0.83333","437","185","252"
"1997","Tennessee","11","2","0","0.84615","428","286","142"
"1998","Tennessee","13","0","0","1.00000","431","189","242"
"1999","Tennessee","9","3","0","0.75000","369","194","175"
"2000","Tennessee","8","4","0","0.66667","380","247","133"
"2001","Tennessee","11","2","0","0.84615","400","251","149"
"2002","Tennessee","8","5","0","0.61538","296","227","69"
"2003","Tennessee","10","3","0","0.76923","365","239","126"
"2004","Tennessee","10","3","0","0.76923","378","295","83"
"2005","Tennessee","5","6","0","0.45455","205","205","0"
"2006","Tennessee","9","4","0","0.69231","362","254","108"
"2007","Tennessee","10","4","0","0.71429","455","382","73"
"2008","Tennessee","5","7","0","0.41667","208","201","7"
"2009","Tennessee","7","6","0","0.53846","381","289","92"
"2010","Southern California","8","5","0","0.61538","403","347","56"
"2011","Southern California","10","2","0","0.83333","429","283","146"
"2012","Southern California","7","6","0","0.53846","417","316","101"
"2013","Southern California","3","2","0","0.60000","130","106","24"
"2007","Louisiana Tech","5","7","0","0.41667","249","368","-119"
"2008","Louisiana Tech","8","5","0","0.61538","320","308","12"
"2009","Louisiana Tech","4","8","0","0.33333","350","309","41"
"2010","Tennessee","6","7","0","0.46154","351","326","25"
"2011","Tennessee","5","7","0","0.41667","244","271","-27"
"2012","Tennessee","4","7","0","0.36364","397","411","-14"
"2012","Tennessee","1","0","0","1.00000","37","17","20"
"2007","Central Michigan","8","6","0","0.57143","487","517","-30"
"2008","Central Michigan","8","5","0","0.61538","384","393","-9"
"2009","Central Michigan","11","2","0","0.84615","431","224","207"
"2010","Cincinnati (OH)","4","8","0","0.33333","325","336","-11"
"2011","Cincinnati (OH)","10","3","0","0.76923","433","264","169"
"2012","Cincinnati (OH)","9","3","0","0.75000","372","206","166"
"2013","Tennessee","5","7","0","0.41667","286","348","-62"
"1869","Rutgers (NJ)","2","2","0","0.50000","18","18","0"
"1870","Rutgers (NJ)","2","2","0","0.50000","17","17","0"
"1872","Columbia (NY)","5","4","0","0.55556","22","16","6"
"1873","Rutgers (NJ)","7","4","1","0.62500","31","26","5"
"1874","Harvard (MA)","9","7","0","0.56250","54","41","13"
"1875","Harvard (MA)","12","6","2","0.65000","52","29","23"
"1876","Harvard (MA)","13","8","1","0.61364","45","29","16"
"1877","Harvard (MA)","9","7","3","0.55263","31","21","10"
"1878","Pennsylvania","14","9","5","0.58929","42","24","18"
"1879","Harvard (MA)","13","9","12","0.55882","46","27","19"
"1880","Harvard (MA)","18","11","4","0.60606","75","53","22"
"1881","Rutgers (NJ)","22","18","8","0.54167","70","47","23"
"1882","Rutgers (NJ)","41","28","2","0.59155","176","111","65"
"1883","Rutgers (NJ)","38","32","1","0.54225","1288","965","323"
"1884","Pennsylvania","47","29","5","0.61111","1728","1184","544"
"1885","Michigan","34","17","4","0.65455","1437","612","825"
"1886","Lehigh (PA)","48","21","4","0.68493","1850","637","1213"
"1887","California","67","35","3","0.65238","2660","935","1725"
"1888","Princeton (NJ)","70","56","6","0.55303","2468","1899","569"
"1889","Brown (RI)","82","51","11","0.60764","2879","1796","1083"
"1890","Brown (RI)","77","76","9","0.50309","3002","2455","547"
"1891","Southern California","94","76","13","0.54918","2813","2189","624"
"1892","Minnesota","93","80","9","0.53571","2972","2394","578"
"1893","Duke (NC)","79","94","9","0.45879","2176","2912","-736"
"1894","Colorado St.","50","62","4","0.44828","1161","1518","-357"
"1895","Boston (MA)","31","44","11","0.42442","692","1031","-339"
"1896","Rhode Island","54","62","12","0.46875","1126","1201","-75"
"1897","Boston (MA)","32","40","6","0.44872","792","785","7"
"1898","Miami (OH)","47","23","4","0.66216","921","644","277"
"1899","New Hampshire","33","32","6","0.50704","571","522","49"
"1900","New Hampshire","22","35","11","0.40441","442","686","-244"
"1901","Marshall (WV)","18","34","3","0.35455","302","917","-615"
"1902","Saint John's (MN)","9","22","4","0.31429","148","460","-312"
"1903","Wichita St. (KS)","14","25","2","0.36585","376","546","-170"
"1904","Oklahoma St.","11","14","1","0.44231","194","394","-200"
"1905","Miami (OH)","7","25","5","0.25676","245","494","-249"
"1906","Rensselaer Tech (NY)","3","7","4","0.35714","92","107","-15"
"1907","Marshall (WV)","5","10","2","0.35294","71","238","-167"
"1908","Fort Hays St. (KS)","5","6","1","0.45833","56","91","-35"
"1909","Fort Hays St. (KS)","1","3","1","0.30000","12","68","-56"
"1910","Texas St.","0","1","0","0.00000","0","19","-19"
"1912","Fort Hays St. (KS)","1","2","0","0.33333","20","132","-112"
"1913","Eureka (IL)","1","6","0","0.14286","39","203","-164"
"1914","Eureka (IL)","3","4","0","0.42857","57","201","-144"
"1915","Texas St.","1","1","1","0.50000","13","20","-7"
"1916","Texas St.","0","2","1","0.16667","0","106","-106"
"1917","Boston (MA)","4","4","0","0.50000","73","136","-63"
"1918","Monmouth (IL)","1","7","0","0.12500","26","137","-111"
"1930","Troy (AL)","1","2","0","0.33333","7","73","-66"
"2013","Grambling St. (LA)","0","1","0","0.00000","0","0","0"
"1894","Texas","6","1","0","0.85714","191","28","163"
"1892","Wisconsin","4","4","0","0.50000","102","96","6"
"1893","Nebraska","3","2","1","0.58333","80","80","0"
"1894","Nebraska","7","2","0","0.77778","120","42","78"
"1895","Texas","5","0","0","1.00000","96","0","96"
"1893","Missouri","4","3","0","0.57143","154","136","18"
"1894","Missouri","4","3","0","0.57143","134","108","26"
"1896","Texas","4","5","2","0.45455","104","84","20"
"1897","Maine","1","2","0","0.33333","24","13","11"
"1897","Texas","6","2","0","0.75000","144","56","88"
"1899","Butler (IN)","1","4","0","0.20000","11","77","-66"
"1900","Butler (IN)","1","3","0","0.25000","10","94","-84"
"1901","Butler (IN)","2","1","0","0.66667","46","28","18"
"1902","Butler (IN)","1","5","0","0.16667","17","198","-181"
"1903","Butler (IN)","0","3","0","0.00000","0","95","-95"
"1898","Texas","5","1","0","0.83333","136","4","132"
"1899","Texas","6","2","0","0.75000","117","24","93"
"1898","Lehigh (PA)","3","6","1","0.35000","49","106","-57"
"1899","Lehigh (PA)","2","9","0","0.18182","60","144","-84"
"1900","Texas","6","0","0","1.00000","113","13","100"
"1901","Texas","8","2","1","0.77273","153","71","82"
"1902","Texas","6","3","1","0.65000","87","40","47"
"1903","Texas","5","1","2","0.75000","131","28","103"
"1904","Texas","6","2","0","0.75000","219","88","131"
"1905","Texas","5","4","0","0.55556","98","68","30"
"1911","New Mexico","1","3","1","0.30000","62","22","40"
"1912","New Mexico","0","4","0","0.00000","15","76","-61"
"1913","New Mexico","3","2","0","0.60000","84","27","57"
"1914","New Mexico","3","1","1","0.70000","83","33","50"
"1915","New Mexico","3","1","0","0.75000","97","6","91"
"1916","New Mexico","3","2","0","0.60000","216","70","146"
"1919","Idaho","2","3","0","0.40000","26","91","-65"
"1920","Idaho St.","3","3","0","0.50000","53","92","-39"
"1921","Idaho St.","6","2","0","0.75000","178","58","120"
"1922","Idaho St.","4","3","0","0.57143","247","54","193"
"1923","Idaho St.","3","2","1","0.58333","58","80","-22"
"1924","Idaho St.","5","2","0","0.71429","169","72","97"
"1925","Idaho St.","2","4","0","0.33333","18","46","-28"
"1926","Idaho St.","1","4","0","0.20000","14","80","-66"
"1927","Idaho St.","1","4","1","0.25000","46","88","-42"
"1906","Texas","9","1","0","0.90000","201","60","141"
"1907","Texas","6","1","1","0.81250","154","53","101"
"1908","Texas","5","4","0","0.55556","135","135","0"
"1909","Texas","4","3","1","0.56250","105","50","55"
"1911","Franklin & Marshall (PA)","3","6","0","0.33333","67","56","11"
"1912","Franklin & Marshall (PA)","6","4","0","0.60000","86","113","-27"
"1913","William & Mary (VA)","0","5","1","0.08333","32","142","-110"
"1914","William & Mary (VA)","1","7","0","0.12500","22","220","-198"
"1915","William & Mary (VA)","0","9","1","0.05000","20","302","-282"
"1910","Texas","6","2","0","0.75000","162","32","130"
"1911","Texas","5","2","0","0.71429","66","19","47"
"1911","Butler (IN)","3","4","1","0.43750","90","100","-10"
"1912","Texas","7","1","0","0.87500","201","62","139"
"1913","Texas","7","1","0","0.87500","250","56","194"
"1914","Texas","8","0","0","1.00000","358","21","337"
"1915","Texas","6","3","0","0.66667","335","69","266"
"1916","Texas","7","2","0","0.77778","218","35","183"
"1920","California-Davis","3","4","1","0.43750","61","67","-6"
"1921","Stanford (CA)","4","2","2","0.62500","100","97","3"
"1906","South Dakota St.","3","1","0","0.75000","52","34","18"
"1907","South Dakota St.","5","2","0","0.71429","108","42","66"
"1908","Marquette (WI)","7","5","2","0.57143","238","77","161"
"1909","Marquette (WI)","2","2","1","0.50000","38","16","22"
"1910","Marquette (WI)","6","1","2","0.77778","267","11","256"
"1911","Marquette (WI)","7","0","2","0.88889","168","31","137"
"1912","Wisconsin","7","0","0","1.00000","246","29","217"
"1913","Wisconsin","3","3","1","0.50000","100","66","34"
"1914","Wisconsin","4","2","1","0.64286","102","51","51"
"1915","Wisconsin","4","3","0","0.57143","235","54","181"
"1917","Texas","4","4","0","0.50000","89","40","49"
"1918","Texas","9","0","0","1.00000","194","14","180"
"1919","Texas","6","3","0","0.66667","181","63","118"
"1920","Kentucky","3","4","1","0.43750","113","109","4"
"1921","Kentucky","4","3","1","0.56250","157","89","68"
"1922","Kentucky","6","3","0","0.66667","167","56","111"
"1920","Texas","9","0","0","1.00000","282","13","269"
"1921","Texas","6","1","1","0.81250","268","27","241"
"1922","Texas","7","2","0","0.77778","202","68","134"
"1907","Mount Union (OH)","9","2","0","0.81818","265","23","242"
"1909","Allegheny (PA)","2","4","1","0.35714","41","115","-74"
"1910","Allegheny (PA)","4","1","1","0.75000","81","29","52"
"1913","Oregon St.","3","2","3","0.56250","59","75","-16"
"1914","Oregon St.","7","0","2","0.88889","172","15","157"
"1915","Oregon St.","5","3","0","0.62500","166","73","93"
"1916","Nebraska","6","2","0","0.75000","145","51","94"
"1917","Nebraska","5","2","0","0.71429","228","33","195"
"1921","Clemson (SC)","1","6","2","0.22222","48","187","-139"
"1922","Clemson (SC)","5","4","0","0.55556","170","109","61"
"1923","Texas","8","0","1","0.94444","241","21","220"
"1924","Texas","5","3","1","0.61111","109","64","45"
"1925","Texas","6","2","1","0.72222","157","51","106"
"1926","Texas","5","4","0","0.55556","146","69","77"
"1927","Texas-El Paso","2","2","2","0.50000","69","69","0"
"1928","Texas-El Paso","3","4","1","0.43750","100","103","-3"
"1927","Texas","6","2","1","0.72222","164","73","91"
"1928","Texas","7","2","0","0.77778","122","32","90"
"1929","Texas","5","2","2","0.66667","132","28","104"
"1930","Texas","8","1","1","0.85000","179","20","159"
"1931","Texas","6","4","0","0.60000","131","58","73"
"1932","Texas","8","2","0","0.80000","220","49","171"
"1933","Texas","4","5","2","0.45455","112","104","8"
"1934","Texas","7","2","1","0.75000","137","85","52"
"1935","Texas","4","6","0","0.40000","138","174","-36"
"1936","Texas","2","6","1","0.27778","69","128","-59"
"1916","Louisiana St.","1","0","2","0.66667","62","21","41"
"1917","Texas A&M","8","0","0","1.00000","270","0","270"
"1919","Texas A&M","10","0","0","1.00000","275","0","275"
"1920","Texas A&M","6","1","1","0.81250","229","7","222"
"1921","Texas A&M","6","1","2","0.77778","110","57","53"
"1922","Texas A&M","5","4","0","0.55556","166","69","97"
"1923","Texas A&M","5","3","1","0.61111","135","23","112"
"1924","Texas A&M","7","2","1","0.75000","229","35","194"
"1925","Texas A&M","7","1","1","0.83333","191","25","166"
"1926","Texas A&M","5","3","1","0.61111","184","59","125"
"1927","Texas A&M","8","0","1","0.94444","262","32","230"
"1928","Texas A&M","5","4","1","0.55000","205","77","128"
"1929","Nebraska","4","1","3","0.68750","93","62","31"
"1930","Nebraska","4","3","2","0.55556","119","61","58"
"1931","Nebraska","8","2","0","0.80000","136","82","54"
"1932","Nebraska","7","1","1","0.83333","105","52","53"
"1933","Nebraska","8","1","0","0.88889","138","19","119"
"1934","Nebraska","6","3","0","0.66667","106","89","17"
"1935","Nebraska","6","2","1","0.72222","138","71","67"
"1936","Nebraska","7","2","0","0.77778","185","49","136"
"1937","Texas","2","6","1","0.27778","60","103","-43"
"1938","Texas","1","8","0","0.11111","52","162","-110"
"1939","Texas","5","4","0","0.55556","106","125","-19"
"1940","Texas","8","2","0","0.80000","172","77","95"
"1941","Texas","8","1","1","0.85000","338","55","283"
"1942","Texas","9","2","0","0.81818","244","49","195"
"1943","Texas","7","1","1","0.83333","277","54","223"
"1944","Texas","5","4","0","0.55556","119","76","43"
"1945","Texas","10","1","0","0.90909","257","86","171"
"1946","Texas","8","2","0","0.80000","290","68","222"
"1947","Texas","10","1","0","0.90909","292","74","218"
"1948","Texas","7","3","1","0.68182","223","147","76"
"1949","Texas","6","4","0","0.60000","290","93","197"
"1950","Texas","9","2","0","0.81818","252","148","104"
"1951","Texas","7","3","0","0.70000","182","129","53"
"1952","Texas","9","2","0","0.81818","278","164","114"
"1953","Texas","7","3","0","0.70000","190","125","65"
"1954","Texas","4","5","1","0.45000","158","161","-3"
"1955","Texas","5","5","0","0.50000","189","212","-23"
"1956","Texas","1","9","0","0.10000","101","272","-171"
"1954","Mississippi St.","6","4","0","0.60000","192","120","72"
"1955","Mississippi St.","6","4","0","0.60000","173","142","31"
"1956","Washington","5","5","0","0.50000","232","206","26"
"1957","Texas","6","4","1","0.59091","159","149","10"
"1958","Texas","7","3","0","0.70000","157","152","5"
"1959","Texas","9","2","0","0.81818","216","96","120"
"1960","Texas","7","3","1","0.68182","167","78","89"
"1961","Texas","10","1","0","0.90909","303","66","237"
"1962","Texas","9","1","1","0.86364","184","72","112"
"1963","Texas","11","0","0","1.00000","243","71","172"
"1964","Texas","10","1","0","0.90909","220","81","139"
"1965","Texas","6","4","0","0.60000","231","153","78"
"1966","Texas","7","4","0","0.63636","194","111","83"
"1967","Texas","6","4","0","0.60000","186","123","63"
"1968","Texas","9","1","1","0.86364","379","198","181"
"1969","Texas","11","0","0","1.00000","435","119","316"
"1970","Texas","10","1","0","0.90909","423","149","274"
"1971","Texas","8","3","0","0.72727","281","168","113"
"1972","Texas","10","1","0","0.90909","271","121","150"
"1973","Texas","8","3","0","0.72727","367","162","205"
"1974","Texas","8","4","0","0.66667","367","197","170"
"1975","Texas","10","2","0","0.83333","401","181","220"
"1976","Texas","5","5","1","0.50000","195","188","7"
"1975","Wyoming","2","9","0","0.18182","174","219","-45"
"1976","Wyoming","8","4","0","0.66667","278","250","28"
"1977","Texas","11","1","0","0.91667","441","152","289"
"1978","Texas","9","3","0","0.75000","287","136","151"
"1979","Texas","9","3","0","0.75000","221","104","117"
"1980","Texas","7","5","0","0.58333","267","214","53"
"1981","Texas","10","1","1","0.87500","262","158","104"
"1982","Texas","9","3","0","0.75000","357","170","187"
"1983","Texas","11","1","0","0.91667","289","114","175"
"1984","Texas","7","4","1","0.62500","264","261","3"
"1985","Texas","8","4","0","0.66667","270","259","11"
"1986","Texas","5","6","0","0.45455","229","245","-16"
"1987","Purdue (IN)","3","7","1","0.31818","197","285","-88"
"1988","Purdue (IN)","4","7","0","0.36364","124","303","-179"
"1989","Purdue (IN)","3","8","0","0.27273","172","281","-109"
"1990","Purdue (IN)","2","9","0","0.18182","177","337","-160"
"1986","Texas Tech","7","4","0","0.63636","254","248","6"
"1987","Texas","7","5","0","0.58333","335","324","11"
"1988","Texas","4","7","0","0.36364","252","304","-52"
"1989","Texas","5","6","0","0.45455","220","289","-69"
"1990","Texas","10","2","0","0.83333","358","227","131"
"1991","Texas","5","6","0","0.45455","195","145","50"
"1978","Wake Forest (NC)","1","10","0","0.09091","104","274","-170"
"1979","Wake Forest (NC)","8","4","0","0.66667","240","283","-43"
"1980","Wake Forest (NC)","5","6","0","0.45455","251","213","38"
"1988","Illinois","6","5","1","0.54167","245","243","2"
"1989","Illinois","10","2","0","0.83333","332","182","150"
"1990","Illinois","8","4","0","0.66667","293","246","47"
"1991","Illinois","6","5","0","0.54545","261","182","79"
"1992","Texas","6","5","0","0.54545","292","282","10"
"1993","Texas","5","5","1","0.50000","281","269","12"
"1994","Texas","8","4","0","0.66667","366","291","75"
"1995","Texas","10","2","1","0.80769","390","255","135"
"1996","Texas","8","5","0","0.61538","447","305","142"
"1997","Texas","4","7","0","0.36364","283","366","-83"
"2001","Arizona","5","6","0","0.45455","320","377","-57"
"2002","Arizona","4","8","0","0.33333","227","310","-83"
"2003","Arizona","1","4","0","0.20000","82","186","-104"
"1983","Appalachian St. (NC)","6","5","0","0.54545","212","265","-53"
"1985","Tulane (LA)","1","10","0","0.09091","166","334","-168"
"1986","Tulane (LA)","4","7","0","0.36364","265","334","-69"
"1987","Tulane (LA)","6","6","0","0.50000","370","376","-6"
"1988","North Carolina","1","10","0","0.09091","217","391","-174"
"1989","North Carolina","1","10","0","0.09091","138","297","-159"
"1990","North Carolina","6","4","1","0.59091","227","186","41"
"1991","North Carolina","7","4","0","0.63636","282","199","83"
"1992","North Carolina","9","3","0","0.75000","289","233","56"
"1993","North Carolina","10","3","0","0.76923","431","253","178"
"1994","North Carolina","8","4","0","0.66667","374","267","107"
"1995","North Carolina","7","5","0","0.58333","284","220","64"
"1996","North Carolina","10","2","0","0.83333","357","123","234"
"1997","North Carolina","10","1","0","0.90909","306","143","163"
"1998","Texas","9","3","0","0.75000","437","337","100"
"1999","Texas","9","5","0","0.64286","450","295","155"
"2000","Texas","9","3","0","0.75000","455","232","223"
"2001","Texas","11","2","0","0.84615","517","207","310"
"2002","Texas","11","2","0","0.84615","439","212","227"
"2003","Texas","10","3","0","0.76923","533","280","253"
"2004","Texas","11","1","0","0.91667","423","215","208"
"2005","Texas","13","0","0","1.00000","652","213","439"
"2006","Texas","10","3","0","0.76923","467","238","229"
"2007","Texas","10","3","0","0.76923","484","329","155"
"2008","Texas","12","1","0","0.92308","551","244","307"
"2009","Texas","13","1","0","0.92857","550","234","316"
"2010","Texas","5","7","0","0.41667","285","284","1"
"2011","Texas","8","5","0","0.61538","365","289","76"
"2012","Texas","9","4","0","0.69231","464","380","84"
"2013","Texas","8","5","0","0.61538","381","336","45"
"1894","Texas A&M","1","1","0","0.50000","14","44","-30"
"1896","Texas A&M","2","0","1","0.83333","50","4","46"
"1897","Texas A&M","1","2","0","0.33333","10","40","-30"
"1898","Texas A&M","4","2","0","0.66667","117","60","57"
"1899","Texas A&M","4","2","0","0.66667","150","16","134"
"1900","Texas A&M","2","2","1","0.50000","61","22","39"
"1901","Texas A&M","1","4","0","0.20000","12","112","-100"
"1902","Texas A&M","7","0","2","0.88889","129","11","118"
"1903","Texas A&M","7","3","1","0.68182","90","59","31"
"1904","Texas A&M","4","2","0","0.66667","104","51","53"
"1903","Allegheny (PA)","5","7","0","0.41667","132","170","-38"
"1905","Texas A&M","7","2","0","0.77778","180","83","97"
"1906","Texas A&M","6","1","0","0.85714","170","42","128"
"1907","Texas A&M","6","1","1","0.81250","125","27","98"
"1908","Texas A&M","3","5","0","0.37500","76","117","-41"
"1909","Texas A&M","1","0","1","0.75000","17","0","17"
"1909","Texas A&M","6","0","0","1.00000","113","14","99"
"1910","Texas A&M","8","1","0","0.88889","203","24","179"
"1911","Texas A&M","6","1","0","0.85714","134","17","117"
"1912","Texas A&M","8","1","0","0.88889","366","26","340"
"1913","Texas A&M","3","4","2","0.44444","53","76","-23"
"1914","Texas A&M","6","1","1","0.81250","205","33","172"
"1924","Bucknell (PA)","8","2","0","0.80000","168","64","104"
"1925","Bucknell (PA)","7","3","1","0.68182","138","57","81"
"1926","Bucknell (PA)","4","5","1","0.45000","114","115","-1"
"1930","Catawba (NC)","8","0","1","0.94444","286","19","267"
"1931","Catawba (NC)","7","3","1","0.68182","153","58","95"
"1932","Catawba (NC)","6","2","1","0.72222","106","49","57"
"1933","Catawba (NC)","2","5","2","0.33333","73","81","-8"
"1911","Johns Hopkins (MD)","4","5","0","0.44444","56","112","-56"
"1915","Texas A&M","6","2","0","0.75000","182","34","148"
"1916","Texas A&M","7","3","0","0.70000","214","66","148"
"1911","Alabama","5","2","2","0.66667","153","31","122"
"1912","Alabama","5","3","1","0.61111","156","55","101"
"1913","Alabama","6","3","0","0.66667","188","40","148"
"1914","Alabama","5","4","0","0.55556","211","64","147"
"1918","Texas A&M","6","1","0","0.85714","123","19","104"
"1920","Montana St.","4","1","1","0.75000","62","41","21"
"1921","Montana St.","2","4","0","0.33333","63","74","-11"
"1916","Louisiana St.","1","0","2","0.66667","62","21","41"
"1917","Texas A&M","8","0","0","1.00000","270","0","270"
"1919","Texas A&M","10","0","0","1.00000","275","0","275"
"1920","Texas A&M","6","1","1","0.81250","229","7","222"
"1921","Texas A&M","6","1","2","0.77778","110","57","53"
"1922","Texas A&M","5","4","0","0.55556","166","69","97"
"1923","Texas A&M","5","3","1","0.61111","135","23","112"
"1924","Texas A&M","7","2","1","0.75000","229","35","194"
"1925","Texas A&M","7","1","1","0.83333","191","25","166"
"1926","Texas A&M","5","3","1","0.61111","184","59","125"
"1927","Texas A&M","8","0","1","0.94444","262","32","230"
"1928","Texas A&M","5","4","1","0.55000","205","77","128"
"1929","Nebraska","4","1","3","0.68750","93","62","31"
"1930","Nebraska","4","3","2","0.55556","119","61","58"
"1931","Nebraska","8","2","0","0.80000","136","82","54"
"1932","Nebraska","7","1","1","0.83333","105","52","53"
"1933","Nebraska","8","1","0","0.88889","138","19","119"
"1934","Nebraska","6","3","0","0.66667","106","89","17"
"1935","Nebraska","6","2","1","0.72222","138","71","67"
"1936","Nebraska","7","2","0","0.77778","185","49","136"
"1937","Texas","2","6","1","0.27778","60","103","-43"
"1938","Texas","1","8","0","0.11111","52","162","-110"
"1939","Texas","5","4","0","0.55556","106","125","-19"
"1940","Texas","8","2","0","0.80000","172","77","95"
"1941","Texas","8","1","1","0.85000","338","55","283"
"1942","Texas","9","2","0","0.81818","244","49","195"
"1943","Texas","7","1","1","0.83333","277","54","223"
"1944","Texas","5","4","0","0.55556","119","76","43"
"1945","Texas","10","1","0","0.90909","257","86","171"
"1946","Texas","8","2","0","0.80000","290","68","222"
"1923","Texas Christian","4","5","0","0.44444","93","137","-44"
"1924","Texas Christian","4","5","0","0.44444","83","96","-13"
"1925","Texas Christian","7","1","1","0.83333","133","54","79"
"1926","Texas Christian","6","1","2","0.77778","110","74","36"
"1927","Texas Christian","4","3","2","0.55556","89","64","25"
"1928","Texas Christian","8","2","0","0.80000","142","28","114"
"1929","Texas A&M","5","4","0","0.55556","203","65","138"
"1930","Texas A&M","2","7","0","0.22222","66","100","-34"
"1931","Texas A&M","7","3","0","0.70000","137","34","103"
"1932","Texas A&M","4","4","2","0.50000","75","78","-3"
"1933","Texas A&M","6","3","1","0.65000","160","89","71"
"1935","Southern Methodist (TX)","12","1","0","0.92308","288","39","249"
"1936","Southern Methodist (TX)","5","4","1","0.55000","119","66","53"
"1937","Southern Methodist (TX)","5","6","0","0.45455","93","83","10"
"1938","Southern Methodist (TX)","6","4","0","0.60000","148","125","23"
"1939","Southern Methodist (TX)","6","3","1","0.65000","118","60","58"
"1940","Southern Methodist (TX)","8","1","1","0.85000","142","75","67"
"1941","Southern Methodist (TX)","5","5","0","0.50000","169","106","63"
"1945","Southern Methodist (TX)","5","6","0","0.45455","201","110","91"
"1946","Southern Methodist (TX)","4","5","1","0.45000","114","100","14"
"1947","Southern Methodist (TX)","9","0","2","0.90909","182","90","92"
"1948","Southern Methodist (TX)","9","1","1","0.86364","250","105","145"
"1949","Southern Methodist (TX)","5","4","1","0.55000","215","204","11"
"1919","Centenary (LA)","2","2","0","0.50000","30","12","18"
"1920","Centenary (LA)","0","1","0","0.00000","0","13","-13"
"1921","Centenary (LA)","4","4","0","0.50000","85","80","5"
"1926","Centenary (LA)","6","3","0","0.66667","206","132","74"
"1927","Centenary (LA)","10","0","0","1.00000","261","37","224"
"1928","Centenary (LA)","6","3","2","0.63636","231","99","132"
"1929","Centenary (LA)","6","3","1","0.65000","161","73","88"
"1930","Centenary (LA)","8","1","1","0.85000","127","33","94"
"1931","Centenary (LA)","5","5","0","0.50000","145","102","43"
"1932","Centenary (LA)","8","0","1","0.94444","183","26","157"
"1933","Centenary (LA)","8","0","4","0.83333","180","25","155"
"1934","Texas A&M","2","7","2","0.27273","84","186","-102"
"1935","Texas A&M","3","7","0","0.30000","125","121","4"
"1936","Texas A&M","8","3","1","0.70833","156","74","82"
"1937","Texas A&M","5","2","2","0.66667","117","59","58"
"1938","Texas A&M","4","4","1","0.50000","137","71","66"
"1939","Texas A&M","11","0","0","1.00000","212","31","181"
"1940","Texas A&M","9","1","0","0.90000","183","46","137"
"1941","Texas A&M","9","2","0","0.81818","281","75","206"
"1942","Texas A&M","4","5","1","0.45000","130","79","51"
"1943","Texas A&M","7","2","1","0.75000","184","65","119"
"1944","Texas A&M","7","4","0","0.63636","289","87","202"
"1945","Texas A&M","6","4","0","0.60000","179","103","76"
"1946","Texas A&M","4","6","0","0.40000","125","107","18"
"1947","Texas A&M","3","6","1","0.35000","169","185","-16"
"1948","Texas A&M","0","9","1","0.05000","123","247","-124"
"1949","Texas A&M","1","8","1","0.15000","92","267","-175"
"1950","Texas A&M","7","4","0","0.63636","344","206","138"
"1951","Texas A&M","5","3","2","0.60000","213","179","34"
"1952","Texas A&M","3","6","1","0.35000","137","187","-50"
"1953","Texas A&M","4","5","1","0.45000","128","186","-58"
"1945","Maryland","6","2","1","0.72222","219","105","114"
"1946","Kentucky","7","3","0","0.70000","233","97","136"
"1947","Kentucky","8","3","0","0.72727","175","73","102"
"1948","Kentucky","5","3","2","0.60000","199","128","71"
"1949","Kentucky","9","3","0","0.75000","317","74","243"
"1950","Kentucky","11","1","0","0.91667","393","69","324"
"1951","Kentucky","8","4","0","0.66667","314","121","193"
"1952","Kentucky","5","4","2","0.54545","161","173","-12"
"1953","Kentucky","7","2","1","0.75000","201","116","85"
"1954","Texas A&M","1","9","0","0.10000","97","177","-80"
"1955","Texas A&M","7","2","1","0.75000","160","89","71"
"1956","Texas A&M","9","0","1","0.95000","223","81","142"
"1957","Texas A&M","8","3","0","0.72727","158","50","108"
"1958","Alabama","5","4","1","0.55000","106","75","31"
"1959","Alabama","7","2","2","0.72727","95","59","36"
"1960","Alabama","8","1","2","0.81818","183","56","127"
"1961","Alabama","11","0","0","1.00000","297","25","272"
"1962","Alabama","10","1","0","0.90909","289","39","250"
"1963","Alabama","9","2","0","0.81818","227","95","132"
"1964","Alabama","10","1","0","0.90909","250","88","162"
"1965","Alabama","9","1","1","0.86364","256","107","149"
"1966","Alabama","11","0","0","1.00000","301","44","257"
"1967","Alabama","8","2","1","0.77273","204","131","73"
"1968","Alabama","8","3","0","0.72727","184","139","45"
"1969","Alabama","6","5","0","0.54545","314","268","46"
"1970","Alabama","6","5","1","0.54167","334","264","70"
"1971","Alabama","11","1","0","0.91667","368","122","246"
"1972","Alabama","10","2","0","0.83333","406","150","256"
"1973","Alabama","11","1","0","0.91667","477","113","364"
"1974","Alabama","11","1","0","0.91667","329","96","233"
"1975","Alabama","11","1","0","0.91667","374","72","302"
"1976","Alabama","9","3","0","0.75000","327","140","187"
"1977","Alabama","11","1","0","0.91667","380","139","241"
"1978","Alabama","11","1","0","0.91667","345","168","177"
"1979","Alabama","12","0","0","1.00000","383","67","316"
"1980","Alabama","10","2","0","0.83333","352","98","254"
"1981","Alabama","9","2","1","0.79167","296","151","145"
"1982","Alabama","8","4","0","0.66667","338","216","122"
"1957","Iowa St.","4","5","1","0.45000","142","160","-18"
"1958","Texas A&M","4","6","0","0.40000","124","217","-93"
"1959","Texas A&M","3","7","0","0.30000","101","141","-40"
"1960","Texas A&M","1","6","3","0.25000","73","117","-44"
"1961","Texas A&M","4","5","1","0.45000","184","118","66"
"1960","Wichita St. (KS)","8","2","0","0.80000","211","145","66"
"1961","Wichita St. (KS)","8","3","0","0.72727","230","189","41"
"1962","Texas A&M","3","7","0","0.30000","61","155","-94"
"1963","Texas A&M","2","7","1","0.25000","90","153","-63"
"1964","Texas A&M","1","9","0","0.10000","88","162","-74"
"1965","Texas A&M","3","7","0","0.30000","80","170","-90"
"1966","Texas A&M","4","5","1","0.45000","145","183","-38"
"1967","Texas A&M","7","4","0","0.63636","211","154","57"
"1968","Texas A&M","3","7","0","0.30000","196","184","12"
"1969","Texas A&M","3","7","0","0.30000","116","192","-76"
"1970","Texas A&M","2","9","0","0.18182","170","304","-134"
"1971","Texas A&M","5","6","0","0.45455","144","212","-68"
"1990","Alabama","7","5","0","0.58333","260","161","99"
"1991","Alabama","11","1","0","0.91667","324","143","181"
"1992","Alabama","13","0","0","1.00000","366","122","244"
"1993","Alabama","1","12","0","0.07692","340","168","172"
"1994","Alabama","12","1","0","0.92308","305","190","115"
"1995","Alabama","8","3","0","0.72727","260","188","72"
"1996","Alabama","10","3","0","0.76923","316","195","121"
"1972","Texas A&M","3","8","0","0.27273","165","243","-78"
"1973","Texas A&M","5","6","0","0.45455","292","231","61"
"1974","Texas A&M","8","3","0","0.72727","222","131","91"
"1975","Texas A&M","10","2","0","0.83333","265","124","141"
"1976","Texas A&M","10","2","0","0.83333","364","140","224"
"1977","Texas A&M","8","4","0","0.66667","350","304","46"
"1978","Texas A&M","4","2","0","0.66667","176","78","98"
"1979","Mississippi St.","3","8","0","0.27273","162","179","-17"
"1980","Mississippi St.","9","3","0","0.75000","301","247","54"
"1981","Mississippi St.","8","4","0","0.66667","212","137","75"
"1982","Mississippi St.","5","6","0","0.45455","252","244","8"
"1983","Mississippi St.","3","8","0","0.27273","196","279","-83"
"1984","Mississippi St.","4","7","0","0.36364","198","230","-32"
"1985","Mississippi St.","5","6","0","0.45455","257","288","-31"
"1978","Texas A&M","4","2","0","0.66667","115","105","10"
"1979","Texas A&M","6","5","0","0.54545","243","159","84"
"1980","Texas A&M","4","7","0","0.36364","160","259","-99"
"1981","Texas A&M","7","5","0","0.58333","280","203","77"
"1976","Washington St.","3","8","0","0.27273","240","331","-91"
"1977","Pittsburgh (PA)","9","2","1","0.79167","428","134","294"
"1978","Pittsburgh (PA)","8","4","0","0.66667","263","187","76"
"1979","Pittsburgh (PA)","11","1","0","0.91667","291","116","175"
"1980","Pittsburgh (PA)","11","1","0","0.91667","380","130","250"
"1981","Pittsburgh (PA)","11","1","0","0.91667","385","160","225"
"1982","Texas A&M","5","6","0","0.45455","286","314","-28"
"1983","Texas A&M","5","5","1","0.50000","218","174","44"
"1984","Texas A&M","6","5","0","0.54545","245","217","28"
"1985","Texas A&M","10","2","0","0.83333","375","196","179"
"1986","Texas A&M","9","3","0","0.75000","372","215","157"
"1987","Texas A&M","10","2","0","0.83333","313","168","145"
"1988","Texas A&M","7","5","0","0.58333","293","253","40"
"1991","Mississippi St.","7","5","0","0.58333","291","194","97"
"1992","Mississippi St.","7","5","0","0.58333","252","197","55"
"1993","Mississippi St.","4","5","2","0.45455","241","245","-4"
"1994","Mississippi St.","8","4","0","0.66667","373","262","111"
"1995","Mississippi St.","3","8","0","0.27273","261","357","-96"
"1996","Mississippi St.","5","6","0","0.45455","249","229","20"
"1997","Mississippi St.","7","4","0","0.63636","226","215","11"
"1998","Mississippi St.","8","5","0","0.61538","350","256","94"
"1999","Mississippi St.","10","2","0","0.83333","255","156","99"
"2000","Mississippi St.","8","4","0","0.66667","390","306","84"
"2001","Mississippi St.","3","8","0","0.27273","196","288","-92"
"2002","Mississippi St.","3","9","0","0.25000","227","339","-112"
"2003","Mississippi St.","2","10","0","0.16667","225","471","-246"
"1989","Texas A&M","8","4","0","0.66667","343","192","151"
"1990","Texas A&M","9","3","1","0.73077","465","232","233"
"1991","Texas A&M","10","2","0","0.83333","404","154","250"
"1992","Texas A&M","12","1","0","0.92308","352","196","156"
"1993","Texas A&M","10","2","0","0.83333","425","143","282"
"1994","Texas A&M","10","0","1","0.95455","319","147","172"
"1995","Texas A&M","9","3","0","0.75000","327","168","159"
"1996","Texas A&M","6","6","0","0.50000","351","257","94"
"1997","Texas A&M","9","4","0","0.69231","445","236","209"
"1998","Texas A&M","11","3","0","0.78571","335","214","121"
"1999","Texas A&M","8","4","0","0.66667","318","232","86"
"2000","Texas A&M","7","5","0","0.58333","348","239","109"
"2001","Texas A&M","8","4","0","0.66667","248","213","35"
"2002","Texas A&M","6","6","0","0.50000","345","280","65"
"1981","Southwestern (KS)","5","2","2","0.66667","300","174","126"
"1982","Southwestern (KS)","9","2","0","0.81818","261","130","131"
"1985","Pittsburg St. (KS)","8","2","0","0.80000","299","217","82"
"1986","Pittsburg St. (KS)","11","1","0","0.91667","499","199","300"
"1987","Pittsburg St. (KS)","11","1","0","0.91667","533","108","425"
"1988","Pittsburg St. (KS)","11","1","0","0.91667","423","126","297"
"1989","Pittsburg St. (KS)","12","1","0","0.92308","478","153","325"
"1990","Texas St.","6","5","0","0.54545","268","220","48"
"1991","Texas St.","7","4","0","0.63636","307","179","128"
"1992","New Mexico","3","8","0","0.27273","247","287","-40"
"1993","New Mexico","6","5","0","0.54545","335","256","79"
"1994","New Mexico","5","7","0","0.41667","401","386","15"
"1995","New Mexico","4","7","0","0.36364","256","303","-47"
"1996","New Mexico","6","5","0","0.54545","331","280","51"
"1997","New Mexico","9","4","0","0.69231","404","274","130"
"1998","Texas Christian","7","5","0","0.58333","267","235","32"
"1999","Texas Christian","8","4","0","0.66667","362","213","149"
"2000","Texas Christian","10","1","0","0.90909","410","106","304"
"2001","Alabama","7","5","0","0.58333","318","232","86"
"2002","Alabama","10","3","0","0.76923","367","200","167"
"2003","Texas A&M","4","8","0","0.33333","304","465","-161"
"2004","Texas A&M","7","5","0","0.58333","341","292","49"
"2005","Texas A&M","5","6","0","0.45455","352","343","9"
"2006","Texas A&M","9","4","0","0.69231","362","267","95"
"2007","Texas A&M","7","5","0","0.58333","346","313","33"
"2011","Texas St.","6","6","0","0.50000","306","342","-36"
"2012","Texas St.","4","8","0","0.33333","343","402","-59"
"2013","Texas St.","6","6","0","0.50000","287","328","-41"
"1983","Tennessee Tech","2","8","0","0.20000","97","226","-129"
"1984","Tennessee Tech","0","11","0","0.00000","78","329","-251"
"1985","Tennessee Tech","1","10","0","0.09091","177","314","-137"
"1989","Florida","3","4","0","0.42857","140","145","-5"
"1997","Western Michigan","8","3","0","0.72727","301","265","36"
"1998","Western Michigan","7","4","0","0.63636","360","312","48"
"1999","Western Michigan","7","5","0","0.58333","373","342","31"
"2000","Western Michigan","9","3","0","0.75000","359","139","220"
"2001","Western Michigan","5","6","0","0.45455","277","266","11"
"2002","Western Michigan","4","8","0","0.33333","303","330","-27"
"2003","Western Michigan","5","7","0","0.41667","331","370","-39"
"2004","Western Michigan","1","10","0","0.09091","248","436","-188"
"2007","Texas A&M","0","1","0","0.00000","17","24","-7"
"2008","Texas A&M","4","8","0","0.33333","300","449","-149"
"2009","Texas A&M","6","7","0","0.46154","427","436","-9"
"2010","Texas A&M","9","4","0","0.69231","406","285","121"
"2011","Texas A&M","6","6","0","0.50000","475","344","131"
"2011","Texas A&M","1","0","0","1.00000","33","22","11"
"2012","Fresno St. (CA)","9","4","0","0.69231","493","310","183"
"2013","Fresno St. (CA)","11","2","0","0.84615","564","394","170"
"2008","Houston (TX)","8","5","0","0.61538","528","402","126"
"2009","Houston (TX)","10","4","0","0.71429","591","421","170"
"2010","Houston (TX)","5","7","0","0.41667","452","386","66"
"2011","Houston (TX)","12","1","0","0.92308","660","300","360"
"2012","Texas A&M","11","2","0","0.84615","578","283","295"
"2013","Texas A&M","9","4","0","0.69231","575","419","156"
"1897","Texas Christian","3","1","0","0.75000","78","24","54"
"1898","Texas Christian","1","3","1","0.30000","41","61","-20"
"1899","Virginia Tech","4","1","0","0.80000","106","28","78"
"1902","Texas Christian","0","5","1","0.08333","0","93","-93"
"1869","Rutgers (NJ)","2","2","0","0.50000","18","18","0"
"1870","Rutgers (NJ)","2","2","0","0.50000","17","17","0"
"1872","Columbia (NY)","5","4","0","0.55556","22","16","6"
"1873","Rutgers (NJ)","7","4","1","0.62500","31","26","5"
"1874","Harvard (MA)","9","7","0","0.56250","54","41","13"
"1875","Harvard (MA)","12","6","2","0.65000","52","29","23"
"1876","Harvard (MA)","13","8","1","0.61364","45","29","16"
"1877","Harvard (MA)","9","7","3","0.55263","31","21","10"
"1878","Pennsylvania","14","9","5","0.58929","42","24","18"
"1879","Harvard (MA)","13","9","12","0.55882","46","27","19"
"1880","Harvard (MA)","18","11","4","0.60606","75","53","22"
"1881","Rutgers (NJ)","22","18","8","0.54167","70","47","23"
"1882","Rutgers (NJ)","41","28","2","0.59155","176","111","65"
"1883","Rutgers (NJ)","38","32","1","0.54225","1288","965","323"
"1884","Pennsylvania","47","29","5","0.61111","1728","1184","544"
"1885","Michigan","34","17","4","0.65455","1437","612","825"
"1886","Lehigh (PA)","48","21","4","0.68493","1850","637","1213"
"1887","California","67","35","3","0.65238","2660","935","1725"
"1888","Princeton (NJ)","70","56","6","0.55303","2468","1899","569"
"1889","Brown (RI)","82","51","11","0.60764","2879","1796","1083"
"1890","Brown (RI)","77","76","9","0.50309","3002","2455","547"
"1891","Southern California","94","76","13","0.54918","2813","2189","624"
"1892","Minnesota","93","80","9","0.53571","2972","2394","578"
"1893","Duke (NC)","79","94","9","0.45879","2176","2912","-736"
"1894","Colorado St.","50","62","4","0.44828","1161","1518","-357"
"1895","Boston (MA)","31","44","11","0.42442","692","1031","-339"
"1896","Rhode Island","54","62","12","0.46875","1126","1201","-75"
"1897","Boston (MA)","32","40","6","0.44872","792","785","7"
"1898","Miami (OH)","47","23","4","0.66216","921","644","277"
"1899","New Hampshire","33","32","6","0.50704","571","522","49"
"1900","New Hampshire","22","35","11","0.40441","442","686","-244"
"1901","Marshall (WV)","18","34","3","0.35455","302","917","-615"
"1902","Saint John's (MN)","9","22","4","0.31429","148","460","-312"
"1903","Wichita St. (KS)","14","25","2","0.36585","376","546","-170"
"1904","Oklahoma St.","11","14","1","0.44231","194","394","-200"
"1905","Miami (OH)","7","25","5","0.25676","245","494","-249"
"1906","Rensselaer Tech (NY)","3","7","4","0.35714","92","107","-15"
"1907","Marshall (WV)","5","10","2","0.35294","71","238","-167"
"1908","Fort Hays St. (KS)","5","6","1","0.45833","56","91","-35"
"1909","Fort Hays St. (KS)","1","3","1","0.30000","12","68","-56"
"1910","Texas St.","0","1","0","0.00000","0","19","-19"
"1912","Fort Hays St. (KS)","1","2","0","0.33333","20","132","-112"
"1913","Eureka (IL)","1","6","0","0.14286","39","203","-164"
"1914","Eureka (IL)","3","4","0","0.42857","57","201","-144"
"1915","Texas St.","1","1","1","0.50000","13","20","-7"
"1916","Texas St.","0","2","1","0.16667","0","106","-106"
"1917","Boston (MA)","4","4","0","0.50000","73","136","-63"
"1918","Monmouth (IL)","1","7","0","0.12500","26","137","-111"
"1930","Troy (AL)","1","2","0","0.33333","7","73","-66"
"2013","Grambling St. (LA)","0","1","0","0.00000","0","0","0"
"1904","Texas Christian","1","4","1","0.25000","5","90","-85"
"1905","Texas Christian","4","4","0","0.50000","77","65","12"
"1906","Texas Christian","2","5","0","0.28571","26","108","-82"
"1907","Texas Christian","4","2","2","0.62500","90","69","21"
"1908","Texas Christian","6","3","0","0.66667","155","63","92"
"1909","Texas Christian","5","2","1","0.68750","95","33","62"
"1910","Texas Christian","2","6","1","0.27778","48","187","-139"
"1911","Texas Christian","4","5","0","0.44444","114","106","8"
"1912","Texas Christian","8","1","0","0.88889","230","53","177"
"1913","Texas Christian","3","1","2","0.66667","44","6","38"
"1914","Texas Christian","4","4","2","0.50000","117","118","-1"
"1917","Kentucky","3","5","1","0.38889","104","56","48"
"1915","Texas Christian","4","5","0","0.44444","130","182","-52"
"1925","Texas Tech","6","1","2","0.77778","210","66","144"
"1926","Texas Tech","6","1","3","0.75000","106","48","58"
"1927","Texas Tech","5","4","0","0.55556","134","100","34"
"1928","Texas Tech","4","4","1","0.50000","47","78","-31"
"1916","Texas Christian","6","2","1","0.72222","217","85","132"
"1917","Texas Christian","8","2","0","0.80000","201","59","142"
"1918","Texas Christian","4","4","0","0.50000","96","92","4"
"1919","Texas Christian","1","7","0","0.12500","20","119","-99"
"1913","Mississippi","6","3","1","0.65000","139","79","60"
"1914","Mississippi","5","4","1","0.55000","110","125","-15"
"1920","Texas Christian","9","1","0","0.90000","170","109","61"
"1921","Texas Christian","6","3","1","0.65000","132","75","57"
"1923","California-Davis","2","7","0","0.22222","43","192","-149"
"1924","California-Davis","5","4","1","0.55000","123","104","19"
"1925","California-Davis","5","3","0","0.62500","81","98","-17"
"1926","California-Davis","2","6","1","0.27778","84","147","-63"
"1927","California-Davis","4","3","1","0.56250","84","82","2"
"1929","Loyola Marymount (CA)","6","3","0","0.66667","131","85","46"
"1922","Texas Christian","2","5","3","0.35000","91","167","-76"
"1923","Texas Christian","4","5","0","0.44444","93","137","-44"
"1924","Texas Christian","4","5","0","0.44444","83","96","-13"
"1925","Texas Christian","7","1","1","0.83333","133","54","79"
"1926","Texas Christian","6","1","2","0.77778","110","74","36"
"1927","Texas Christian","4","3","2","0.55556","89","64","25"
"1928","Texas Christian","8","2","0","0.80000","142","28","114"
"1929","Texas A&M","5","4","0","0.55556","203","65","138"
"1930","Texas A&M","2","7","0","0.22222","66","100","-34"
"1931","Texas A&M","7","3","0","0.70000","137","34","103"
"1932","Texas A&M","4","4","2","0.50000","75","78","-3"
"1933","Texas A&M","6","3","1","0.65000","160","89","71"
"1935","Southern Methodist (TX)","12","1","0","0.92308","288","39","249"
"1936","Southern Methodist (TX)","5","4","1","0.55000","119","66","53"
"1937","Southern Methodist (TX)","5","6","0","0.45455","93","83","10"
"1938","Southern Methodist (TX)","6","4","0","0.60000","148","125","23"
"1939","Southern Methodist (TX)","6","3","1","0.65000","118","60","58"
"1940","Southern Methodist (TX)","8","1","1","0.85000","142","75","67"
"1941","Southern Methodist (TX)","5","5","0","0.50000","169","106","63"
"1945","Southern Methodist (TX)","5","6","0","0.45455","201","110","91"
"1946","Southern Methodist (TX)","4","5","1","0.45000","114","100","14"
"1947","Southern Methodist (TX)","9","0","2","0.90909","182","90","92"
"1948","Southern Methodist (TX)","9","1","1","0.86364","250","105","145"
"1949","Southern Methodist (TX)","5","4","1","0.55000","215","204","11"
"1919","Tulsa (OK)","8","0","1","0.94444","591","27","564"
"1920","Tulsa (OK)","10","0","1","0.95455","621","21","600"
"1921","Tulsa (OK)","6","3","0","0.66667","257","95","162"
"1922","Arkansas","4","5","0","0.44444","143","136","7"
"1923","Arkansas","7","2","1","0.75000","178","40","138"
"1924","Arkansas","7","2","1","0.75000","227","69","158"
"1925","Arkansas","4","4","1","0.50000","95","62","33"
"1926","Arkansas","5","5","0","0.50000","179","88","91"
"1927","Arkansas","8","1","0","0.88889","218","76","142"
"1928","Arkansas","7","2","0","0.77778","251","63","188"
"1929","Texas Christian","9","0","1","0.95000","249","33","216"
"1930","Texas Christian","9","2","1","0.79167","298","49","249"
"1931","Texas Christian","8","2","1","0.77273","119","41","78"
"1932","Texas Christian","10","0","1","0.95455","283","23","260"
"1933","Texas Christian","9","2","1","0.79167","208","49","159"
"1934","Ohio St.","7","1","0","0.87500","267","34","233"
"1935","Ohio St.","7","1","0","0.87500","237","57","180"
"1936","Ohio St.","5","3","0","0.62500","160","27","133"
"1937","Ohio St.","6","2","0","0.75000","125","23","102"
"1938","Ohio St.","4","3","1","0.56250","119","65","54"
"1939","Ohio St.","6","2","0","0.75000","189","64","125"
"1940","Ohio St.","4","4","0","0.50000","99","113","-14"
"1941","Idaho","4","5","0","0.44444","123","135","-12"
"1942","Idaho","3","7","0","0.30000","96","209","-113"
"1934","Texas Christian","8","4","0","0.66667","173","116","57"
"1935","Texas Christian","12","1","0","0.92308","265","73","192"
"1936","Texas Christian","9","2","2","0.76923","160","58","102"
"1937","Texas Christian","4","4","2","0.50000","73","66","7"
"1938","Texas Christian","11","0","0","1.00000","269","60","209"
"1939","Texas Christian","3","7","0","0.30000","116","119","-3"
"1940","Texas Christian","3","7","0","0.30000","116","121","-5"
"1941","Texas Christian","7","3","1","0.68182","162","135","27"
"1942","Texas Christian","7","3","0","0.70000","129","82","47"
"1943","Texas Christian","2","6","0","0.25000","71","146","-75"
"1944","Texas Christian","7","3","1","0.68182","134","109","25"
"1945","Texas Christian","5","5","0","0.50000","91","156","-65"
"1946","Texas Christian","2","7","1","0.25000","90","148","-58"
"1947","Texas Christian","4","5","2","0.45455","114","99","15"
"1948","Texas Christian","4","5","1","0.45000","125","143","-18"
"1949","Texas Christian","6","3","1","0.65000","205","185","20"
"1950","Texas Christian","5","5","0","0.50000","157","161","-4"
"1951","Texas Christian","6","5","0","0.54545","206","183","23"
"1952","Texas Christian","4","4","2","0.50000","141","103","38"
"1953","Texas Christian","3","7","0","0.30000","116","150","-34"
"1954","Texas Christian","4","6","0","0.40000","164","155","9"
"1955","Texas Christian","9","2","0","0.81818","306","105","201"
"1956","Texas Christian","8","3","0","0.72727","231","110","121"
"1957","Texas Christian","5","4","1","0.55000","134","101","33"
"1958","Texas Christian","8","2","1","0.77273","219","78","141"
"1959","Texas Christian","8","3","0","0.72727","169","75","94"
"1960","Texas Christian","4","4","2","0.50000","85","94","-9"
"1961","Texas Christian","3","5","2","0.40000","113","194","-81"
"1962","Texas Christian","6","4","0","0.60000","167","154","13"
"1963","Texas Christian","4","5","1","0.45000","131","166","-35"
"1964","Texas Christian","4","6","0","0.40000","94","169","-75"
"1965","Texas Christian","6","5","0","0.54545","161","156","5"
"1966","Texas Christian","2","8","0","0.20000","55","149","-94"
"1967","Texas Christian","4","6","0","0.40000","113","185","-72"
"1968","Texas Christian","3","7","0","0.30000","176","215","-39"
"1969","Texas Christian","4","6","0","0.40000","177","293","-116"
"1970","Texas Christian","4","6","1","0.40909","189","265","-76"
"1966","Tulane (LA)","5","4","1","0.55000","153","182","-29"
"1967","Tulane (LA)","3","7","0","0.30000","164","223","-59"
"1968","Tulane (LA)","2","8","0","0.20000","163","300","-137"
"1969","Tulane (LA)","3","7","0","0.30000","152","235","-83"
"1970","Tulane (LA)","8","4","0","0.66667","196","160","36"
"1971","Texas Christian","3","3","1","0.50000","159","203","-44"
"1971","Texas Christian","3","1","0","0.75000","55","72","-17"
"1972","Texas Christian","5","6","0","0.45455","213","245","-32"
"1973","Texas Christian","3","8","0","0.27273","189","290","-101"
"1974","Texas Christian","1","10","0","0.09091","79","345","-266"
"1975","Texas Christian","1","10","0","0.09091","103","325","-222"
"1976","Texas Christian","0","11","0","0.00000","128","430","-302"
"1972","Tulsa (OK)","3","2","0","0.60000","125","127","-2"
"1973","Tulsa (OK)","6","5","0","0.54545","258","193","65"
"1974","Tulsa (OK)","8","3","0","0.72727","285","204","81"
"1975","Tulsa (OK)","7","4","0","0.63636","368","181","187"
"1976","Tulsa (OK)","7","4","1","0.62500","253","208","45"
"1977","Texas Christian","2","9","0","0.18182","184","434","-250"
"1978","Texas Christian","2","9","0","0.18182","109","357","-248"
"1979","Texas Christian","2","8","1","0.22727","127","226","-99"
"1980","Texas Christian","1","10","0","0.09091","143","295","-152"
"1981","Texas Christian","2","7","2","0.27273","230","299","-69"
"1982","Texas Christian","3","8","0","0.27273","203","266","-63"
"1976","North Dakota St.","9","3","0","0.75000","221","125","96"
"1977","North Dakota St.","9","2","1","0.79167","374","163","211"
"1978","North Dakota St.","6","4","0","0.60000","308","187","121"
"1979","Texas St.","7","4","0","0.63636","271","202","69"
"1980","Texas St.","8","3","0","0.72727","356","140","216"
"1981","Texas St.","13","1","0","0.92857","554","138","416"
"1982","Texas St.","14","0","0","1.00000","446","199","247"
"1983","Texas Christian","1","8","2","0.18182","174","252","-78"
"1984","Texas Christian","8","4","0","0.66667","376","280","96"
"1985","Texas Christian","3","8","0","0.27273","150","383","-233"
"1986","Texas Christian","3","8","0","0.27273","259","376","-117"
"1987","Texas Christian","5","6","0","0.45455","261","226","35"
"1988","Texas Christian","4","7","0","0.36364","206","286","-80"
"1989","Texas Christian","4","7","0","0.36364","183","301","-118"
"1990","Texas Christian","5","6","0","0.45455","292","353","-61"
"1991","Texas Christian","7","4","0","0.63636","279","267","12"
"1992","Minnesota","2","9","0","0.18182","200","313","-113"
"1993","Minnesota","4","7","0","0.36364","253","354","-101"
"1994","Minnesota","3","8","0","0.27273","256","348","-92"
"1995","Minnesota","3","8","0","0.27273","272","368","-96"
"1996","Minnesota","4","7","0","0.36364","236","340","-104"
"1992","Texas Christian","2","8","1","0.22727","195","319","-124"
"1993","Texas Christian","4","7","0","0.36364","201","313","-112"
"1994","Texas Christian","7","5","0","0.58333","302","301","1"
"1995","Texas Christian","6","5","0","0.54545","217","246","-29"
"1996","Texas Christian","4","7","0","0.36364","211","302","-91"
"1997","Texas Christian","1","10","0","0.09091","172","325","-153"
"2007","Samford (AL)","4","7","0","0.36364","279","384","-105"
"2008","Samford (AL)","6","5","0","0.54545","274","207","67"
"2009","Samford (AL)","5","6","0","0.45455","217","192","25"
"2010","Samford (AL)","4","7","0","0.36364","196","278","-82"
"2011","Samford (AL)","6","5","0","0.54545","311","273","38"
"2012","Samford (AL)","7","4","0","0.63636","272","227","45"
"2013","Samford (AL)","8","5","0","0.61538","391","364","27"
"1981","Southwestern (KS)","5","2","2","0.66667","300","174","126"
"1982","Southwestern (KS)","9","2","0","0.81818","261","130","131"
"1985","Pittsburg St. (KS)","8","2","0","0.80000","299","217","82"
"1986","Pittsburg St. (KS)","11","1","0","0.91667","499","199","300"
"1987","Pittsburg St. (KS)","11","1","0","0.91667","533","108","425"
"1988","Pittsburg St. (KS)","11","1","0","0.91667","423","126","297"
"1989","Pittsburg St. (KS)","12","1","0","0.92308","478","153","325"
"1990","Texas St.","6","5","0","0.54545","268","220","48"
"1991","Texas St.","7","4","0","0.63636","307","179","128"
"1992","New Mexico","3","8","0","0.27273","247","287","-40"
"1993","New Mexico","6","5","0","0.54545","335","256","79"
"1994","New Mexico","5","7","0","0.41667","401","386","15"
"1995","New Mexico","4","7","0","0.36364","256","303","-47"
"1996","New Mexico","6","5","0","0.54545","331","280","51"
"1997","New Mexico","9","4","0","0.69231","404","274","130"
"1998","Texas Christian","7","5","0","0.58333","267","235","32"
"1999","Texas Christian","8","4","0","0.66667","362","213","149"
"2000","Texas Christian","10","1","0","0.90909","410","106","304"
"2001","Alabama","7","5","0","0.58333","318","232","86"
"2002","Alabama","10","3","0","0.76923","367","200","167"
"2003","Texas A&M","4","8","0","0.33333","304","465","-161"
"2004","Texas A&M","7","5","0","0.58333","341","292","49"
"2005","Texas A&M","5","6","0","0.45455","352","343","9"
"2006","Texas A&M","9","4","0","0.69231","362","267","95"
"2007","Texas A&M","7","5","0","0.58333","346","313","33"
"2011","Texas St.","6","6","0","0.50000","306","342","-36"
"2012","Texas St.","4","8","0","0.33333","343","402","-59"
"2013","Texas St.","6","6","0","0.50000","287","328","-41"
"2000","Texas Christian","0","1","0","0.00000","21","28","-7"
"2001","Texas Christian","6","6","0","0.50000","289","285","4"
"2002","Texas Christian","10","2","0","0.83333","361","222","139"
"2003","Texas Christian","11","2","0","0.84615","380","276","104"
"2004","Texas Christian","5","6","0","0.45455","362","373","-11"
"2005","Texas Christian","11","1","0","0.91667","398","223","175"
"2006","Texas Christian","11","2","0","0.84615","380","160","220"
"2007","Texas Christian","8","5","0","0.61538","339","243","96"
"2008","Texas Christian","11","2","0","0.84615","437","147","290"
"2009","Texas Christian","12","1","0","0.92308","498","166","332"
"2010","Texas Christian","13","0","0","1.00000","541","156","385"
"2011","Texas Christian","11","2","0","0.84615","531","279","252"
"2012","Texas Christian","7","6","0","0.53846","368","294","74"
"2013","Texas Christian","4","8","0","0.33333","301","303","-2"
"1869","Rutgers (NJ)","2","2","0","0.50000","18","18","0"
"1870","Rutgers (NJ)","2","2","0","0.50000","17","17","0"
"1872","Columbia (NY)","5","4","0","0.55556","22","16","6"
"1873","Rutgers (NJ)","7","4","1","0.62500","31","26","5"
"1874","Harvard (MA)","9","7","0","0.56250","54","41","13"
"1875","Harvard (MA)","12","6","2","0.65000","52","29","23"
"1876","Harvard (MA)","13","8","1","0.61364","45","29","16"
"1877","Harvard (MA)","9","7","3","0.55263","31","21","10"
"1878","Pennsylvania","14","9","5","0.58929","42","24","18"
"1879","Harvard (MA)","13","9","12","0.55882","46","27","19"
"1880","Harvard (MA)","18","11","4","0.60606","75","53","22"
"1881","Rutgers (NJ)","22","18","8","0.54167","70","47","23"
"1882","Rutgers (NJ)","41","28","2","0.59155","176","111","65"
"1883","Rutgers (NJ)","38","32","1","0.54225","1288","965","323"
"1884","Pennsylvania","47","29","5","0.61111","1728","1184","544"
"1885","Michigan","34","17","4","0.65455","1437","612","825"
"1886","Lehigh (PA)","48","21","4","0.68493","1850","637","1213"
"1887","California","67","35","3","0.65238","2660","935","1725"
"1888","Princeton (NJ)","70","56","6","0.55303","2468","1899","569"
"1889","Brown (RI)","82","51","11","0.60764","2879","1796","1083"
"1890","Brown (RI)","77","76","9","0.50309","3002","2455","547"
"1891","Southern California","94","76","13","0.54918","2813","2189","624"
"1892","Minnesota","93","80","9","0.53571","2972","2394","578"
"1893","Duke (NC)","79","94","9","0.45879","2176","2912","-736"
"1894","Colorado St.","50","62","4","0.44828","1161","1518","-357"
"1895","Boston (MA)","31","44","11","0.42442","692","1031","-339"
"1896","Rhode Island","54","62","12","0.46875","1126","1201","-75"
"1897","Boston (MA)","32","40","6","0.44872","792","785","7"
"1898","Miami (OH)","47","23","4","0.66216","921","644","277"
"1899","New Hampshire","33","32","6","0.50704","571","522","49"
"1900","New Hampshire","22","35","11","0.40441","442","686","-244"
"1901","Marshall (WV)","18","34","3","0.35455","302","917","-615"
"1902","Saint John's (MN)","9","22","4","0.31429","148","460","-312"
"1903","Wichita St. (KS)","14","25","2","0.36585","376","546","-170"
"1904","Oklahoma St.","11","14","1","0.44231","194","394","-200"
"1905","Miami (OH)","7","25","5","0.25676","245","494","-249"
"1906","Rensselaer Tech (NY)","3","7","4","0.35714","92","107","-15"
"1907","Marshall (WV)","5","10","2","0.35294","71","238","-167"
"1908","Fort Hays St. (KS)","5","6","1","0.45833","56","91","-35"
"1909","Fort Hays St. (KS)","1","3","1","0.30000","12","68","-56"
"1910","Texas St.","0","1","0","0.00000","0","19","-19"
"1912","Fort Hays St. (KS)","1","2","0","0.33333","20","132","-112"
"1913","Eureka (IL)","1","6","0","0.14286","39","203","-164"
"1914","Eureka (IL)","3","4","0","0.42857","57","201","-144"
"1915","Texas St.","1","1","1","0.50000","13","20","-7"
"1916","Texas St.","0","2","1","0.16667","0","106","-106"
"1917","Boston (MA)","4","4","0","0.50000","73","136","-63"
"1918","Monmouth (IL)","1","7","0","0.12500","26","137","-111"
"1930","Troy (AL)","1","2","0","0.33333","7","73","-66"
"2013","Grambling St. (LA)","0","1","0","0.00000","0","0","0"
"1885","Minnesota","0","2","0","0.00000","13","27","-14"
"1890","Kentucky","1","0","0","1.00000","8","2","6"
"1896","Saint John's (NY)","1","0","0","1.00000","6","0","6"
"1898","Emporia St. (KS)","0","2","0","0.00000","0","60","-60"
"1900","Boston College (MA)","1","0","0","1.00000","5","0","5"
"1901","Saint John's (NY)","0","1","0","0.00000","0","61","-61"
"1902","La Salle (PA)","0","4","0","0.00000","12","65","-53"
"1904","Louisiana-Lafayette","2","0","1","0.83333","28","4","24"
"1908","Saint John's (NY)","0","2","0","0.00000","0","18","-18"
"1909","North Carolina A&T","0","1","0","0.00000","0","11","-11"
"1910","Clarion (PA)","0","1","0","0.00000","0","39","-39"
"1917","Texas St.","1","0","0","1.00000","12","0","12"
"1924","Manhattan (NY)","4","4","0","0.50000","74","69","5"
"1929","Campbellsville (KY)","0","1","0","0.00000","6","54","-48"
"1943","William & Mary Freshmen (VA)","4","2","0","0.66667","157","56","101"
"1919","Texas St.","4","4","0","0.50000","71","77","-6"
"1920","Texas St.","5","2","1","0.68750","234","84","150"
"1921","Texas St.","7","0","0","1.00000","185","26","159"
"1922","Texas St.","3","3","0","0.50000","92","73","19"
"1923","Texas St.","4","4","0","0.50000","157","69","88"
"1924","Texas St.","4","4","0","0.50000","69","82","-13"
"1925","Texas St.","2","6","1","0.27778","57","106","-49"
"1926","Texas St.","7","2","0","0.77778","171","56","115"
"1927","Texas St.","4","4","1","0.50000","127","71","56"
"1928","Texas St.","2","7","0","0.22222","48","113","-65"
"1929","Texas St.","6","1","2","0.77778","120","75","45"
"1930","Texas St.","5","2","3","0.65000","51","55","-4"
"1931","Texas St.","4","4","0","0.50000","67","46","21"
"1932","Texas St.","5","3","0","0.62500","82","40","42"
"1933","Texas St.","7","1","1","0.83333","84","30","54"
"1934","Texas St.","2","7","1","0.25000","65","91","-26"
"1928","Howard Payne (TX)","10","1","0","0.90909","296","75","221"
"1929","Howard Payne (TX)","8","0","2","0.90000","184","26","158"
"1930","Howard Payne (TX)","7","2","2","0.72727","209","85","124"
"1931","Howard Payne (TX)","6","2","0","0.75000","105","38","67"
"1932","Howard Payne (TX)","7","1","0","0.87500","120","38","82"
"1933","Howard Payne (TX)","5","2","2","0.66667","76","46","30"
"1934","Howard Payne (TX)","9","0","1","0.95000","156","39","117"
"1935","Texas St.","2","7","0","0.22222","45","76","-31"
"1936","Texas St.","2","5","2","0.33333","65","134","-69"
"1937","Texas St.","6","4","0","0.60000","136","110","26"
"1938","Texas St.","0","8","0","0.00000","46","152","-106"
"1939","Texas St.","3","5","2","0.40000","50","76","-26"
"1940","Texas St.","3","5","1","0.38889","100","98","2"
"1941","Texas St.","4","4","0","0.50000","83","56","27"
"1942","Texas St.","3","4","1","0.43750","83","106","-23"
"1946","Howard Payne (TX)","2","5","2","0.33333","86","125","-39"
"1947","Howard Payne (TX)","4","6","0","0.40000","139","124","15"
"1946","Texas St.","6","2","2","0.70000","115","52","63"
"1947","Texas St.","5","4","0","0.55556","115","92","23"
"1948","Texas St.","8","1","0","0.88889","111","34","77"
"1949","Texas St.","3","6","1","0.35000","124","168","-44"
"1950","Texas St.","6","3","0","0.66667","145","136","9"
"1951","Texas St.","6","3","1","0.65000","271","142","129"
"1952","Texas St.","7","2","0","0.77778","261","192","69"
"1953","Texas St.","5","4","0","0.55556","241","186","55"
"1961","Texas St.","4","5","1","0.45000","150","125","25"
"1962","Texas St.","8","2","0","0.80000","269","126","143"
"1963","Texas St.","10","0","0","1.00000","213","81","132"
"1954","Texas St.","6","3","1","0.65000","160","170","-10"
"1955","Texas St.","6","1","2","0.77778","253","103","150"
"1956","Texas St.","6","3","0","0.66667","132","101","31"
"1957","Texas St.","4","6","0","0.40000","139","200","-61"
"1958","Texas St.","5","5","0","0.50000","114","170","-56"
"1959","Texas St.","4","6","0","0.40000","115","157","-42"
"1960","Texas St.","2","8","0","0.20000","64","173","-109"
"1964","Texas St.","8","2","0","0.80000","281","103","178"
"1965","Texas St.","8","2","0","0.80000","234","74","160"
"1966","Texas St.","7","2","1","0.75000","181","93","88"
"1967","Texas St.","9","1","0","0.90000","374","108","266"
"1968","Texas St.","5","5","0","0.50000","248","195","53"
"1969","Texas St.","3","6","1","0.35000","219","241","-22"
"1970","Texas St.","6","5","0","0.54545","256","220","36"
"1971","Texas St.","8","1","1","0.85000","304","133","171"
"1972","Texas St.","7","3","0","0.70000","213","145","68"
"1973","Texas St.","4","6","0","0.40000","161","198","-37"
"1974","Texas St.","6","4","0","0.60000","156","153","3"
"1975","Texas St.","7","3","0","0.70000","209","169","40"
"1976","Texas St.","5","5","0","0.50000","215","204","11"
"1977","Texas St.","5","4","0","0.55556","168","164","4"
"1978","Texas St.","6","4","0","0.60000","218","124","94"
"1976","North Dakota St.","9","3","0","0.75000","221","125","96"
"1977","North Dakota St.","9","2","1","0.79167","374","163","211"
"1978","North Dakota St.","6","4","0","0.60000","308","187","121"
"1979","Texas St.","7","4","0","0.63636","271","202","69"
"1980","Texas St.","8","3","0","0.72727","356","140","216"
"1981","Texas St.","13","1","0","0.92857","554","138","416"
"1982","Texas St.","14","0","0","1.00000","446","199","247"
"1983","Texas Christian","1","8","2","0.18182","174","252","-78"
"1984","Texas Christian","8","4","0","0.66667","376","280","96"
"1985","Texas Christian","3","8","0","0.27273","150","383","-233"
"1986","Texas Christian","3","8","0","0.27273","259","376","-117"
"1987","Texas Christian","5","6","0","0.45455","261","226","35"
"1988","Texas Christian","4","7","0","0.36364","206","286","-80"
"1989","Texas Christian","4","7","0","0.36364","183","301","-118"
"1990","Texas Christian","5","6","0","0.45455","292","353","-61"
"1991","Texas Christian","7","4","0","0.63636","279","267","12"
"1992","Minnesota","2","9","0","0.18182","200","313","-113"
"1993","Minnesota","4","7","0","0.36364","253","354","-101"
"1994","Minnesota","3","8","0","0.27273","256","348","-92"
"1995","Minnesota","3","8","0","0.27273","272","368","-96"
"1996","Minnesota","4","7","0","0.36364","236","340","-104"
"1983","Texas St.","9","2","0","0.81818","358","128","230"
"1984","Texas St.","7","4","0","0.63636","240","204","36"
"1985","Texas St.","3","8","0","0.27273","247","262","-15"
"1986","Texas St.","4","7","0","0.36364","200","234","-34"
"1987","Texas St.","4","7","0","0.36364","186","254","-68"
"1988","Texas St.","4","7","0","0.36364","222","281","-59"
"1989","Texas St.","5","6","0","0.45455","245","198","47"
"1981","Southwestern (KS)","5","2","2","0.66667","300","174","126"
"1982","Southwestern (KS)","9","2","0","0.81818","261","130","131"
"1985","Pittsburg St. (KS)","8","2","0","0.80000","299","217","82"
"1986","Pittsburg St. (KS)","11","1","0","0.91667","499","199","300"
"1987","Pittsburg St. (KS)","11","1","0","0.91667","533","108","425"
"1988","Pittsburg St. (KS)","11","1","0","0.91667","423","126","297"
"1989","Pittsburg St. (KS)","12","1","0","0.92308","478","153","325"
"1990","Texas St.","6","5","0","0.54545","268","220","48"
"1991","Texas St.","7","4","0","0.63636","307","179","128"
"1992","New Mexico","3","8","0","0.27273","247","287","-40"
"1993","New Mexico","6","5","0","0.54545","335","256","79"
"1994","New Mexico","5","7","0","0.41667","401","386","15"
"1995","New Mexico","4","7","0","0.36364","256","303","-47"
"1996","New Mexico","6","5","0","0.54545","331","280","51"
"1997","New Mexico","9","4","0","0.69231","404","274","130"
"1998","Texas Christian","7","5","0","0.58333","267","235","32"
"1999","Texas Christian","8","4","0","0.66667","362","213","149"
"2000","Texas Christian","10","1","0","0.90909","410","106","304"
"2001","Alabama","7","5","0","0.58333","318","232","86"
"2002","Alabama","10","3","0","0.76923","367","200","167"
"2003","Texas A&M","4","8","0","0.33333","304","465","-161"
"2004","Texas A&M","7","5","0","0.58333","341","292","49"
"2005","Texas A&M","5","6","0","0.45455","352","343","9"
"2006","Texas A&M","9","4","0","0.69231","362","267","95"
"2007","Texas A&M","7","5","0","0.58333","346","313","33"
"2011","Texas St.","6","6","0","0.50000","306","342","-36"
"2012","Texas St.","4","8","0","0.33333","343","402","-59"
"2013","Texas St.","6","6","0","0.50000","287","328","-41"
"1992","Texas St.","5","5","1","0.50000","253","190","63"
"1993","Texas St.","2","9","0","0.18182","220","375","-155"
"1994","Texas St.","4","7","0","0.36364","223","307","-84"
"1995","Texas St.","4","7","0","0.36364","274","303","-29"
"1996","Texas St.","5","6","0","0.45455","221","310","-89"
"1997","Texas St.","5","6","0","0.45455","273","276","-3"
"1998","Texas St.","4","7","0","0.36364","186","269","-83"
"1999","Texas St.","3","8","0","0.27273","217","210","7"
"2000","Texas St.","7","4","0","0.63636","220","183","37"
"2001","Texas St.","4","7","0","0.36364","188","258","-70"
"2002","Texas St.","4","7","0","0.36364","211","290","-79"
"1995","Emporia St. (KS)","5","6","0","0.45455","319","314","5"
"1996","Emporia St. (KS)","5","6","0","0.45455","345","381","-36"
"1997","Emporia St. (KS)","8","3","0","0.72727","465","298","167"
"1998","Emporia St. (KS)","9","2","0","0.81818","428","276","152"
"2003","Texas St.","4","8","0","0.33333","315","417","-102"
"2013","Bethany (KS)","2","9","0","0.18182","206","389","-183"
"2004","Texas St.","5","6","0","0.45455","283","285","-2"
"2005","Texas St.","11","3","0","0.78571","518","284","234"
"2006","Texas St.","5","6","0","0.45455","244","248","-4"
"2007","Rice (TX)","3","9","0","0.25000","377","515","-138"
"2008","Rice (TX)","10","3","0","0.76923","537","433","104"
"2009","Rice (TX)","2","10","0","0.16667","219","517","-298"
"2010","Rice (TX)","4","8","0","0.33333","344","462","-118"
"2011","Rice (TX)","4","8","0","0.33333","280","400","-120"
"2012","Rice (TX)","7","6","0","0.53846","414","390","24"
"2013","Rice (TX)","10","4","0","0.71429","415","342","73"
"2007","Texas St.","4","7","0","0.36364","309","414","-105"
"2008","Texas St.","8","5","0","0.61538","473","407","66"
"2009","Texas St.","7","4","0","0.63636","351","317","34"
"2010","Texas St.","4","7","0","0.36364","273","377","-104"
"1915","Texas Christian","4","5","0","0.44444","130","182","-52"
"1925","Texas Tech","6","1","2","0.77778","210","66","144"
"1926","Texas Tech","6","1","3","0.75000","106","48","58"
"1927","Texas Tech","5","4","0","0.55556","134","100","34"
"1928","Texas Tech","4","4","1","0.50000","47","78","-31"
"1929","Texas Tech","1","7","2","0.20000","31","130","-99"
"1930","Texas Tech","3","6","0","0.33333","90","121","-31"
"1931","Texas Tech","6","3","0","0.66667","150","66","84"
"1932","Texas Tech","10","2","0","0.83333","382","35","347"
"1933","Texas Tech","8","1","0","0.88889","145","30","115"
"1934","Texas Tech","7","2","1","0.75000","192","84","108"
"1935","Texas Tech","5","3","2","0.60000","110","55","55"
"1936","Texas Tech","5","4","1","0.55000","111","85","26"
"1937","Texas Tech","8","4","0","0.66667","163","93","70"
"1938","Texas Tech","10","1","0","0.90909","287","55","232"
"1939","Texas Tech","5","5","1","0.50000","150","74","76"
"1940","Texas Tech","9","1","1","0.86364","241","131","110"
"1941","Texas Tech","9","2","0","0.81818","226","36","190"
"1942","Texas Tech","4","5","1","0.45000","111","87","24"
"1943","Texas Tech","4","6","0","0.40000","128","177","-49"
"1944","Texas Tech","4","7","0","0.36364","134","170","-36"
"1945","Texas Tech","3","5","2","0.40000","63","145","-82"
"1946","Texas Tech","8","3","0","0.72727","148","116","32"
"1947","Texas Tech","6","5","0","0.54545","184","228","-44"
"1948","Texas Tech","7","3","0","0.70000","212","135","77"
"1949","Texas Tech","7","5","0","0.58333","187","184","3"
"1950","Texas Tech","3","8","0","0.27273","222","241","-19"
"1951","Texas Tech","7","4","0","0.63636","301","169","132"
"1952","Texas Tech","3","7","1","0.31818","233","239","-6"
"1953","Texas Tech","11","1","0","0.91667","463","167","296"
"1954","Texas Tech","7","2","1","0.75000","367","157","210"
"1955","Texas Tech","7","3","1","0.68182","202","166","36"
"1956","Texas Tech","2","7","1","0.25000","117","216","-99"
"1957","Texas Tech","2","8","0","0.20000","120","190","-70"
"1958","Texas Tech","3","7","0","0.30000","126","163","-37"
"1959","Texas Tech","4","6","0","0.40000","139","158","-19"
"1960","Texas Tech","3","6","1","0.35000","148","182","-34"
"1961","Texas Tech","4","6","0","0.40000","94","201","-107"
"1962","Texas Tech","1","9","0","0.10000","83","250","-167"
"1963","Texas Tech","5","5","0","0.50000","147","178","-31"
"1964","Texas Tech","6","4","1","0.59091","166","120","46"
"1965","Texas Tech","8","3","0","0.72727","278","222","56"
"1966","Texas Tech","4","6","0","0.40000","181","216","-35"
"1967","Texas Tech","6","4","0","0.60000","217","165","52"
"1968","Texas Tech","5","3","2","0.60000","255","241","14"
"1969","Texas Tech","5","5","0","0.50000","212","240","-28"
"1966","West Virginia","3","5","2","0.40000","158","197","-39"
"1967","West Virginia","5","4","1","0.55000","188","117","71"
"1968","West Virginia","7","3","0","0.70000","207","141","66"
"1969","West Virginia","10","1","0","0.90909","302","113","189"
"1970","Texas Tech","8","4","0","0.66667","222","165","57"
"1971","Texas Tech","4","7","0","0.36364","131","138","-7"
"1972","Texas Tech","8","4","0","0.66667","282","188","94"
"1973","Texas Tech","11","1","0","0.91667","342","187","155"
"1974","Texas Tech","6","4","2","0.58333","193","158","35"
"1975","South Carolina","7","5","0","0.58333","328","274","54"
"1976","South Carolina","6","5","0","0.54545","195","143","52"
"1977","South Carolina","5","7","0","0.41667","215","202","13"
"1978","South Carolina","5","5","1","0.50000","238","181","57"
"1979","South Carolina","8","4","0","0.66667","246","205","41"
"1980","South Carolina","8","4","0","0.66667","348","200","148"
"1981","South Carolina","6","6","0","0.50000","225","222","3"
"1973","Vanderbilt (TN)","5","6","0","0.45455","181","262","-81"
"1974","Vanderbilt (TN)","7","3","2","0.66667","313","199","114"
"1975","Texas Tech","6","5","0","0.54545","272","251","21"
"1976","Texas Tech","10","2","0","0.83333","336","206","130"
"1977","Texas Tech","7","5","0","0.58333","299","246","53"
"1978","Mississippi","5","6","0","0.45455","181","240","-59"
"1979","Mississippi","4","7","0","0.36364","251","298","-47"
"1980","Mississippi","3","8","0","0.27273","263","266","-3"
"1981","Mississippi","4","6","1","0.40909","167","284","-117"
"1982","Mississippi","4","7","0","0.36364","208","262","-54"
"1983","Duke (NC)","3","8","0","0.27273","246","350","-104"
"1984","Duke (NC)","2","9","0","0.18182","128","301","-173"
"1985","Duke (NC)","4","7","0","0.36364","193","252","-59"
"1986","Duke (NC)","4","7","0","0.36364","200","284","-84"
"1978","Texas Tech","7","4","0","0.63636","246","268","-22"
"1979","Texas Tech","3","6","2","0.36364","141","182","-41"
"1980","Texas Tech","5","6","0","0.45455","178","188","-10"
"1981","Memphis (TN)","1","10","0","0.09091","82","209","-127"
"1982","Memphis (TN)","1","10","0","0.09091","129","284","-155"
"1983","Memphis (TN)","6","4","1","0.59091","274","205","69"
"1979","North Texas","5","6","0","0.45455","182","235","-53"
"1980","North Texas","6","5","0","0.54545","268","252","16"
"1981","Texas Tech","1","9","1","0.13636","198","298","-100"
"1982","Texas Tech","4","7","0","0.36364","157","234","-77"
"1983","Texas Tech","3","7","1","0.31818","160","253","-93"
"1984","Texas Tech","4","7","0","0.36364","200","212","-12"
"1985","Texas Tech","4","7","0","0.36364","249","240","9"
"1989","Appalachian St. (NC)","9","3","0","0.75000","306","177","129"
"1990","Appalachian St. (NC)","6","5","0","0.54545","171","266","-95"
"1991","Appalachian St. (NC)","8","4","0","0.66667","215","202","13"
"1992","Appalachian St. (NC)","7","5","0","0.58333","262","237","25"
"1993","Appalachian St. (NC)","4","7","0","0.36364","207","252","-45"
"1994","Appalachian St. (NC)","9","4","0","0.69231","363","209","154"
"1995","Appalachian St. (NC)","12","1","0","0.92308","375","251","124"
"1996","Appalachian St. (NC)","7","4","0","0.63636","223","196","27"
"1997","Appalachian St. (NC)","7","4","0","0.63636","294","215","79"
"1998","Appalachian St. (NC)","10","3","0","0.76923","356","222","134"
"1999","Appalachian St. (NC)","9","3","0","0.75000","369","219","150"
"2000","Appalachian St. (NC)","10","4","0","0.71429","441","278","163"
"2001","Appalachian St. (NC)","9","4","0","0.69231","411","278","133"
"2002","Appalachian St. (NC)","8","4","0","0.66667","314","273","41"
"2003","Appalachian St. (NC)","7","4","0","0.63636","252","219","33"
"2004","Appalachian St. (NC)","6","5","0","0.54545","366","358","8"
"2005","Appalachian St. (NC)","12","3","0","0.80000","455","282","173"
"2006","Appalachian St. (NC)","14","1","0","0.93333","528","223","305"
"2007","Appalachian St. (NC)","13","2","0","0.86667","641","400","241"
"2008","Appalachian St. (NC)","11","3","0","0.78571","522","303","219"
"2009","Appalachian St. (NC)","11","3","0","0.78571","465","313","152"
"2010","Appalachian St. (NC)","10","3","0","0.76923","446","307","139"
"2011","Appalachian St. (NC)","8","4","0","0.66667","344","286","58"
"2012","Appalachian St. (NC)","8","4","0","0.66667","395","352","43"
"1986","Texas Tech","7","4","0","0.63636","254","248","6"
"1987","Texas","7","5","0","0.58333","335","324","11"
"1988","Texas","4","7","0","0.36364","252","304","-52"
"1989","Texas","5","6","0","0.45455","220","289","-69"
"1990","Texas","10","2","0","0.83333","358","227","131"
"1991","Texas","5","6","0","0.45455","195","145","50"
"1986","Texas Tech","0","1","0","0.00000","17","20","-3"
"1987","Texas Tech","6","4","1","0.59091","315","266","49"
"1988","Texas Tech","5","6","0","0.45455","328","332","-4"
"1989","Texas Tech","9","3","0","0.75000","360","281","79"
"1990","Texas Tech","4","7","0","0.36364","322","356","-34"
"1991","Texas Tech","6","5","0","0.54545","315","272","43"
"1992","Texas Tech","5","6","0","0.45455","287","332","-45"
"1993","Texas Tech","6","6","0","0.50000","419","335","84"
"1994","Texas Tech","6","6","0","0.50000","312","246","66"
"1995","Texas Tech","9","3","0","0.75000","385","247","138"
"1996","Texas Tech","7","5","0","0.58333","323","232","91"
"1997","Texas Tech","6","5","0","0.54545","245","217","28"
"1998","Texas Tech","7","5","0","0.58333","315","255","60"
"1999","Texas Tech","6","5","0","0.54545","253","282","-29"
"2000","Texas Tech","7","6","0","0.53846","330","278","52"
"2001","Texas Tech","7","5","0","0.58333","402","281","121"
"2002","Texas Tech","9","5","0","0.64286","537","439","98"
"2003","Texas Tech","8","5","0","0.61538","552","442","110"
"2004","Texas Tech","8","4","0","0.66667","434","314","120"
"2005","Texas Tech","9","3","0","0.75000","473","226","247"
"2006","Texas Tech","8","5","0","0.61538","422","326","96"
"2007","Texas Tech","9","4","0","0.69231","532","337","195"
"2008","Texas Tech","11","2","0","0.84615","569","362","207"
"2009","Texas Tech","8","4","0","0.66667","440","261","179"
"2012","Washington St.","3","9","0","0.25000","245","404","-159"
"2013","Washington St.","6","7","0","0.46154","403","423","-20"
"2009","Texas Tech","1","0","0","1.00000","41","31","10"
"2010","East Carolina (NC)","6","7","0","0.46154","478","572","-94"
"2011","East Carolina (NC)","5","7","0","0.41667","315","387","-72"
"2012","East Carolina (NC)","8","5","0","0.61538","409","411","-2"
"2013","East Carolina (NC)","10","3","0","0.76923","522","322","200"
"2005","Abilene Christian (TX)","4","6","0","0.40000","253","268","-15"
"2006","Abilene Christian (TX)","8","3","0","0.72727","390","243","147"
"2007","Abilene Christian (TX)","10","3","0","0.76923","639","390","249"
"2008","Abilene Christian (TX)","11","1","0","0.91667","628","275","353"
"2009","Abilene Christian (TX)","9","4","0","0.69231","376","256","120"
"2010","Abilene Christian (TX)","11","1","0","0.91667","520","258","262"
"2011","Abilene Christian (TX)","8","3","0","0.72727","410","324","86"
"2012","Texas Tech","1","0","0","1.00000","34","31","3"
"1995","Mississippi","6","5","0","0.54545","209","208","1"
"1996","Mississippi","5","6","0","0.45455","203","270","-67"
"1997","Mississippi","8","4","0","0.66667","267","240","27"
"1998","Mississippi","6","5","0","0.54545","245","256","-11"
"1999","Auburn (AL)","5","6","0","0.45455","233","236","-3"
"2000","Auburn (AL)","9","4","0","0.69231","316","266","50"
"2001","Auburn (AL)","7","5","0","0.58333","254","281","-27"
"2002","Auburn (AL)","9","4","0","0.69231","388","231","157"
"2003","Auburn (AL)","8","5","0","0.61538","342","212","130"
"2004","Auburn (AL)","13","0","0","1.00000","417","147","270"
"2005","Auburn (AL)","9","3","0","0.75000","386","186","200"
"2006","Auburn (AL)","11","2","0","0.84615","322","181","141"
"2007","Auburn (AL)","9","4","0","0.69231","315","220","95"
"2008","Auburn (AL)","5","7","0","0.41667","208","216","-8"
"2010","Texas Tech","8","5","0","0.61538","430","402","28"
"2011","Texas Tech","5","7","0","0.41667","406","471","-65"
"2012","Texas Tech","7","5","0","0.58333","453","382","71"
"2013","Cincinnati (OH)","9","4","0","0.69231","417","273","144"
"2013","Texas Tech","8","5","0","0.61538","465","397","68"
"1914","Texas-El Paso","2","3","0","0.40000","34","64","-30"
"1915","Texas-El Paso","3","2","0","0.60000","65","60","5"
"1916","Texas-El Paso","2","3","0","0.40000","28","137","-109"
"1917","Texas-El Paso","0","0","1","0.50000","0","0","0"
"1919","Texas-El Paso","2","4","0","0.33333","67","132","-65"
"1872","Stevens Tech (NJ)","0","1","0","0.00000","0","6","-6"
"1873","New York (NY)","3","3","0","0.50000","15","13","2"
"1874","Stevens Tech (NJ)","2","3","0","0.40000","10","20","-10"
"1875","Stevens Tech (NJ)","4","4","0","0.50000","21","20","1"
"1876","New York (NY)","2","3","1","0.41667","16","19","-3"
"1877","Stevens Tech (NJ)","3","1","2","0.66667","9","14","-5"
"1878","Stevens Tech (NJ)","3","3","3","0.50000","3","9","-6"
"1879","Stevens Tech (NJ)","2","3","5","0.45000","8","14","-6"
"1880","Stevens Tech (NJ)","1","5","0","0.16667","3","16","-13"
"1881","Stevens Tech (NJ)","3","8","3","0.32143","16","29","-13"
"1882","Lawrence (WI)","7","8","1","0.46875","17","25","-8"
"1883","Stevens Tech (NJ)","7","6","1","0.53571","187","128","59"
"1884","Fordham (NY)","9","10","0","0.47368","221","261","-40"
"1885","Georgetown (DC)","5","17","1","0.23913","359","612","-253"
"1886","New York (NY)","9","15","2","0.38462","180","565","-385"
"1887","Fordham (NY)","8","12","1","0.40476","157","445","-288"
"1888","Amherst (MA)","6","17","3","0.28846","192","791","-599"
"1889","New York (NY)","8","21","4","0.30303","278","647","-369"
"1890","New York (NY)","25","14","2","0.63415","727","538","189"
"1891","Delaware","32","30","7","0.51449","966","971","-5"
"1892","Beloit (WI)","29","31","3","0.48413","726","797","-71"
"1893","Marquette (WI)","39","34","3","0.53289","1091","885","206"
"1894","Manhattan (NY)","32","29","7","0.52206","853","692","161"
"1895","Delaware","44","35","6","0.55294","889","813","76"
"1896","Manhattan (NY)","51","49","6","0.50943","949","1164","-215"
"1897","Stevens Tech (NJ)","37","50","4","0.42857","661","1048","-387"
"1898","Manhattan (NY)","37","43","9","0.46629","781","1050","-269"
"1899","Manhattan (NY)","34","40","6","0.46250","594","1063","-469"
"1900","Manhattan (NY)","43","47","11","0.48020","991","1049","-58"
"1901","Ferris St. (MI)","51","44","7","0.53431","906","852","54"
"1902","Indiana St.","56","48","5","0.53670","1053","927","126"
"1903","Manhattan (NY)","30","49","7","0.38953","762","1319","-557"
"1904","Saint Francis (NY)","44","53","9","0.45755","787","1363","-576"
"1905","Bluffton (OH)","38","59","5","0.39706","850","1433","-583"
"1906","Ferris St. (MI)","32","43","12","0.43678","677","854","-177"
"1907","Ferris St. (MI)","32","48","10","0.41111","722","1208","-486"
"1908","Western Illinois","36","45","10","0.45055","760","1069","-309"
"1909","Delaware Valley (PA)","27","52","2","0.34568","682","1287","-605"
"1910","East Stroudsburg (PA)","23","31","3","0.42982","583","738","-155"
"1911","Western Illinois","32","44","7","0.42771","661","902","-241"
"1912","Indiana (PA)","36","56","7","0.39899","1134","1463","-329"
"1913","Saint Francis (NY)","52","67","8","0.44094","1672","2360","-688"
"1914","Delaware Valley (PA)","41","50","6","0.45361","1217","1585","-368"
"1915","Western Illinois","34","35","11","0.49375","932","1217","-285"
"1916","Morgan St. (MD)","44","43","7","0.50532","1493","1270","223"
"1917","Morgan St. (MD)","21","21","2","0.50000","408","883","-475"
"1918","Oklahoma Baptist University","7","16","2","0.32000","258","358","-100"
"1919","Western Illinois","53","41","8","0.55882","1478","1056","422"
"1920","Virginia Union","28","39","2","0.42029","506","893","-387"
"1921","Cooper Union (NY)","19","34","3","0.36607","441","1112","-671"
"1922","Cooper Union (NY)","27","34","6","0.44776","703","832","-129"
"1923","Cooper Union (NY)","31","45","2","0.41026","718","1112","-394"
"1924","East Stroudsburg (PA)","34","40","6","0.46250","946","1175","-229"
"1925","Saint Anselm (NH)","32","28","10","0.52857","847","802","45"
"1926","Saint Anselm (NH)","22","30","4","0.42857","515","702","-187"
"1927","Bethune-Cookman (FL)","20","29","8","0.42105","674","783","-109"
"1928","Saint Anselm (NH)","28","24","7","0.53390","564","1095","-531"
"1929","Saint Anselm (NH)","25","32","5","0.44355","616","843","-227"
"1930","Saint Anselm (NH)","31","27","10","0.52941","643","549","94"
"1931","Campbell (NC)","21","17","4","0.54762","465","428","37"
"1932","Campbell (NC)","7","30","3","0.21250","254","760","-506"
"1933","Campbell (NC)","11","13","3","0.46296","262","324","-62"
"1934","Bowie St. (MD)","4","7","2","0.38462","116","94","22"
"1935","Florida Southern","7","12","1","0.37500","170","162","8"
"1936","Bowie St. (MD)","5","2","1","0.68750","154","97","57"
"1937","Bowie St. (MD)","6","3","0","0.66667","98","87","11"
"1938","West Alabama","7","5","0","0.58333","151","88","63"
"1939","Elizabeth City St. (NC)","7","13","0","0.35000","150","307","-157"
"1940","Elizabeth City St. (NC)","6","5","4","0.53333","128","67","61"
"1941","Arkansas-Pine Bluff","3","9","5","0.32353","178","223","-45"
"1942","Brevard College (NC)","10","6","2","0.61111","225","189","36"
"1943","Clark Atlanta (GA)","6","8","0","0.42857","127","206","-79"
"1944","Abilene Christian (TX)","9","11","1","0.45238","158","255","-97"
"1945","Benedict (SC)","10","15","2","0.40741","299","296","3"
"1946","Elizabeth City St. (NC)","7","20","3","0.28333","144","540","-396"
"1947","Clark Atlanta (GA)","3","6","2","0.36364","49","230","-181"
"1948","Virginia-Lynchburg","4","6","1","0.40909","77","302","-225"
"1949","Virginia-Lynchburg","0","3","1","0.12500","7","70","-63"
"1950","Virginia-Lynchburg","2","3","0","0.40000","53","98","-45"
"1951","Lane (TN)","8","6","0","0.57143","295","234","61"
"1952","Lane (TN)","9","5","1","0.63333","220","206","14"
"1953","Lane (TN)","1","7","0","0.12500","58","215","-157"
"1954","Lane (TN)","2","6","0","0.25000","105","135","-30"
"1955","Lane (TN)","2","4","0","0.33333","83","129","-46"
"1957","Louisiana College","2","7","0","0.22222","106","179","-73"
"1959","Azusa Pacific (CA)","2","3","0","0.40000","117","90","27"
"1960","Azusa Pacific (CA)","4","3","1","0.56250","103","76","27"
"1961","Azusa Pacific (CA)","3","3","0","0.50000","123","147","-24"
"1963","San Francisco (CA)","2","5","0","0.28571","58","98","-40"
"1964","New York (NY)","0","2","0","0.00000","20","48","-28"
"1965","Adelphi (NY)","4","8","0","0.33333","198","216","-18"
"1966","Fairfield (CT)","18","22","2","0.45238","545","652","-107"
"1967","La Salle (PA)","25","31","0","0.44643","846","1080","-234"
"1968","Centenary (LA)","17","42","2","0.29508","726","1393","-667"
"1969","Bluffton (OH)","33","43","0","0.43421","1058","1548","-490"
"1970","Saint John's (NY)","35","54","1","0.39444","1379","1783","-404"
"1971","Bluffton (OH)","43","45","1","0.48876","1360","1384","-24"
"1972","Marquette (WI)","39","44","2","0.47059","1217","1351","-134"
"1973","Brooklyn (NY)","30","52","1","0.36747","1007","1611","-604"
"1974","Marquette (WI)","33","36","3","0.47917","959","1169","-210"
"1975","Marquette (WI)","31","22","4","0.57895","1042","932","110"
"1976","Bluffton (OH)","23","33","1","0.41228","862","1186","-324"
"1977","Manhattan (NY)","14","28","1","0.33721","568","923","-355"
"1978","Fairfield (CT)","5","7","1","0.42308","194","203","-9"
"1979","Fairfield (CT)","7","8","0","0.46667","247","260","-13"
"1980","Westfield St. (MA)","6","5","4","0.53333","184","196","-12"
"1981","San Francisco (CA)","17","14","0","0.54839","567","498","69"
"1982","Manhattan (NY)","18","16","0","0.52941","580","644","-64"
"1983","SUNY-Stony Brook (NY)","15","11","0","0.57692","474","453","21"
"1984","Stonehill (MA)","7","12","0","0.36842","231","439","-208"
"1985","Manhattan (NY)","10","10","0","0.50000","313","316","-3"
"1986","Marquette (WI)","13","17","0","0.43333","497","564","-67"
"1987","Marquette (WI)","10","17","0","0.37037","389","487","-98"
"1988","Marquette (WI)","1","5","0","0.16667","80","125","-45"
"1989","Marquette (WI)","4","4","0","0.50000","209","151","58"
"1990","Marquette (WI)","1","7","0","0.12500","80","180","-100"
"1991","Marquette (WI)","1","5","0","0.16667","106","182","-76"
"1992","Marquette (WI)","2","5","0","0.28571","81","129","-48"
"1993","Marquette (WI)","7","1","0","0.87500","212","126","86"
"1994","Marquette (WI)","1","6","0","0.14286","125","184","-59"
"1995","Marquette (WI)","3","4","0","0.42857","141","191","-50"
"1996","Marquette (WI)","3","5","0","0.37500","139","182","-43"
"1998","Madison College (WI)","2","15","0","0.11765","221","613","-392"
"1999","Marquette (WI)","0","7","0","0.00000","110","298","-188"
"2000","Marquette (WI)","1","5","0","0.16667","60","96","-36"
"2001","Marquette (WI)","2","6","0","0.25000","144","179","-35"
"2002","Marquette (WI)","3","4","0","0.42857","127","208","-81"
"2003","Marquette (WI)","1","6","0","0.14286","71","151","-80"
"2004","Marquette (WI)","0","6","0","0.00000","53","238","-185"
"2005","Marquette (WI)","2","5","0","0.28571","92","226","-134"
"2006","Marquette (WI)","1","6","0","0.14286","62","206","-144"
"2007","Marquette (WI)","2","5","0","0.28571","140","215","-75"
"2008","Marquette (WI)","0","7","0","0.00000","61","304","-243"
"2009","Marquette (WI)","0","1","0","0.00000","0","22","-22"
"1908","Sewanee (TN)","4","1","3","0.68750","94","20","74"
"1920","Texas-El Paso","2","4","0","0.33333","73","180","-107"
"1921","Texas-El Paso","0","5","0","0.00000","14","149","-135"
"1922","Texas-El Paso","5","4","0","0.55556","157","108","49"
"1923","Texas-El Paso","3","4","0","0.42857","115","65","50"
"1924","Texas-El Paso","3","2","1","0.58333","70","51","19"
"1925","Texas-El Paso","5","1","1","0.78571","118","57","61"
"1926","Texas-El Paso","3","4","0","0.42857","106","92","14"
"1907","Mount Union (OH)","9","2","0","0.81818","265","23","242"
"1909","Allegheny (PA)","2","4","1","0.35714","41","115","-74"
"1910","Allegheny (PA)","4","1","1","0.75000","81","29","52"
"1913","Oregon St.","3","2","3","0.56250","59","75","-16"
"1914","Oregon St.","7","0","2","0.88889","172","15","157"
"1915","Oregon St.","5","3","0","0.62500","166","73","93"
"1916","Nebraska","6","2","0","0.75000","145","51","94"
"1917","Nebraska","5","2","0","0.71429","228","33","195"
"1921","Clemson (SC)","1","6","2","0.22222","48","187","-139"
"1922","Clemson (SC)","5","4","0","0.55556","170","109","61"
"1923","Texas","8","0","1","0.94444","241","21","220"
"1924","Texas","5","3","1","0.61111","109","64","45"
"1925","Texas","6","2","1","0.72222","157","51","106"
"1926","Texas","5","4","0","0.55556","146","69","77"
"1927","Texas-El Paso","2","2","2","0.50000","69","69","0"
"1928","Texas-El Paso","3","4","1","0.43750","100","103","-3"
"1929","Texas-El Paso","6","1","2","0.77778","154","46","108"
"1930","Texas-El Paso","7","1","1","0.83333","186","67","119"
"1931","Texas-El Paso","7","1","0","0.87500","146","83","63"
"1932","Texas-El Paso","7","3","0","0.70000","222","113","109"
"1933","Texas-El Paso","3","5","1","0.38889","71","79","-8"
"1934","Texas-El Paso","4","4","0","0.50000","128","104","24"
"1935","Texas-El Paso","1","8","0","0.11111","23","178","-155"
"1936","Texas-El Paso","5","3","1","0.61111","92","86","6"
"1937","Texas-El Paso","7","1","2","0.80000","215","91","124"
"1938","Texas-El Paso","6","3","0","0.66667","153","72","81"
"1939","Texas-El Paso","5","4","0","0.55556","110","71","39"
"1940","Texas-El Paso","4","4","1","0.50000","129","115","14"
"1941","Texas-El Paso","4","5","1","0.45000","184","192","-8"
"1942","Texas-El Paso","5","4","0","0.55556","162","111","51"
"1940","West Texas A&M","7","3","0","0.70000","238","101","137"
"1941","West Texas A&M","8","2","0","0.80000","298","107","191"
"1946","Texas-El Paso","3","6","0","0.33333","136","150","-14"
"1947","Texas-El Paso","5","3","1","0.61111","159","79","80"
"1948","Texas-El Paso","8","2","1","0.77273","361","182","179"
"1949","Texas-El Paso","8","2","1","0.77273","292","113","179"
"1950","Utah","3","4","3","0.45000","240","254","-14"
"1951","Utah","7","4","0","0.63636","236","247","-11"
"1952","Utah","6","3","1","0.65000","188","128","60"
"1953","Utah","8","2","0","0.80000","264","150","114"
"1954","Utah","4","7","0","0.36364","172","212","-40"
"1955","Utah","6","3","0","0.66667","182","136","46"
"1956","Utah","5","5","0","0.50000","227","177","50"
"1957","Utah","6","4","0","0.60000","262","136","126"
"1958","Stanford (CA)","2","8","0","0.20000","93","226","-133"
"1959","Stanford (CA)","3","7","0","0.30000","232","261","-29"
"1960","Stanford (CA)","0","10","0","0.00000","111","254","-143"
"1961","Stanford (CA)","4","6","0","0.40000","105","163","-58"
"1962","Stanford (CA)","5","5","0","0.50000","124","174","-50"
"1950","Texas-El Paso","7","3","0","0.70000","279","232","47"
"1951","Texas-El Paso","3","7","0","0.30000","152","241","-89"
"1952","Texas-El Paso","5","5","1","0.50000","228","236","-8"
"1953","Texas-El Paso","8","2","0","0.80000","257","144","113"
"1954","Texas-El Paso","8","3","0","0.72727","290","197","93"
"1955","Texas-El Paso","6","2","2","0.70000","227","114","113"
"1956","Texas-El Paso","9","2","0","0.81818","305","78","227"
"1957","Texas-El Paso","6","3","0","0.66667","202","168","34"
"1958","Texas-El Paso","2","7","0","0.22222","92","179","-87"
"1959","Texas-El Paso","3","7","0","0.30000","163","191","-28"
"1960","Texas-El Paso","4","5","1","0.45000","167","176","-9"
"1961","Texas-El Paso","3","7","0","0.30000","176","283","-107"
"1962","Texas-El Paso","4","5","0","0.44444","84","144","-60"
"1963","Texas-El Paso","3","7","0","0.30000","98","142","-44"
"1964","Texas-El Paso","0","8","2","0.10000","64","217","-153"
"1955","Tulsa (OK)","2","7","1","0.25000","124","232","-108"
"1956","Tulsa (OK)","7","2","1","0.75000","169","76","93"
"1957","Tulsa (OK)","4","6","0","0.40000","110","145","-35"
"1958","Tulsa (OK)","7","3","0","0.70000","216","100","116"
"1959","Tulsa (OK)","5","5","0","0.50000","137","164","-27"
"1960","Tulsa (OK)","5","5","0","0.50000","169","230","-61"
"1965","Texas-El Paso","8","3","0","0.72727","317","206","111"
"1966","Texas-El Paso","6","4","0","0.60000","293","187","106"
"1967","Texas-El Paso","7","2","1","0.75000","337","145","192"
"1968","Texas-El Paso","4","5","1","0.45000","232","225","7"
"1969","Texas-El Paso","4","6","0","0.40000","158","242","-84"
"1970","Texas-El Paso","6","4","0","0.60000","263","236","27"
"1971","Texas-El Paso","5","6","0","0.45455","166","217","-51"
"1972","Texas-El Paso","1","5","0","0.16667","104","197","-93"
"1964","Brigham Young (UT)","3","6","1","0.35000","173","210","-37"
"1965","Brigham Young (UT)","6","4","0","0.60000","229","178","51"
"1966","Brigham Young (UT)","8","2","0","0.80000","269","163","106"
"1967","Brigham Young (UT)","6","4","0","0.60000","278","215","63"
"1968","Brigham Young (UT)","2","8","0","0.20000","179","247","-68"
"1969","Brigham Young (UT)","6","4","0","0.60000","186","158","28"
"1970","Brigham Young (UT)","3","8","0","0.27273","138","255","-117"
"1971","Brigham Young (UT)","5","6","0","0.45455","227","199","28"
"1972","Texas-El Paso","1","3","0","0.25000","78","148","-70"
"1973","Texas-El Paso","0","11","0","0.00000","142","544","-402"
"1974","Texas-El Paso","4","7","0","0.36364","246","298","-52"
"1975","Texas-El Paso","1","10","0","0.09091","109","281","-172"
"1976","Texas-El Paso","1","11","0","0.08333","172","356","-184"
"1977","Texas-El Paso","1","10","0","0.09091","151","460","-309"
"1978","Texas-El Paso","1","11","0","0.08333","151","424","-273"
"1979","Texas-El Paso","2","9","0","0.18182","106","266","-160"
"1980","Texas-El Paso","1","11","0","0.08333","143","424","-281"
"1981","Texas-El Paso","0","2","0","0.00000","22","51","-29"
"1981","Texas-El Paso","1","8","0","0.11111","124","390","-266"
"1977","West Texas A&M","6","4","1","0.59091","263","183","80"
"1978","West Texas A&M","3","8","0","0.27273","237","297","-60"
"1979","West Texas A&M","5","5","1","0.50000","239","195","44"
"1980","West Texas A&M","5","6","0","0.45455","232","284","-52"
"1981","West Texas A&M","7","4","0","0.63636","247","213","34"
"1982","Texas-El Paso","2","10","0","0.16667","177","417","-240"
"1983","Texas-El Paso","2","10","0","0.16667","210","359","-149"
"1984","Texas-El Paso","2","9","0","0.18182","180","374","-194"
"1985","Texas-El Paso","1","10","0","0.09091","196","375","-179"
"1984","Massachusetts","3","8","0","0.27273","148","219","-71"
"1985","Massachusetts","7","4","0","0.63636","198","127","71"
"1986","Texas-El Paso","4","8","0","0.33333","309","391","-82"
"1987","Texas-El Paso","7","4","0","0.63636","309","234","75"
"1988","Texas-El Paso","10","3","0","0.76923","445","275","170"
"1989","Missouri","2","9","0","0.18182","171","363","-192"
"1990","Missouri","4","7","0","0.36364","278","360","-82"
"1991","Missouri","3","7","1","0.31818","223","403","-180"
"1992","Missouri","3","8","0","0.27273","214","269","-55"
"1993","Missouri","3","7","1","0.31818","192","344","-152"
"1989","Texas-El Paso","2","10","0","0.16667","238","412","-174"
"1990","Texas-El Paso","3","8","0","0.27273","191","342","-151"
"1991","Texas-El Paso","4","7","1","0.37500","254","252","2"
"1992","Texas-El Paso","1","10","0","0.09091","254","386","-132"
"1993","Texas-El Paso","1","6","0","0.14286","155","254","-99"
"1986","Memphis (TN)","1","10","0","0.09091","104","292","-188"
"1987","Memphis (TN)","5","5","1","0.50000","220","210","10"
"1988","Memphis (TN)","6","5","0","0.54545","226","205","21"
"1993","Texas-El Paso","0","5","0","0.00000","65","195","-130"
"1994","Texas-El Paso","3","7","1","0.31818","217","359","-142"
"1995","Texas-El Paso","2","10","0","0.16667","263","486","-223"
"1996","Texas-El Paso","2","9","0","0.18182","183","314","-131"
"1997","Texas-El Paso","4","7","0","0.36364","162","311","-149"
"1998","Texas-El Paso","3","8","0","0.27273","226","305","-79"
"1999","Texas-El Paso","5","7","0","0.41667","306","389","-83"
"2000","Texas-El Paso","8","4","0","0.66667","378","336","42"
"2001","Texas-El Paso","2","9","0","0.18182","235","414","-179"
"2002","Texas-El Paso","2","10","0","0.16667","220","511","-291"
"2003","Texas-El Paso","2","11","0","0.15385","288","498","-210"
"1981","Weber St. (UT)","7","4","0","0.63636","271","228","43"
"1982","Weber St. (UT)","4","7","0","0.36364","261","312","-51"
"1983","Weber St. (UT)","6","5","0","0.54545","290","279","11"
"1984","Weber St. (UT)","5","6","0","0.45455","287","312","-25"
"1985","Weber St. (UT)","6","5","0","0.54545","411","333","78"
"1986","Weber St. (UT)","3","8","0","0.27273","332","351","-19"
"1987","Weber St. (UT)","10","3","0","0.76923","489","382","107"
"1988","Weber St. (UT)","5","6","0","0.45455","360","341","19"
"1989","Washington St.","6","5","0","0.54545","351","268","83"
"1990","Washington St.","3","8","0","0.27273","286","381","-95"
"1991","Washington St.","4","7","0","0.36364","280","340","-60"
"1992","Washington St.","9","3","0","0.75000","337","281","56"
"1993","Washington St.","5","6","0","0.45455","271","248","23"
"1994","Washington St.","8","4","0","0.66667","192","136","56"
"1995","Washington St.","3","8","0","0.27273","236","274","-38"
"1996","Washington St.","5","6","0","0.45455","314","317","-3"
"1997","Washington St.","10","2","0","0.83333","483","296","187"
"1998","Washington St.","3","8","0","0.27273","223","349","-126"
"1999","Washington St.","3","9","0","0.25000","248","327","-79"
"2000","Washington St.","4","7","0","0.36364","281","354","-73"
"2001","Washington St.","10","2","0","0.83333","420","269","151"
"2002","Washington St.","10","3","0","0.76923","431","296","135"
"2004","Texas-El Paso","8","4","0","0.66667","429","301","128"
"2005","Texas-El Paso","8","4","0","0.66667","382","311","71"
"2006","Texas-El Paso","5","7","0","0.41667","328","375","-47"
"2007","Texas-El Paso","4","8","0","0.33333","403","445","-42"
"2008","Texas-El Paso","5","7","0","0.41667","395","444","-49"
"2009","Texas-El Paso","4","8","0","0.33333","358","402","-44"
"2010","Texas-El Paso","6","7","0","0.46154","338","357","-19"
"2011","Texas-El Paso","5","7","0","0.41667","319","364","-45"
"2012","Texas-El Paso","3","9","0","0.25000","254","357","-103"
"2013","Texas-El Paso","2","10","0","0.16667","261","472","-211"
"2001","Miami (FL)","12","0","0","1.00000","512","117","395"
"2002","Miami (FL)","12","1","0","0.92308","527","248","279"
"2003","Miami (FL)","11","2","0","0.84615","361","196","165"
"2004","Miami (FL)","9","3","0","0.75000","380","204","176"
"2005","Miami (FL)","9","3","0","0.75000","325","171","154"
"2006","Miami (FL)","7","6","0","0.53846","255","201","54"
"2011","Texas-San Antonio","4","6","0","0.40000","266","214","52"
"2012","Texas-San Antonio","8","4","0","0.66667","374","345","29"
"2013","Texas-San Antonio","7","5","0","0.58333","307","316","-9"
"1917","Toledo (OH)","0","3","0","0.00000","0","262","-262"
"1918","Toledo (OH)","1","1","0","0.50000","36","43","-7"
"1919","Toledo (OH)","2","4","0","0.33333","31","73","-42"
"1920","Toledo (OH)","0","3","0","0.00000","7","67","-60"
"1921","Toledo (OH)","3","5","0","0.37500","94","68","26"
"1922","Toledo (OH)","2","2","3","0.50000","17","19","-2"
"1923","Toledo (OH)","6","4","0","0.60000","257","105","152"
"1924","Toledo (OH)","5","3","0","0.62500","84","127","-43"
"1925","Toledo (OH)","1","8","0","0.11111","28","172","-144"
"1926","Toledo (OH)","3","5","0","0.37500","81","154","-73"
"1927","Toledo (OH)","5","2","0","0.71429","88","64","24"
"1928","Toledo (OH)","1","6","0","0.14286","46","130","-84"
"1929","Toledo (OH)","4","2","1","0.64286","68","70","-2"
"1930","Toledo (OH)","2","5","1","0.31250","50","138","-88"
"1932","Toledo (OH)","3","4","0","0.42857","42","40","2"
"1933","Toledo (OH)","4","2","2","0.62500","100","66","34"
"1934","Toledo (OH)","5","3","0","0.62500","123","55","68"
"1935","Toledo (OH)","6","2","1","0.72222","185","32","153"
"1917","Dartmouth (NH)","5","3","0","0.62500","83","68","15"
"1918","Dartmouth (NH)","3","3","0","0.50000","78","83","-5"
"1919","Dartmouth (NH)","6","1","1","0.81250","141","53","88"
"1920","Dartmouth (NH)","7","2","0","0.77778","199","68","131"
"1921","West Virginia","5","4","1","0.55000","161","82","79"
"1922","West Virginia","10","0","1","0.95455","267","34","233"
"1923","West Virginia","7","1","1","0.83333","297","41","256"
"1924","West Virginia","8","1","0","0.88889","282","47","235"
"1925","Minnesota","5","2","1","0.68750","176","91","85"
"1926","Minnesota","5","3","0","0.62500","269","57","212"
"1927","Minnesota","6","0","2","0.87500","209","51","158"
"1928","Minnesota","6","2","0","0.75000","182","36","146"
"1929","Minnesota","6","2","0","0.75000","179","55","124"
"1930","Oregon","7","2","0","0.77778","131","35","96"
"1931","Oregon","6","2","2","0.70000","90","87","3"
"1932","Wisconsin","6","1","1","0.81250","151","48","103"
"1933","Wisconsin","2","5","1","0.31250","54","79","-25"
"1934","Wisconsin","4","4","0","0.50000","48","84","-36"
"1935","Wisconsin","1","7","0","0.12500","53","171","-118"
"1936","Toledo (OH)","2","6","0","0.25000","94","58","36"
"1937","Toledo (OH)","6","3","0","0.66667","128","96","32"
"1938","Toledo (OH)","6","3","1","0.65000","156","83","73"
"1939","Toledo (OH)","7","3","0","0.70000","180","59","121"
"1940","Toledo (OH)","6","3","0","0.66667","146","78","68"
"1941","Toledo (OH)","7","4","0","0.63636","195","122","73"
"1942","Toledo (OH)","4","4","1","0.50000","91","114","-23"
"1943","Maryland","4","5","0","0.44444","105","194","-89"
"1944","Maryland","1","7","1","0.16667","46","170","-124"
"1946","Toledo (OH)","6","2","2","0.70000","200","132","68"
"1947","Toledo (OH)","9","2","0","0.81818","255","115","140"
"1934","Delaware","4","3","1","0.56250","51","71","-20"
"1941","Brown (RI)","5","4","0","0.55556","102","81","21"
"1942","Brown (RI)","4","4","0","0.50000","96","114","-18"
"1943","Brown (RI)","5","3","0","0.62500","194","180","14"
"1946","George Washington (DC)","4","3","0","0.57143","107","87","20"
"1947","George Washington (DC)","1","7","1","0.16667","92","177","-85"
"1948","Toledo (OH)","5","6","0","0.45455","206","225","-19"
"1949","Toledo (OH)","6","4","0","0.60000","318","210","108"
"1954","Idaho","4","5","0","0.44444","96","153","-57"
"1955","Idaho","2","7","0","0.22222","128","174","-46"
"1956","Idaho","4","5","0","0.44444","198","215","-17"
"1957","Idaho","4","4","1","0.50000","140","108","32"
"1958","Idaho","4","5","0","0.44444","114","139","-25"
"1959","Idaho","1","9","0","0.10000","79","293","-214"
"1960","Idaho","1","9","0","0.10000","104","256","-152"
"1961","Idaho","2","7","0","0.22222","65","351","-286"
"1950","Toledo (OH)","4","5","0","0.44444","200","234","-34"
"1951","Toledo (OH)","4","3","0","0.57143","203","127","76"
"1951","Toledo (OH)","2","1","0","0.66667","57","51","6"
"1952","Toledo (OH)","4","5","0","0.44444","132","151","-19"
"1953","Toledo (OH)","3","6","0","0.33333","113","305","-192"
"1946","Arkansas St.","4","3","3","0.55000","99","103","-4"
"1947","Arkansas St.","4","2","3","0.61111","159","91","68"
"1948","Arkansas St.","4","4","1","0.50000","131","186","-55"
"1949","Arkansas St.","4","5","0","0.44444","87","176","-89"
"1950","Arkansas St.","6","3","0","0.66667","201","179","22"
"1951","Arkansas St.","10","2","0","0.83333","456","111","345"
"1952","Arkansas St.","8","3","0","0.72727","351","123","228"
"1953","Arkansas St.","8","0","2","0.90000","239","65","174"
"1954","Toledo (OH)","6","2","1","0.72222","205","113","92"
"1955","Toledo (OH)","3","5","1","0.38889","77","213","-136"
"1956","Toledo (OH)","1","7","1","0.16667","118","250","-132"
"1957","Toledo (OH)","5","4","0","0.55556","136","147","-11"
"1958","Toledo (OH)","4","5","0","0.44444","122","168","-46"
"1959","Toledo (OH)","2","6","1","0.27778","123","200","-77"
"1960","Toledo (OH)","2","7","0","0.22222","126","192","-66"
"1961","Toledo (OH)","3","7","0","0.30000","146","170","-24"
"1962","Toledo (OH)","3","6","0","0.33333","133","176","-43"
"1976","Merchant Marine (NY)","8","1","0","0.88889","170","85","85"
"1963","Toledo (OH)","2","7","0","0.22222","118","176","-58"
"1964","Toledo (OH)","2","8","0","0.20000","127","218","-91"
"1965","Toledo (OH)","5","5","0","0.50000","104","96","8"
"1966","Toledo (OH)","2","7","1","0.25000","137","162","-25"
"1967","Toledo (OH)","9","1","0","0.90000","266","83","183"
"1968","Toledo (OH)","5","4","1","0.55000","230","156","74"
"1969","Toledo (OH)","11","0","0","1.00000","385","160","225"
"1970","Toledo (OH)","12","0","0","1.00000","384","88","296"
"1971","Iowa","1","10","0","0.09091","121","379","-258"
"1972","Iowa","3","7","1","0.31818","109","208","-99"
"1973","Iowa","0","11","0","0.00000","140","401","-261"
"1971","Toledo (OH)","12","0","0","1.00000","383","96","287"
"1972","Toledo (OH)","6","5","0","0.54545","196","210","-14"
"1973","Toledo (OH)","3","8","0","0.27273","229","288","-59"
"1974","Toledo (OH)","6","5","0","0.54545","262","270","-8"
"1975","Toledo (OH)","5","6","0","0.45455","244","277","-33"
"1976","Toledo (OH)","3","8","0","0.27273","185","232","-47"
"1977","Toledo (OH)","2","9","0","0.18182","112","287","-175"
"1978","Toledo (OH)","2","9","0","0.18182","144","256","-112"
"1979","Toledo (OH)","8","2","1","0.77273","213","190","23"
"1980","Toledo (OH)","4","7","0","0.36364","187","190","-3"
"1981","Toledo (OH)","9","3","0","0.75000","270","170","100"
"1982","Utah","5","6","0","0.45455","247","188","59"
"1983","Utah","5","6","0","0.45455","296","289","7"
"1984","Utah","6","5","1","0.54167","347","253","94"
"1989","Memphis (TN)","2","9","0","0.18182","174","338","-164"
"1990","Memphis (TN)","4","6","1","0.40909","212","233","-21"
"1991","Memphis (TN)","5","6","0","0.45455","228","229","-1"
"1992","Memphis (TN)","6","5","0","0.54545","312","181","131"
"1993","Memphis (TN)","6","5","0","0.54545","268","215","53"
"1994","Memphis (TN)","6","5","0","0.54545","163","159","4"
"1982","Toledo (OH)","6","5","0","0.54545","184","162","22"
"1983","Toledo (OH)","9","2","0","0.81818","276","167","109"
"1984","Toledo (OH)","8","3","1","0.70833","187","164","23"
"1985","Toledo (OH)","4","7","0","0.36364","135","187","-52"
"1986","Toledo (OH)","7","4","0","0.63636","216","197","19"
"1987","Toledo (OH)","3","7","1","0.31818","165","245","-80"
"1988","Toledo (OH)","6","5","0","0.54545","244","221","23"
"1989","Toledo (OH)","6","5","0","0.54545","254","272","-18"
"1990","Toledo (OH)","9","2","0","0.81818","284","178","106"
"1995","Michigan St.","6","5","1","0.54167","287","338","-51"
"1996","Michigan St.","6","6","0","0.50000","358","302","56"
"1997","Michigan St.","7","5","0","0.58333","342","237","105"
"1998","Michigan St.","6","6","0","0.50000","336","294","42"
"1999","Michigan St.","9","2","0","0.81818","341","211","130"
"2000","Louisiana St.","8","4","0","0.66667","320","235","85"
"2001","Louisiana St.","10","3","0","0.76923","418","302","116"
"2002","Louisiana St.","8","5","0","0.61538","323","238","85"
"2003","Louisiana St.","13","1","0","0.92857","475","154","321"
"2004","Louisiana St.","9","3","0","0.75000","344","205","139"
"2007","Alabama","2","6","0","0.25000","352","286","66"
"2008","Alabama","12","2","0","0.85714","422","200","222"
"2009","Alabama","14","0","0","1.00000","449","164","285"
"2010","Alabama","10","3","0","0.76923","464","176","288"
"2011","Alabama","12","1","0","0.92308","453","106","347"
"2012","Alabama","13","1","0","0.92857","542","153","389"
"2013","Alabama","11","2","0","0.84615","496","181","315"
"1991","Toledo (OH)","5","5","1","0.50000","187","209","-22"
"1992","Toledo (OH)","8","3","0","0.72727","269","153","116"
"1993","Toledo (OH)","4","7","0","0.36364","252","270","-18"
"1994","Toledo (OH)","6","4","1","0.59091","352","324","28"
"1995","Toledo (OH)","11","0","1","0.95833","411","264","147"
"1996","Toledo (OH)","7","4","0","0.63636","210","259","-49"
"1997","Toledo (OH)","9","3","0","0.75000","356","268","88"
"1998","Toledo (OH)","7","5","0","0.58333","229","216","13"
"1999","Toledo (OH)","6","5","0","0.54545","293","229","64"
"2000","Toledo (OH)","10","1","0","0.90909","400","125","275"
"2001","Missouri","4","7","0","0.36364","240","330","-90"
"2002","Missouri","5","7","0","0.41667","360","352","8"
"2003","Missouri","8","5","0","0.61538","399","287","112"
"2004","Missouri","5","6","0","0.45455","256","215","41"
"2005","Missouri","7","5","0","0.58333","369","350","19"
"2006","Missouri","8","5","0","0.61538","391","254","137"
"2007","Missouri","12","2","0","0.85714","558","326","232"
"2008","Missouri","10","4","0","0.71429","591","381","210"
"2009","Missouri","8","5","0","0.61538","377","330","47"
"2010","Missouri","10","3","0","0.76923","388","209","179"
"2011","Missouri","7","5","0","0.58333","396","279","117"
"2012","Missouri","5","7","0","0.41667","309","341","-32"
"2013","Missouri","12","2","0","0.85714","548","323","225"
"2001","Toledo (OH)","10","2","0","0.83333","407","297","110"
"2002","Toledo (OH)","9","5","0","0.64286","495","378","117"
"2003","Toledo (OH)","8","4","0","0.66667","389","285","104"
"2004","Toledo (OH)","9","4","0","0.69231","432","404","28"
"2005","Toledo (OH)","9","3","0","0.75000","429","261","168"
"2006","Toledo (OH)","5","7","0","0.41667","281","332","-51"
"2007","Toledo (OH)","5","7","0","0.41667","395","470","-75"
"2008","Toledo (OH)","3","9","0","0.25000","269","377","-108"
"2009","Toledo (OH)","5","7","0","0.41667","356","452","-96"
"2010","Toledo (OH)","8","5","0","0.61538","363","371","-8"
"2011","Toledo (OH)","8","4","0","0.66667","507","371","136"
"2012","Illinois","2","10","0","0.16667","200","385","-185"
"2013","Illinois","4","8","0","0.33333","356","425","-69"
"2011","Toledo (OH)","1","0","0","1.00000","42","41","1"
"2012","Toledo (OH)","9","4","0","0.69231","410","369","41"
"2013","Toledo (OH)","7","5","0","0.58333","396","343","53"
"1909","Troy (AL)","1","0","2","0.66667","6","0","6"
"1910","Troy (AL)","1","1","2","0.50000","11","16","-5"
"1910","Jacksonville St. (AL)","1","3","2","0.33333","62","34","28"
"1911","Troy (AL)","4","1","1","0.75000","49","20","29"
"1912","Troy (AL)","3","0","0","1.00000","61","10","51"
"1921","Troy (AL)","1","7","0","0.12500","19","284","-265"
"1922","Troy (AL)","6","4","1","0.59091","177","92","85"
"1923","Troy (AL)","5","3","0","0.62500","96","73","23"
"1924","Troy (AL)","2","1","4","0.57143","59","20","39"
"1925","Troy (AL)","5","3","0","0.62500","76","120","-44"
"1926","Troy (AL)","7","1","1","0.83333","147","21","126"
"1927","Troy (AL)","5","3","0","0.62500","195","66","129"
"1928","Troy (AL)","2","4","0","0.33333","20","155","-135"
"1869","Rutgers (NJ)","2","2","0","0.50000","18","18","0"
"1870","Rutgers (NJ)","2","2","0","0.50000","17","17","0"
"1872","Columbia (NY)","5","4","0","0.55556","22","16","6"
"1873","Rutgers (NJ)","7","4","1","0.62500","31","26","5"
"1874","Harvard (MA)","9","7","0","0.56250","54","41","13"
"1875","Harvard (MA)","12","6","2","0.65000","52","29","23"
"1876","Harvard (MA)","13","8","1","0.61364","45","29","16"
"1877","Harvard (MA)","9","7","3","0.55263","31","21","10"
"1878","Pennsylvania","14","9","5","0.58929","42","24","18"
"1879","Harvard (MA)","13","9","12","0.55882","46","27","19"
"1880","Harvard (MA)","18","11","4","0.60606","75","53","22"
"1881","Rutgers (NJ)","22","18","8","0.54167","70","47","23"
"1882","Rutgers (NJ)","41","28","2","0.59155","176","111","65"
"1883","Rutgers (NJ)","38","32","1","0.54225","1288","965","323"
"1884","Pennsylvania","47","29","5","0.61111","1728","1184","544"
"1885","Michigan","34","17","4","0.65455","1437","612","825"
"1886","Lehigh (PA)","48","21","4","0.68493","1850","637","1213"
"1887","California","67","35","3","0.65238","2660","935","1725"
"1888","Princeton (NJ)","70","56","6","0.55303","2468","1899","569"
"1889","Brown (RI)","82","51","11","0.60764","2879","1796","1083"
"1890","Brown (RI)","77","76","9","0.50309","3002","2455","547"
"1891","Southern California","94","76","13","0.54918","2813","2189","624"
"1892","Minnesota","93","80","9","0.53571","2972","2394","578"
"1893","Duke (NC)","79","94","9","0.45879","2176","2912","-736"
"1894","Colorado St.","50","62","4","0.44828","1161","1518","-357"
"1895","Boston (MA)","31","44","11","0.42442","692","1031","-339"
"1896","Rhode Island","54","62","12","0.46875","1126","1201","-75"
"1897","Boston (MA)","32","40","6","0.44872","792","785","7"
"1898","Miami (OH)","47","23","4","0.66216","921","644","277"
"1899","New Hampshire","33","32","6","0.50704","571","522","49"
"1900","New Hampshire","22","35","11","0.40441","442","686","-244"
"1901","Marshall (WV)","18","34","3","0.35455","302","917","-615"
"1902","Saint John's (MN)","9","22","4","0.31429","148","460","-312"
"1903","Wichita St. (KS)","14","25","2","0.36585","376","546","-170"
"1904","Oklahoma St.","11","14","1","0.44231","194","394","-200"
"1905","Miami (OH)","7","25","5","0.25676","245","494","-249"
"1906","Rensselaer Tech (NY)","3","7","4","0.35714","92","107","-15"
"1907","Marshall (WV)","5","10","2","0.35294","71","238","-167"
"1908","Fort Hays St. (KS)","5","6","1","0.45833","56","91","-35"
"1909","Fort Hays St. (KS)","1","3","1","0.30000","12","68","-56"
"1910","Texas St.","0","1","0","0.00000","0","19","-19"
"1912","Fort Hays St. (KS)","1","2","0","0.33333","20","132","-112"
"1913","Eureka (IL)","1","6","0","0.14286","39","203","-164"
"1914","Eureka (IL)","3","4","0","0.42857","57","201","-144"
"1915","Texas St.","1","1","1","0.50000","13","20","-7"
"1916","Texas St.","0","2","1","0.16667","0","106","-106"
"1917","Boston (MA)","4","4","0","0.50000","73","136","-63"
"1918","Monmouth (IL)","1","7","0","0.12500","26","137","-111"
"1930","Troy (AL)","1","2","0","0.33333","7","73","-66"
"2013","Grambling St. (LA)","0","1","0","0.00000","0","0","0"
"1931","Troy (AL)","6","4","0","0.60000","136","99","37"
"1932","Troy (AL)","7","3","0","0.70000","152","53","99"
"1933","Troy (AL)","5","1","0","0.83333","99","26","73"
"1934","Troy (AL)","6","2","1","0.72222","170","52","118"
"1935","Troy (AL)","5","5","0","0.50000","168","169","-1"
"1936","Troy (AL)","3","5","0","0.37500","39","125","-86"
"1937","Troy (AL)","3","6","2","0.36364","49","167","-118"
"1938","Troy (AL)","4","4","1","0.50000","85","89","-4"
"1939","Troy (AL)","7","4","0","0.63636","121","71","50"
"1940","Troy (AL)","3","6","0","0.33333","60","109","-49"
"1941","Troy (AL)","5","4","0","0.55556","104","125","-21"
"1942","Troy (AL)","4","3","0","0.57143","129","126","3"
"1946","Troy (AL)","4","4","0","0.50000","58","117","-59"
"1946","West Alabama","4","2","0","0.66667","110","70","40"
"1947","Troy (AL)","5","4","1","0.55000","183","109","74"
"1948","Troy (AL)","6","5","0","0.54545","171","121","50"
"1949","Troy (AL)","6","3","1","0.65000","166","105","61"
"1950","Troy (AL)","3","6","1","0.35000","123","160","-37"
"1951","Troy (AL)","2","7","0","0.22222","80","277","-197"
"1952","Troy (AL)","4","6","0","0.40000","161","225","-64"
"1953","Troy (AL)","3","5","0","0.37500","66","86","-20"
"1954","Troy (AL)","2","5","1","0.31250","98","156","-58"
"1955","Troy (AL)","2","6","0","0.25000","65","161","-96"
"1956","Troy (AL)","3","5","0","0.37500","107","147","-40"
"1957","Troy (AL)","2","6","0","0.25000","60","181","-121"
"1958","Troy (AL)","3","6","0","0.33333","128","150","-22"
"1959","Troy (AL)","3","5","0","0.37500","107","170","-63"
"1960","Troy (AL)","1","8","0","0.11111","82","236","-154"
"1961","Troy (AL)","1","8","0","0.11111","56","273","-217"
"1962","Troy (AL)","2","6","0","0.25000","89","177","-88"
"1963","Troy (AL)","2","7","0","0.22222","64","124","-60"
"1964","Troy (AL)","6","3","0","0.66667","126","122","4"
"1965","Troy (AL)","1","8","0","0.11111","63","236","-173"
"1966","Troy (AL)","5","5","0","0.50000","229","186","43"
"1967","Troy (AL)","8","2","0","0.80000","287","100","187"
"1968","Troy (AL)","11","1","0","0.91667","519","158","361"
"1969","Troy (AL)","8","1","1","0.85000","283","110","173"
"1970","Troy (AL)","6","4","1","0.59091","259","198","61"
"1971","Troy (AL)","6","3","0","0.66667","178","146","32"
"1972","Troy (AL)","4","5","1","0.45000","176","143","33"
"1973","Troy (AL)","7","2","1","0.75000","208","111","97"
"1974","Troy (AL)","6","4","0","0.60000","274","218","56"
"1975","Troy (AL)","6","4","0","0.60000","194","172","22"
"1962","Kentucky","3","5","2","0.40000","85","101","-16"
"1963","Kentucky","3","6","1","0.35000","142","168","-26"
"1964","Kentucky","5","5","0","0.50000","150","194","-44"
"1965","Kentucky","6","4","0","0.60000","202","160","42"
"1966","Kentucky","3","6","1","0.35000","107","196","-89"
"1967","Kentucky","2","8","0","0.20000","111","230","-119"
"1968","Kentucky","3","7","0","0.30000","141","206","-65"
"1976","Troy (AL)","8","1","1","0.85000","206","119","87"
"1977","Troy (AL)","6","4","0","0.60000","214","194","20"
"1978","Troy (AL)","8","2","0","0.80000","229","144","85"
"1979","Troy (AL)","6","3","1","0.65000","234","116","118"
"1980","Troy (AL)","8","2","0","0.80000","282","105","177"
"1981","Troy (AL)","3","7","0","0.30000","182","192","-10"
"1982","Troy (AL)","2","8","0","0.20000","177","210","-33"
"1983","Troy (AL)","7","4","0","0.63636","263","226","37"
"1984","Troy (AL)","12","1","0","0.92308","372","185","187"
"1993","Samford (AL)","5","6","0","0.45455","191","255","-64"
"2002","Georgia Tech","7","6","0","0.53846","280","267","13"
"2003","Georgia Tech","7","6","0","0.53846","274","266","8"
"2004","Georgia Tech","7","5","0","0.58333","264","227","37"
"2005","Georgia Tech","7","5","0","0.58333","222","241","-19"
"2006","Georgia Tech","9","5","0","0.64286","349","257","92"
"2007","Georgia Tech","7","5","0","0.58333","313","231","82"
"1985","Troy (AL)","6","4","0","0.60000","256","161","95"
"1986","Troy (AL)","10","2","0","0.83333","403","239","164"
"1987","Troy (AL)","12","1","1","0.89286","467","166","301"
"1988","Southern Illinois","4","7","0","0.36364","201","262","-61"
"1993","Nicholls St. (LA)","3","8","0","0.27273","269","377","-108"
"1994","Nicholls St. (LA)","5","6","0","0.45455","248","227","21"
"2002","Delta St. (MS)","4","7","0","0.36364","269","284","-15"
"2003","Delta St. (MS)","9","2","0","0.81818","458","208","250"
"2004","Delta St. (MS)","6","4","0","0.60000","443","296","147"
"2005","Delta St. (MS)","7","4","0","0.63636","360","286","74"
"2006","Delta St. (MS)","12","3","0","0.80000","436","201","235"
"1988","Troy (AL)","4","6","0","0.40000","215","184","31"
"1989","Troy (AL)","4","6","0","0.40000","160","230","-70"
"1990","Troy (AL)","5","5","0","0.50000","228","209","19"
"1991","Troy (AL)","5","6","0","0.45455","230","200","30"
"1992","Troy (AL)","10","1","0","0.90909","295","122","173"
"1993","Troy (AL)","12","1","1","0.89286","505","227","278"
"1994","Troy (AL)","8","4","0","0.66667","430","326","104"
"1995","Troy (AL)","11","1","0","0.91667","446","174","272"
"1996","Troy (AL)","12","2","0","0.85714","434","252","182"
"1997","Troy (AL)","5","6","0","0.45455","217","157","60"
"1998","Troy (AL)","8","4","0","0.66667","235","203","32"
"1999","Troy (AL)","11","2","0","0.84615","362","224","138"
"2000","Troy (AL)","10","2","0","0.83333","330","193","137"
"2001","Troy (AL)","7","4","0","0.63636","246","269","-23"
"2002","Troy (AL)","4","8","0","0.33333","218","252","-34"
"2003","Troy (AL)","6","6","0","0.50000","185","272","-87"
"2004","Troy (AL)","7","5","0","0.58333","286","200","86"
"2005","Troy (AL)","4","7","0","0.36364","175","255","-80"
"2006","Troy (AL)","8","5","0","0.61538","296","289","7"
"2007","Troy (AL)","8","4","0","0.66667","408","295","113"
"2008","Troy (AL)","8","5","0","0.61538","426","277","149"
"2009","Troy (AL)","9","4","0","0.69231","438","387","51"
"2010","Troy (AL)","8","5","0","0.61538","443","393","50"
"2011","Troy (AL)","3","9","0","0.25000","269","404","-135"
"2012","Troy (AL)","5","7","0","0.41667","367","366","1"
"2013","Troy (AL)","6","6","0","0.50000","409","431","-22"
"1894","Tulane (LA)","0","4","0","0.00000","14","50","-36"
"1893","Tulane (LA)","1","2","0","0.33333","38","24","14"
"1895","Tulane (LA)","3","2","0","0.60000","66","28","38"
"1896","Tulane (LA)","3","2","0","0.60000","74","18","56"
"1898","Tulane (LA)","1","1","0","0.50000","14","46","-32"
"1899","Tulane (LA)","0","6","1","0.07143","0","141","-141"
"1900","Tulane (LA)","5","0","0","1.00000","105","0","105"
"1901","Tulane (LA)","4","2","0","0.66667","109","19","90"
"1902","Tulane (LA)","1","4","2","0.28571","47","67","-20"
"1903","Tulane (LA)","2","2","1","0.50000","64","56","8"
"1904","Tulane (LA)","5","2","0","0.71429","58","24","34"
"1905","Tulane (LA)","0","1","0","0.00000","0","5","-5"
"1906","Tulane (LA)","0","4","1","0.10000","0","92","-92"
"1907","Tulane (LA)","3","2","0","0.60000","71","44","27"
"1908","Tulane (LA)","7","1","0","0.87500","103","23","80"
"1902","Virginia Tech","3","2","1","0.58333","89","23","66"
"1904","North Carolina","5","2","2","0.66667","170","34","136"
"1905","Washington & Lee (VA)","7","2","0","0.77778","145","36","109"
"1906","Washington & Lee (VA)","4","1","1","0.75000","59","14","45"
"1907","Washington & Lee (VA)","3","2","1","0.58333","44","17","27"
"1908","Washington & Lee (VA)","5","1","1","0.78571","144","71","73"
"1909","Tulane (LA)","4","3","2","0.55556","40","50","-10"
"1923","New Mexico St.","9","0","0","1.00000","218","17","201"
"1924","New Mexico St.","7","3","0","0.70000","241","30","211"
"1925","New Mexico St.","5","3","1","0.61111","151","75","76"
"1908","Central Missouri St.","5","3","1","0.61111","161","109","52"
"1909","Central Missouri St.","2","4","2","0.37500","44","32","12"
"1910","Tulane (LA)","0","7","0","0.00000","6","126","-120"
"1911","Tulane (LA)","5","3","1","0.61111","106","46","60"
"1912","Tulane (LA)","5","3","0","0.62500","216","99","117"
"1918","New York (NY)","0","4","0","0.00000","2","38","-36"
"1913","Tulane (LA)","3","5","0","0.37500","59","159","-100"
"1899","Hamilton (NY)","8","2","1","0.77273","282","67","215"
"1900","Syracuse (NY)","7","2","1","0.75000","208","60","148"
"1901","Syracuse (NY)","7","1","0","0.87500","185","27","158"
"1902","Syracuse (NY)","6","2","1","0.72222","172","93","79"
"1903","Hamilton (NY)","6","3","0","0.66667","136","91","45"
"1904","Ohio St.","6","5","0","0.54545","219","123","96"
"1905","Ohio St.","8","2","2","0.75000","197","63","134"
"1908","Colgate (NY)","4","3","0","0.57143","78","25","53"
"1909","Kentucky","9","1","0","0.90000","261","29","232"
"1910","Kentucky","7","2","0","0.77778","140","29","111"
"1911","Miami (OH)","2","4","2","0.37500","57","45","12"
"1912","Kentucky","7","2","0","0.77778","250","41","209"
"1913","West Virginia","3","4","2","0.44444","109","137","-28"
"1914","Tulane (LA)","3","3","1","0.50000","145","147","-2"
"1915","Tulane (LA)","4","4","0","0.50000","118","78","40"
"1916","Tulane (LA)","4","3","1","0.56250","126","149","-23"
"1917","Tulane (LA)","5","3","0","0.62500","159","105","54"
"1918","Tulane (LA)","4","1","1","0.75000","133","16","117"
"1919","Tulane (LA)","6","2","1","0.72222","224","55","169"
"1920","Tulane (LA)","6","2","1","0.72222","181","28","153"
"1922","Tulane (LA)","4","4","0","0.50000","136","100","36"
"1923","Tulane (LA)","6","3","1","0.65000","117","89","28"
"1924","Tulane (LA)","8","1","0","0.88889","201","59","142"
"1925","Tulane (LA)","9","0","1","0.95000","246","23","223"
"1926","Tulane (LA)","3","5","1","0.38889","71","60","11"
"1927","Loyola (LA)","6","2","2","0.70000","130","41","89"
"1928","Loyola (LA)","7","3","0","0.70000","220","85","135"
"1929","Loyola (LA)","4","5","2","0.45455","150","129","21"
"1930","Loyola (LA)","9","1","0","0.90000","217","52","165"
"1931","Loyola (LA)","5","4","0","0.55556","154","91","63"
"1932","Loyola (LA)","6","4","1","0.59091","134","77","57"
"1933","Chicago (IL)","3","3","2","0.50000","118","56","62"
"1934","Chicago (IL)","4","4","0","0.50000","113","106","7"
"1935","Chicago (IL)","4","4","0","0.50000","102","110","-8"
"1936","Chicago (IL)","2","5","1","0.31250","68","166","-98"
"1937","Chicago (IL)","1","6","0","0.14286","45","143","-98"
"1938","Chicago (IL)","1","6","1","0.18750","75","241","-166"
"1939","Chicago (IL)","2","6","0","0.25000","37","308","-271"
"1940","Stanford (CA)","10","0","0","1.00000","196","85","111"
"1941","Stanford (CA)","6","3","0","0.66667","160","95","65"
"1942","Maryland","7","2","0","0.77778","198","124","74"
"1943","Pittsburgh (PA)","3","5","0","0.37500","114","180","-66"
"1944","Pittsburgh (PA)","4","5","0","0.44444","147","293","-146"
"1945","Pittsburgh (PA)","3","7","0","0.30000","87","141","-54"
"1946","Maryland","3","6","0","0.33333","136","193","-57"
"1965","Hawaii","1","8","1","0.15000","85","227","-142"
"1912","Stevens Tech (NJ)","1","9","0","0.10000","56","205","-149"
"1913","Stevens Tech (NJ)","2","6","0","0.25000","49","149","-100"
"1914","Stevens Tech (NJ)","1","7","1","0.16667","43","268","-225"
"1920","North Carolina","2","6","0","0.25000","16","91","-75"
"1921","Tulane (LA)","4","6","0","0.40000","84","97","-13"
"1919","Montana","2","3","2","0.42857","80","121","-41"
"1920","Montana","4","3","0","0.57143","227","92","135"
"1921","Montana","3","3","1","0.50000","66","90","-24"
"1925","Mississippi St.","3","4","1","0.43750","101","60","41"
"1926","Mississippi St.","5","4","0","0.55556","134","98","36"
"1927","Tulane (LA)","2","5","1","0.31250","56","120","-64"
"1928","Tulane (LA)","6","3","1","0.65000","264","76","188"
"1929","Tulane (LA)","9","0","0","1.00000","279","45","234"
"1930","Tulane (LA)","8","1","0","0.88889","263","30","233"
"1931","Tulane (LA)","11","1","0","0.91667","350","56","294"
"1932","Minnesota","5","3","0","0.62500","86","42","44"
"1933","Minnesota","4","0","4","0.75000","64","32","32"
"1934","Minnesota","8","0","0","1.00000","270","38","232"
"1935","Minnesota","8","0","0","1.00000","194","46","148"
"1936","Minnesota","7","1","0","0.87500","203","32","171"
"1937","Minnesota","6","2","0","0.75000","184","50","134"
"1938","Minnesota","6","2","0","0.75000","97","38","59"
"1939","Minnesota","3","4","1","0.43750","154","82","72"
"1940","Minnesota","8","0","0","1.00000","154","71","83"
"1941","Minnesota","8","0","0","1.00000","186","38","148"
"1945","Minnesota","4","5","0","0.44444","177","155","22"
"1946","Minnesota","5","4","0","0.55556","130","114","16"
"1947","Minnesota","6","3","0","0.66667","174","127","47"
"1948","Minnesota","7","2","0","0.77778","203","94","109"
"1949","Minnesota","7","2","0","0.77778","231","80","151"
"1950","Minnesota","1","7","1","0.16667","79","196","-117"
"1932","Tulane (LA)","6","2","1","0.72222","131","95","36"
"1933","Tulane (LA)","6","3","1","0.65000","160","68","92"
"1934","Tulane (LA)","10","1","0","0.90909","215","83","132"
"1935","Tulane (LA)","6","4","0","0.60000","156","123","33"
"1936","Oklahoma St.","1","9","0","0.10000","43","205","-162"
"1937","Oklahoma St.","4","6","0","0.40000","101","141","-40"
"1938","Oklahoma St.","2","8","0","0.20000","75","178","-103"
"1936","Tulane (LA)","6","3","1","0.65000","163","117","46"
"1937","Tulane (LA)","5","4","1","0.55000","164","69","95"
"1938","Tulane (LA)","7","2","1","0.75000","211","53","158"
"1939","Tulane (LA)","8","1","1","0.85000","194","60","134"
"1940","Tulane (LA)","5","5","0","0.50000","144","126","18"
"1941","Tulane (LA)","5","4","0","0.55556","220","95","125"
"1952","Pittsburgh (PA)","6","3","0","0.66667","187","156","31"
"1953","Pittsburgh (PA)","3","5","1","0.38889","143","138","5"
"1954","Pittsburgh (PA)","0","3","0","0.00000","14","106","-92"
"1942","Tulane (LA)","4","5","0","0.44444","121","154","-33"
"1943","Tulane (LA)","3","3","0","0.50000","92","94","-2"
"1944","Tulane (LA)","4","3","0","0.57143","113","125","-12"
"1945","Tulane (LA)","2","6","1","0.27778","93","212","-119"
"1941","Tulsa (OK)","8","2","0","0.80000","194","65","129"
"1942","Tulsa (OK)","10","1","0","0.90909","434","46","388"
"1943","Tulsa (OK)","6","1","1","0.81250","269","52","217"
"1944","Tulsa (OK)","8","2","0","0.80000","380","128","252"
"1945","Tulsa (OK)","8","3","0","0.72727","275","84","191"
"1946","Tulane (LA)","3","7","0","0.30000","179","209","-30"
"1947","Tulane (LA)","2","5","2","0.33333","94","192","-98"
"1948","Tulane (LA)","9","1","0","0.90000","207","60","147"
"1949","Tulane (LA)","7","2","1","0.75000","251","142","109"
"1950","Tulane (LA)","6","2","1","0.72222","260","97","163"
"1951","Tulane (LA)","4","6","0","0.40000","143","172","-29"
"1936","North Carolina","8","2","0","0.80000","190","100","90"
"1937","North Carolina","7","1","1","0.83333","173","39","134"
"1938","North Carolina","6","2","1","0.72222","117","37","80"
"1939","North Carolina","8","1","1","0.85000","228","52","176"
"1940","North Carolina","6","4","0","0.60000","159","98","61"
"1941","North Carolina","3","7","0","0.30000","130","172","-42"
"1946","Florida","0","9","0","0.00000","104","264","-160"
"1947","Florida","4","5","1","0.45000","125","156","-31"
"1948","Florida","5","5","0","0.50000","213","206","7"
"1949","Florida","4","5","1","0.45000","180","218","-38"
"1952","Tulane (LA)","5","5","0","0.50000","188","146","42"
"1953","Tulane (LA)","1","8","1","0.15000","129","228","-99"
"1954","Tulane (LA)","1","6","3","0.25000","46","144","-98"
"1955","Tulane (LA)","5","4","1","0.55000","163","136","27"
"1956","Tulane (LA)","6","4","0","0.60000","124","123","1"
"1957","Tulane (LA)","2","8","0","0.20000","91","195","-104"
"1958","Tulane (LA)","3","7","0","0.30000","105","189","-84"
"1959","Tulane (LA)","3","6","1","0.35000","94","176","-82"
"1960","Tulane (LA)","3","6","1","0.35000","132","140","-8"
"1961","Tulane (LA)","2","8","0","0.20000","60","225","-165"
"1947","Missouri St.","7","2","1","0.75000","130","66","64"
"1948","Missouri St.","9","2","0","0.81818","231","66","165"
"1962","Tulane (LA)","0","10","0","0.00000","76","293","-217"
"1963","Tulane (LA)","1","8","1","0.15000","43","191","-148"
"1964","Tulane (LA)","3","7","0","0.30000","79","147","-68"
"1965","Tulane (LA)","2","8","0","0.20000","71","268","-197"
"1966","Tulane (LA)","5","4","1","0.55000","153","182","-29"
"1967","Tulane (LA)","3","7","0","0.30000","164","223","-59"
"1968","Tulane (LA)","2","8","0","0.20000","163","300","-137"
"1969","Tulane (LA)","3","7","0","0.30000","152","235","-83"
"1970","Tulane (LA)","8","4","0","0.66667","196","160","36"
"1971","Texas Christian","3","3","1","0.50000","159","203","-44"
"1963","Arkansas St.","2","6","0","0.25000","159","174","-15"
"1964","Arkansas St.","7","0","2","0.88889","148","61","87"
"1965","Arkansas St.","6","3","0","0.66667","157","107","50"
"1966","Arkansas St.","7","2","0","0.77778","222","109","113"
"1967","Arkansas St.","4","5","0","0.44444","126","116","10"
"1968","Arkansas St.","7","3","1","0.68182","245","172","73"
"1969","Arkansas St.","8","1","1","0.85000","262","140","122"
"1970","Arkansas St.","11","0","0","1.00000","360","134","226"
"1971","Tulane (LA)","3","8","0","0.27273","152","215","-63"
"1972","Tulane (LA)","6","5","0","0.54545","212","165","47"
"1973","Tulane (LA)","9","3","0","0.75000","228","194","34"
"1974","Tulane (LA)","5","6","0","0.45455","176","214","-38"
"1975","Tulane (LA)","4","7","0","0.36364","123","192","-69"
"1976","Tulane (LA)","2","9","0","0.18182","149","228","-79"
"1977","Tulane (LA)","3","8","0","0.27273","181","289","-108"
"1978","Tulane (LA)","4","7","0","0.36364","183","211","-28"
"1979","Tulane (LA)","9","3","0","0.75000","320","179","141"
"1980","Arizona","5","6","0","0.45455","215","275","-60"
"1981","Arizona","6","5","0","0.54545","253","205","48"
"1982","Arizona","6","4","1","0.59091","311","219","92"
"1983","Arizona","7","3","1","0.68182","343","188","155"
"1984","Arizona","7","4","0","0.63636","272","192","80"
"1985","Arizona","8","3","1","0.70833","252","146","106"
"1986","Arizona","9","3","0","0.75000","352","204","148"
"1987","Southern California","8","4","0","0.66667","321","229","92"
"1988","Southern California","10","2","0","0.83333","370","184","186"
"1989","Southern California","9","2","1","0.79167","336","132","204"
"1990","Southern California","8","4","1","0.65385","348","274","74"
"1991","Southern California","3","8","0","0.27273","229","276","-47"
"1992","Southern California","6","5","1","0.54167","264","249","15"
"1994","Missouri","3","8","1","0.29167","208","325","-117"
"1995","Missouri","3","8","0","0.27273","186","311","-125"
"1996","Missouri","5","6","0","0.45455","278","376","-98"
"1997","Missouri","7","5","0","0.58333","392","367","25"
"1998","Missouri","8","4","0","0.66667","334","236","98"
"1999","Missouri","4","7","0","0.36364","224","371","-147"
"2000","Missouri","3","8","0","0.27273","255","348","-93"
"1967","Kansas St.","1","9","0","0.10000","90","263","-173"
"1968","Kansas St.","4","6","0","0.40000","194","247","-53"
"1969","Kansas St.","5","5","0","0.50000","316","233","83"
"1970","Kansas St.","6","5","0","0.54545","190","218","-28"
"1971","Kansas St.","5","6","0","0.45455","219","296","-77"
"1972","Kansas St.","3","8","0","0.27273","169","407","-238"
"1973","Kansas St.","5","6","0","0.45455","176","260","-84"
"1974","Kansas St.","4","7","0","0.36364","193","283","-90"
"1975","Louisville (KY)","2","9","0","0.18182","148","316","-168"
"1976","Louisville (KY)","5","6","0","0.45455","177","234","-57"
"1977","Louisville (KY)","7","4","1","0.62500","291","194","97"
"1978","Louisville (KY)","7","4","0","0.63636","319","202","117"
"1979","Louisville (KY)","4","6","1","0.40909","167","202","-35"
"1980","Tulane (LA)","7","5","0","0.58333","279","243","36"
"1981","Tulane (LA)","6","5","0","0.54545","213","144","69"
"1982","Tulane (LA)","4","7","0","0.36364","201","271","-70"
"1983","Tulane (LA)","2","9","0","0.18182","192","241","-49"
"1984","Tulane (LA)","3","8","0","0.27273","177","275","-98"
"1983","Appalachian St. (NC)","6","5","0","0.54545","212","265","-53"
"1985","Tulane (LA)","1","10","0","0.09091","166","334","-168"
"1986","Tulane (LA)","4","7","0","0.36364","265","334","-69"
"1987","Tulane (LA)","6","6","0","0.50000","370","376","-6"
"1988","North Carolina","1","10","0","0.09091","217","391","-174"
"1989","North Carolina","1","10","0","0.09091","138","297","-159"
"1990","North Carolina","6","4","1","0.59091","227","186","41"
"1991","North Carolina","7","4","0","0.63636","282","199","83"
"1992","North Carolina","9","3","0","0.75000","289","233","56"
"1993","North Carolina","10","3","0","0.76923","431","253","178"
"1994","North Carolina","8","4","0","0.66667","374","267","107"
"1995","North Carolina","7","5","0","0.58333","284","220","64"
"1996","North Carolina","10","2","0","0.83333","357","123","234"
"1997","North Carolina","10","1","0","0.90909","306","143","163"
"1998","Texas","9","3","0","0.75000","437","337","100"
"1999","Texas","9","5","0","0.64286","450","295","155"
"2000","Texas","9","3","0","0.75000","455","232","223"
"2001","Texas","11","2","0","0.84615","517","207","310"
"2002","Texas","11","2","0","0.84615","439","212","227"
"2003","Texas","10","3","0","0.76923","533","280","253"
"2004","Texas","11","1","0","0.91667","423","215","208"
"2005","Texas","13","0","0","1.00000","652","213","439"
"2006","Texas","10","3","0","0.76923","467","238","229"
"2007","Texas","10","3","0","0.76923","484","329","155"
"2008","Texas","12","1","0","0.92308","551","244","307"
"2009","Texas","13","1","0","0.92857","550","234","316"
"2010","Texas","5","7","0","0.41667","285","284","1"
"2011","Texas","8","5","0","0.61538","365","289","76"
"2012","Texas","9","4","0","0.69231","464","380","84"
"2013","Texas","8","5","0","0.61538","381","336","45"
"1988","Tulane (LA)","5","6","0","0.45455","251","334","-83"
"1989","Tulane (LA)","4","8","0","0.33333","247","337","-90"
"1990","Tulane (LA)","4","7","0","0.36364","237","253","-16"
"1991","Tulane (LA)","1","10","0","0.09091","146","384","-238"
"1985","Maine","6","5","0","0.54545","268","211","57"
"1986","Maine","7","4","0","0.63636","297","213","84"
"1987","Dartmouth (NH)","2","8","0","0.20000","110","302","-192"
"1988","Dartmouth (NH)","5","5","0","0.50000","209","198","11"
"1989","Dartmouth (NH)","5","5","0","0.50000","170","178","-8"
"1990","Dartmouth (NH)","7","2","1","0.75000","211","121","90"
"1991","Dartmouth (NH)","7","2","1","0.75000","283","209","74"
"1992","Tulane (LA)","2","9","0","0.18182","146","349","-203"
"1993","Tulane (LA)","4","8","0","0.33333","154","355","-201"
"1994","Tulane (LA)","1","10","0","0.09091","135","358","-223"
"1995","Tulane (LA)","2","9","0","0.18182","187","303","-116"
"1996","Tulane (LA)","2","9","0","0.18182","213","268","-55"
"2002","Stanford (CA)","2","9","0","0.18182","225","377","-152"
"2003","Stanford (CA)","4","7","0","0.36364","186","324","-138"
"2004","Stanford (CA)","4","7","0","0.36364","242","233","9"
"2005","Dartmouth (NH)","2","8","0","0.20000","126","260","-134"
"2006","Dartmouth (NH)","2","8","0","0.20000","147","254","-107"
"2007","Dartmouth (NH)","3","7","0","0.30000","271","347","-76"
"2008","Dartmouth (NH)","0","10","0","0.00000","129","343","-214"
"2009","Dartmouth (NH)","2","8","0","0.20000","161","282","-121"
"2010","Dartmouth (NH)","6","4","0","0.60000","264","212","52"
"2011","Dartmouth (NH)","5","5","0","0.50000","220","219","1"
"2012","Dartmouth (NH)","6","4","0","0.60000","251","210","41"
"2013","Dartmouth (NH)","6","4","0","0.60000","286","195","91"
"1997","Tulane (LA)","7","4","0","0.63636","375","225","150"
"1998","Tulane (LA)","11","0","0","1.00000","499","268","231"
"1999","Clemson (SC)","6","6","0","0.50000","322","253","69"
"2000","Clemson (SC)","9","3","0","0.75000","416","253","163"
"2001","Clemson (SC)","7","5","0","0.58333","369","339","30"
"2002","Clemson (SC)","7","6","0","0.53846","330","349","-19"
"2003","Clemson (SC)","9","4","0","0.69231","365","250","115"
"2004","Clemson (SC)","6","5","0","0.54545","236","229","7"
"2005","Clemson (SC)","8","4","0","0.66667","316","211","105"
"2006","Clemson (SC)","8","5","0","0.61538","425","210","215"
"2007","Clemson (SC)","9","4","0","0.69231","430","243","187"
"2008","Clemson (SC)","3","3","0","0.50000","160","92","68"
"1998","Tulane (LA)","1","0","0","1.00000","41","27","14"
"1999","Tulane (LA)","3","8","0","0.27273","279","399","-120"
"2000","Tulane (LA)","6","5","0","0.54545","329","346","-17"
"2001","Tulane (LA)","3","9","0","0.25000","344","495","-151"
"2002","Tulane (LA)","8","5","0","0.61538","361","282","79"
"2003","Tulane (LA)","5","7","0","0.41667","337","424","-87"
"2004","Tulane (LA)","5","6","0","0.45455","300","361","-61"
"2005","Tulane (LA)","2","9","0","0.18182","234","348","-114"
"2006","Tulane (LA)","4","8","0","0.33333","224","400","-176"
"1979","Pacific (CA)","3","7","0","0.30000","162","193","-31"
"1980","Pacific (CA)","4","8","0","0.33333","211","330","-119"
"1981","Pacific (CA)","5","6","0","0.45455","170","253","-83"
"1982","Pacific (CA)","2","9","0","0.18182","200","330","-130"
"1996","UCLA","5","6","0","0.45455","330","318","12"
"1997","UCLA","10","2","0","0.83333","477","247","230"
"1998","UCLA","10","2","0","0.83333","476","340","136"
"1999","UCLA","5","6","0","0.45455","230","311","-81"
"2000","UCLA","6","6","0","0.50000","353","368","-15"
"2001","UCLA","7","4","0","0.63636","317","225","92"
"2002","UCLA","7","5","0","0.58333","360","313","47"
"2007","Tulane (LA)","4","8","0","0.33333","293","375","-82"
"2008","Tulane (LA)","2","10","0","0.16667","200","414","-214"
"2009","Tulane (LA)","3","9","0","0.25000","193","440","-247"
"2010","Tulane (LA)","4","8","0","0.33333","299","446","-147"
"2011","Tulane (LA)","2","5","0","0.28571","173","248","-75"
"2011","Tulane (LA)","0","6","0","0.00000","101","239","-138"
"2012","Tulane (LA)","2","10","0","0.16667","257","461","-204"
"2013","Tulane (LA)","7","6","0","0.53846","322","278","44"
"1895","Tulsa (OK)","1","0","0","1.00000","1","0","1"
"1896","Tulsa (OK)","2","1","0","0.66667","2","6","-4"
"1897","Tulsa (OK)","2","1","0","0.66667","2","1","1"
"1898","Tulsa (OK)","1","0","0","1.00000","1","0","1"
"1899","Tulsa (OK)","0","1","1","0.25000","0","11","-11"
"1872","Stevens Tech (NJ)","0","1","0","0.00000","0","6","-6"
"1873","New York (NY)","3","3","0","0.50000","15","13","2"
"1874","Stevens Tech (NJ)","2","3","0","0.40000","10","20","-10"
"1875","Stevens Tech (NJ)","4","4","0","0.50000","21","20","1"
"1876","New York (NY)","2","3","1","0.41667","16","19","-3"
"1877","Stevens Tech (NJ)","3","1","2","0.66667","9","14","-5"
"1878","Stevens Tech (NJ)","3","3","3","0.50000","3","9","-6"
"1879","Stevens Tech (NJ)","2","3","5","0.45000","8","14","-6"
"1880","Stevens Tech (NJ)","1","5","0","0.16667","3","16","-13"
"1881","Stevens Tech (NJ)","3","8","3","0.32143","16","29","-13"
"1882","Lawrence (WI)","7","8","1","0.46875","17","25","-8"
"1883","Stevens Tech (NJ)","7","6","1","0.53571","187","128","59"
"1884","Fordham (NY)","9","10","0","0.47368","221","261","-40"
"1885","Georgetown (DC)","5","17","1","0.23913","359","612","-253"
"1886","New York (NY)","9","15","2","0.38462","180","565","-385"
"1887","Fordham (NY)","8","12","1","0.40476","157","445","-288"
"1888","Amherst (MA)","6","17","3","0.28846","192","791","-599"
"1889","New York (NY)","8","21","4","0.30303","278","647","-369"
"1890","New York (NY)","25","14","2","0.63415","727","538","189"
"1891","Delaware","32","30","7","0.51449","966","971","-5"
"1892","Beloit (WI)","29","31","3","0.48413","726","797","-71"
"1893","Marquette (WI)","39","34","3","0.53289","1091","885","206"
"1894","Manhattan (NY)","32","29","7","0.52206","853","692","161"
"1895","Delaware","44","35","6","0.55294","889","813","76"
"1896","Manhattan (NY)","51","49","6","0.50943","949","1164","-215"
"1897","Stevens Tech (NJ)","37","50","4","0.42857","661","1048","-387"
"1898","Manhattan (NY)","37","43","9","0.46629","781","1050","-269"
"1899","Manhattan (NY)","34","40","6","0.46250","594","1063","-469"
"1900","Manhattan (NY)","43","47","11","0.48020","991","1049","-58"
"1901","Ferris St. (MI)","51","44","7","0.53431","906","852","54"
"1902","Indiana St.","56","48","5","0.53670","1053","927","126"
"1903","Manhattan (NY)","30","49","7","0.38953","762","1319","-557"
"1904","Saint Francis (NY)","44","53","9","0.45755","787","1363","-576"
"1905","Bluffton (OH)","38","59","5","0.39706","850","1433","-583"
"1906","Ferris St. (MI)","32","43","12","0.43678","677","854","-177"
"1907","Ferris St. (MI)","32","48","10","0.41111","722","1208","-486"
"1908","Western Illinois","36","45","10","0.45055","760","1069","-309"
"1909","Delaware Valley (PA)","27","52","2","0.34568","682","1287","-605"
"1910","East Stroudsburg (PA)","23","31","3","0.42982","583","738","-155"
"1911","Western Illinois","32","44","7","0.42771","661","902","-241"
"1912","Indiana (PA)","36","56","7","0.39899","1134","1463","-329"
"1913","Saint Francis (NY)","52","67","8","0.44094","1672","2360","-688"
"1914","Delaware Valley (PA)","41","50","6","0.45361","1217","1585","-368"
"1915","Western Illinois","34","35","11","0.49375","932","1217","-285"
"1916","Morgan St. (MD)","44","43","7","0.50532","1493","1270","223"
"1917","Morgan St. (MD)","21","21","2","0.50000","408","883","-475"
"1918","Oklahoma Baptist University","7","16","2","0.32000","258","358","-100"
"1919","Western Illinois","53","41","8","0.55882","1478","1056","422"
"1920","Virginia Union","28","39","2","0.42029","506","893","-387"
"1921","Cooper Union (NY)","19","34","3","0.36607","441","1112","-671"
"1922","Cooper Union (NY)","27","34","6","0.44776","703","832","-129"
"1923","Cooper Union (NY)","31","45","2","0.41026","718","1112","-394"
"1924","East Stroudsburg (PA)","34","40","6","0.46250","946","1175","-229"
"1925","Saint Anselm (NH)","32","28","10","0.52857","847","802","45"
"1926","Saint Anselm (NH)","22","30","4","0.42857","515","702","-187"
"1927","Bethune-Cookman (FL)","20","29","8","0.42105","674","783","-109"
"1928","Saint Anselm (NH)","28","24","7","0.53390","564","1095","-531"
"1929","Saint Anselm (NH)","25","32","5","0.44355","616","843","-227"
"1930","Saint Anselm (NH)","31","27","10","0.52941","643","549","94"
"1931","Campbell (NC)","21","17","4","0.54762","465","428","37"
"1932","Campbell (NC)","7","30","3","0.21250","254","760","-506"
"1933","Campbell (NC)","11","13","3","0.46296","262","324","-62"
"1934","Bowie St. (MD)","4","7","2","0.38462","116","94","22"
"1935","Florida Southern","7","12","1","0.37500","170","162","8"
"1936","Bowie St. (MD)","5","2","1","0.68750","154","97","57"
"1937","Bowie St. (MD)","6","3","0","0.66667","98","87","11"
"1938","West Alabama","7","5","0","0.58333","151","88","63"
"1939","Elizabeth City St. (NC)","7","13","0","0.35000","150","307","-157"
"1940","Elizabeth City St. (NC)","6","5","4","0.53333","128","67","61"
"1941","Arkansas-Pine Bluff","3","9","5","0.32353","178","223","-45"
"1942","Brevard College (NC)","10","6","2","0.61111","225","189","36"
"1943","Clark Atlanta (GA)","6","8","0","0.42857","127","206","-79"
"1944","Abilene Christian (TX)","9","11","1","0.45238","158","255","-97"
"1945","Benedict (SC)","10","15","2","0.40741","299","296","3"
"1946","Elizabeth City St. (NC)","7","20","3","0.28333","144","540","-396"
"1947","Clark Atlanta (GA)","3","6","2","0.36364","49","230","-181"
"1948","Virginia-Lynchburg","4","6","1","0.40909","77","302","-225"
"1949","Virginia-Lynchburg","0","3","1","0.12500","7","70","-63"
"1950","Virginia-Lynchburg","2","3","0","0.40000","53","98","-45"
"1951","Lane (TN)","8","6","0","0.57143","295","234","61"
"1952","Lane (TN)","9","5","1","0.63333","220","206","14"
"1953","Lane (TN)","1","7","0","0.12500","58","215","-157"
"1954","Lane (TN)","2","6","0","0.25000","105","135","-30"
"1955","Lane (TN)","2","4","0","0.33333","83","129","-46"
"1957","Louisiana College","2","7","0","0.22222","106","179","-73"
"1959","Azusa Pacific (CA)","2","3","0","0.40000","117","90","27"
"1960","Azusa Pacific (CA)","4","3","1","0.56250","103","76","27"
"1961","Azusa Pacific (CA)","3","3","0","0.50000","123","147","-24"
"1963","San Francisco (CA)","2","5","0","0.28571","58","98","-40"
"1964","New York (NY)","0","2","0","0.00000","20","48","-28"
"1965","Adelphi (NY)","4","8","0","0.33333","198","216","-18"
"1966","Fairfield (CT)","18","22","2","0.45238","545","652","-107"
"1967","La Salle (PA)","25","31","0","0.44643","846","1080","-234"
"1968","Centenary (LA)","17","42","2","0.29508","726","1393","-667"
"1969","Bluffton (OH)","33","43","0","0.43421","1058","1548","-490"
"1970","Saint John's (NY)","35","54","1","0.39444","1379","1783","-404"
"1971","Bluffton (OH)","43","45","1","0.48876","1360","1384","-24"
"1972","Marquette (WI)","39","44","2","0.47059","1217","1351","-134"
"1973","Brooklyn (NY)","30","52","1","0.36747","1007","1611","-604"
"1974","Marquette (WI)","33","36","3","0.47917","959","1169","-210"
"1975","Marquette (WI)","31","22","4","0.57895","1042","932","110"
"1976","Bluffton (OH)","23","33","1","0.41228","862","1186","-324"
"1977","Manhattan (NY)","14","28","1","0.33721","568","923","-355"
"1978","Fairfield (CT)","5","7","1","0.42308","194","203","-9"
"1979","Fairfield (CT)","7","8","0","0.46667","247","260","-13"
"1980","Westfield St. (MA)","6","5","4","0.53333","184","196","-12"
"1981","San Francisco (CA)","17","14","0","0.54839","567","498","69"
"1982","Manhattan (NY)","18","16","0","0.52941","580","644","-64"
"1983","SUNY-Stony Brook (NY)","15","11","0","0.57692","474","453","21"
"1984","Stonehill (MA)","7","12","0","0.36842","231","439","-208"
"1985","Manhattan (NY)","10","10","0","0.50000","313","316","-3"
"1986","Marquette (WI)","13","17","0","0.43333","497","564","-67"
"1987","Marquette (WI)","10","17","0","0.37037","389","487","-98"
"1988","Marquette (WI)","1","5","0","0.16667","80","125","-45"
"1989","Marquette (WI)","4","4","0","0.50000","209","151","58"
"1990","Marquette (WI)","1","7","0","0.12500","80","180","-100"
"1991","Marquette (WI)","1","5","0","0.16667","106","182","-76"
"1992","Marquette (WI)","2","5","0","0.28571","81","129","-48"
"1993","Marquette (WI)","7","1","0","0.87500","212","126","86"
"1994","Marquette (WI)","1","6","0","0.14286","125","184","-59"
"1995","Marquette (WI)","3","4","0","0.42857","141","191","-50"
"1996","Marquette (WI)","3","5","0","0.37500","139","182","-43"
"1998","Madison College (WI)","2","15","0","0.11765","221","613","-392"
"1999","Marquette (WI)","0","7","0","0.00000","110","298","-188"
"2000","Marquette (WI)","1","5","0","0.16667","60","96","-36"
"2001","Marquette (WI)","2","6","0","0.25000","144","179","-35"
"2002","Marquette (WI)","3","4","0","0.42857","127","208","-81"
"2003","Marquette (WI)","1","6","0","0.14286","71","151","-80"
"2004","Marquette (WI)","0","6","0","0.00000","53","238","-185"
"2005","Marquette (WI)","2","5","0","0.28571","92","226","-134"
"2006","Marquette (WI)","1","6","0","0.14286","62","206","-144"
"2007","Marquette (WI)","2","5","0","0.28571","140","215","-75"
"2008","Marquette (WI)","0","7","0","0.00000","61","304","-243"
"2009","Marquette (WI)","0","1","0","0.00000","0","22","-22"
"1912","Tulsa (OK)","1","4","0","0.20000","75","141","-66"
"1913","Tulsa (OK)","5","2","0","0.71429","271","59","212"
"1908","Tulsa (OK)","2","3","0","0.40000","80","43","37"
"1914","Tulsa (OK)","6","2","0","0.75000","261","48","213"
"1915","Tulsa (OK)","6","1","1","0.81250","257","33","224"
"1916","Tulsa (OK)","10","0","0","1.00000","566","40","526"
"1917","Tulsa (OK)","0","8","1","0.05556","61","221","-160"
"1918","Tulsa (OK)","1","2","0","0.33333","9","56","-47"
"1919","Tulsa (OK)","8","0","1","0.94444","591","27","564"
"1920","Tulsa (OK)","10","0","1","0.95455","621","21","600"
"1921","Tulsa (OK)","6","3","0","0.66667","257","95","162"
"1922","Arkansas","4","5","0","0.44444","143","136","7"
"1923","Arkansas","7","2","1","0.75000","178","40","138"
"1924","Arkansas","7","2","1","0.75000","227","69","158"
"1925","Arkansas","4","4","1","0.50000","95","62","33"
"1926","Arkansas","5","5","0","0.50000","179","88","91"
"1927","Arkansas","8","1","0","0.88889","218","76","142"
"1928","Arkansas","7","2","0","0.77778","251","63","188"
"1929","Texas Christian","9","0","1","0.95000","249","33","216"
"1930","Texas Christian","9","2","1","0.79167","298","49","249"
"1931","Texas Christian","8","2","1","0.77273","119","41","78"
"1932","Texas Christian","10","0","1","0.95455","283","23","260"
"1933","Texas Christian","9","2","1","0.79167","208","49","159"
"1934","Ohio St.","7","1","0","0.87500","267","34","233"
"1935","Ohio St.","7","1","0","0.87500","237","57","180"
"1936","Ohio St.","5","3","0","0.62500","160","27","133"
"1937","Ohio St.","6","2","0","0.75000","125","23","102"
"1938","Ohio St.","4","3","1","0.56250","119","65","54"
"1939","Ohio St.","6","2","0","0.75000","189","64","125"
"1940","Ohio St.","4","4","0","0.50000","99","113","-14"
"1941","Idaho","4","5","0","0.44444","123","135","-12"
"1942","Idaho","3","7","0","0.30000","96","209","-113"
"1922","Tulsa (OK)","8","1","0","0.88889","156","60","96"
"1923","Tulsa (OK)","2","5","1","0.31250","107","165","-58"
"1924","Tulsa (OK)","1","7","1","0.16667","24","177","-153"
"1919","Southern California","4","1","0","0.80000","87","21","66"
"1920","Southern California","6","0","0","1.00000","170","21","149"
"1921","Southern California","10","1","0","0.90909","362","52","310"
"1922","Southern California","10","1","0","0.90909","236","31","205"
"1923","Southern California","6","2","0","0.75000","173","62","111"
"1924","Southern California","9","2","0","0.81818","269","44","225"
"1925","Tulsa (OK)","6","2","0","0.75000","128","91","37"
"1926","Tulsa (OK)","7","2","0","0.77778","169","56","113"
"1927","Tulsa (OK)","8","1","0","0.88889","206","84","122"
"1928","Tulsa (OK)","7","2","1","0.75000","273","80","193"
"1929","Tulsa (OK)","6","3","1","0.65000","107","81","26"
"1930","Tulsa (OK)","7","2","0","0.77778","171","79","92"
"1931","Tulsa (OK)","8","3","0","0.72727","256","55","201"
"1932","Tulsa (OK)","7","1","1","0.83333","175","36","139"
"1933","Tulsa (OK)","6","1","0","0.85714","93","19","74"
"1934","Tulsa (OK)","5","2","1","0.68750","106","39","67"
"1935","Tulsa (OK)","3","6","1","0.35000","58","94","-36"
"1923","Oklahoma Baptist University","4","4","1","0.50000","57","66","-9"
"1924","Oklahoma Baptist University","8","3","0","0.72727","161","96","65"
"1925","Oklahoma Baptist University","8","1","0","0.88889","285","15","270"
"1926","Oklahoma Baptist University","6","1","1","0.81250","162","22","140"
"1927","Oklahoma Baptist University","6","1","2","0.77778","98","41","57"
"1928","Oklahoma Baptist University","5","2","2","0.66667","191","86","105"
"1929","Oklahoma Baptist University","5","3","0","0.62500","112","31","81"
"1931","Oklahoma Baptist University","3","6","0","0.33333","84","120","-36"
"1932","Oklahoma Baptist University","5","4","0","0.55556","131","98","33"
"1933","Oklahoma Baptist University","6","2","1","0.72222","178","97","81"
"1934","Oklahoma Baptist University","7","2","0","0.77778","95","26","69"
"1936","Tulsa (OK)","5","2","2","0.66667","154","56","98"
"1937","Tulsa (OK)","6","2","2","0.70000","195","90","105"
"1938","Tulsa (OK)","4","5","1","0.45000","115","148","-33"
"1939","Tulsa (OK)","4","5","1","0.45000","94","104","-10"
"1940","Tulsa (OK)","7","3","0","0.70000","166","112","54"
"1941","Tulsa (OK)","8","2","0","0.80000","194","65","129"
"1942","Tulsa (OK)","10","1","0","0.90909","434","46","388"
"1943","Tulsa (OK)","6","1","1","0.81250","269","52","217"
"1944","Tulsa (OK)","8","2","0","0.80000","380","128","252"
"1945","Tulsa (OK)","8","3","0","0.72727","275","84","191"
"1946","Tulane (LA)","3","7","0","0.30000","179","209","-30"
"1947","Tulane (LA)","2","5","2","0.33333","94","192","-98"
"1948","Tulane (LA)","9","1","0","0.90000","207","60","147"
"1949","Tulane (LA)","7","2","1","0.75000","251","142","109"
"1950","Tulane (LA)","6","2","1","0.72222","260","97","163"
"1951","Tulane (LA)","4","6","0","0.40000","143","172","-29"
"1946","Tulsa (OK)","9","1","0","0.90000","295","83","212"
"1947","Tulsa (OK)","5","5","0","0.50000","143","128","15"
"1948","Tulsa (OK)","0","9","1","0.05000","135","330","-195"
"1949","Tulsa (OK)","5","5","1","0.50000","223","233","-10"
"1950","Tulsa (OK)","9","1","1","0.86364","339","124","215"
"1951","Tulsa (OK)","9","2","0","0.81818","371","200","171"
"1952","Tulsa (OK)","8","2","1","0.77273","341","197","144"
"1953","Tulsa (OK)","3","7","0","0.30000","117","258","-141"
"1954","Tulsa (OK)","0","11","0","0.00000","118","338","-220"
"1955","Tulsa (OK)","2","7","1","0.25000","124","232","-108"
"1956","Tulsa (OK)","7","2","1","0.75000","169","76","93"
"1957","Tulsa (OK)","4","6","0","0.40000","110","145","-35"
"1958","Tulsa (OK)","7","3","0","0.70000","216","100","116"
"1959","Tulsa (OK)","5","5","0","0.50000","137","164","-27"
"1960","Tulsa (OK)","5","5","0","0.50000","169","230","-61"
"1965","Texas-El Paso","8","3","0","0.72727","317","206","111"
"1966","Texas-El Paso","6","4","0","0.60000","293","187","106"
"1967","Texas-El Paso","7","2","1","0.75000","337","145","192"
"1968","Texas-El Paso","4","5","1","0.45000","232","225","7"
"1969","Texas-El Paso","4","6","0","0.40000","158","242","-84"
"1970","Texas-El Paso","6","4","0","0.60000","263","236","27"
"1971","Texas-El Paso","5","6","0","0.45455","166","217","-51"
"1972","Texas-El Paso","1","5","0","0.16667","104","197","-93"
"1961","Tulsa (OK)","2","8","0","0.20000","91","205","-114"
"1962","Tulsa (OK)","5","5","0","0.50000","219","181","38"
"1963","Tulsa (OK)","5","5","0","0.50000","214","241","-27"
"1964","Tulsa (OK)","9","2","0","0.81818","398","140","258"
"1965","Tulsa (OK)","8","3","0","0.72727","321","171","150"
"1966","Tulsa (OK)","6","4","0","0.60000","220","203","17"
"1967","Tulsa (OK)","7","3","0","0.70000","304","155","149"
"1968","Tulsa (OK)","3","7","0","0.30000","149","314","-165"
"1969","Tulsa (OK)","1","9","0","0.10000","183","377","-194"
"1970","Tulsa (OK)","6","4","0","0.60000","187","178","9"
"1971","Tulsa (OK)","4","7","0","0.36364","173","297","-124"
"1972","Tulsa (OK)","1","5","0","0.16667","70","142","-72"
"1972","Tulsa (OK)","3","2","0","0.60000","125","127","-2"
"1973","Tulsa (OK)","6","5","0","0.54545","258","193","65"
"1974","Tulsa (OK)","8","3","0","0.72727","285","204","81"
"1975","Tulsa (OK)","7","4","0","0.63636","368","181","187"
"1976","Tulsa (OK)","7","4","1","0.62500","253","208","45"
"1977","Texas Christian","2","9","0","0.18182","184","434","-250"
"1978","Texas Christian","2","9","0","0.18182","109","357","-248"
"1979","Texas Christian","2","8","1","0.22727","127","226","-99"
"1980","Texas Christian","1","10","0","0.09091","143","295","-152"
"1981","Texas Christian","2","7","2","0.27273","230","299","-69"
"1982","Texas Christian","3","8","0","0.27273","203","266","-63"
"1977","Tulsa (OK)","3","8","0","0.27273","192","398","-206"
"1978","Tulsa (OK)","9","2","0","0.81818","289","203","86"
"1979","Tulsa (OK)","6","5","0","0.54545","195","221","-26"
"1980","Tulsa (OK)","8","3","0","0.72727","243","196","47"
"1981","Tulsa (OK)","6","5","0","0.54545","304","196","108"
"1982","Tulsa (OK)","10","1","0","0.90909","342","196","146"
"1983","Tulsa (OK)","8","3","0","0.72727","297","185","112"
"1984","Tulsa (OK)","6","5","0","0.54545","261","206","55"
"1985","Arizona St.","8","4","0","0.66667","285","168","117"
"1986","Arizona St.","10","1","1","0.87500","379","167","212"
"1987","Arizona St.","7","4","1","0.62500","334","263","71"
"1988","Ohio St.","4","6","1","0.40909","229","283","-54"
"1989","Ohio St.","8","4","0","0.66667","339","297","42"
"1990","Ohio St.","7","4","1","0.62500","349","220","129"
"1991","Ohio St.","8","4","0","0.66667","277","187","90"
"1992","Ohio St.","8","3","1","0.70833","271","158","113"
"1993","Ohio St.","10","1","1","0.87500","351","193","158"
"1994","Ohio St.","9","4","0","0.69231","336","211","125"
"1995","Ohio St.","11","2","0","0.84615","475","220","255"
"1996","Ohio St.","11","1","0","0.91667","455","131","324"
"1997","Ohio St.","10","3","0","0.76923","394","170","224"
"1998","Ohio St.","11","1","0","0.91667","430","144","286"
"1999","Ohio St.","6","6","0","0.50000","285","287","-2"
"2000","Ohio St.","8","4","0","0.66667","331","222","109"
"1979","North Dakota St.","6","4","0","0.60000","217","164","53"
"1980","North Dakota St.","6","4","0","0.60000","204","163","41"
"1981","North Dakota St.","10","3","0","0.76923","322","185","137"
"1982","North Dakota St.","12","1","0","0.92308","294","130","164"
"1983","North Dakota St.","12","1","0","0.92308","326","171","155"
"1984","North Dakota St.","11","2","0","0.84615","463","225","238"
"1985","Tulsa (OK)","6","5","0","0.54545","274","328","-54"
"1986","Tulsa (OK)","7","4","0","0.63636","293","186","107"
"1987","Wisconsin","3","8","0","0.27273","202","299","-97"
"1988","Wisconsin","1","10","0","0.09091","106","314","-208"
"1989","Wisconsin","2","9","0","0.18182","172","341","-169"
"1987","Tulsa (OK)","3","8","0","0.27273","175","371","-196"
"1988","Tulsa (OK)","4","7","0","0.36364","254","318","-64"
"1989","Tulsa (OK)","6","6","0","0.50000","302","271","31"
"1990","Tulsa (OK)","3","8","0","0.27273","183","281","-98"
"1991","Tulsa (OK)","10","2","0","0.83333","333","225","108"
"1992","Tulsa (OK)","4","7","0","0.36364","240","303","-63"
"1993","Tulsa (OK)","4","6","1","0.40909","262","273","-11"
"1994","Tulsa (OK)","3","8","0","0.27273","244","304","-60"
"1995","Tulsa (OK)","4","7","0","0.36364","233","300","-67"
"1996","Tulsa (OK)","4","7","0","0.36364","245","333","-88"
"1997","Tulsa (OK)","2","9","0","0.18182","258","426","-168"
"1998","Tulsa (OK)","4","7","0","0.36364","222","258","-36"
"1999","Tulsa (OK)","1","6","0","0.14286","125","274","-149"
"1999","Tulsa (OK)","1","3","0","0.25000","105","112","-7"
"2000","Tulsa (OK)","5","7","0","0.41667","240","283","-43"
"2001","Tulsa (OK)","1","10","0","0.09091","191","387","-196"
"2002","Tulsa (OK)","1","11","0","0.08333","233","417","-184"
"2003","Tulsa (OK)","8","5","0","0.61538","400","361","39"
"2004","Tulsa (OK)","4","8","0","0.33333","348","398","-50"
"2005","Tulsa (OK)","9","4","0","0.69231","430","305","125"
"2006","Tulsa (OK)","8","5","0","0.61538","360","262","98"
"2007","Louisville (KY)","6","6","0","0.50000","422","377","45"
"2008","Louisville (KY)","5","7","0","0.41667","296","358","-62"
"2009","Louisville (KY)","4","8","0","0.33333","217","315","-98"
"2006","Rice (TX)","7","6","0","0.53846","350","432","-82"
"2007","Tulsa (OK)","10","4","0","0.71429","576","467","109"
"2008","Tulsa (OK)","11","3","0","0.78571","661","391","270"
"2009","Tulsa (OK)","5","7","0","0.41667","351","328","23"
"2010","Tulsa (OK)","10","3","0","0.76923","538","394","144"
"2011","Pittsburgh (PA)","6","6","0","0.50000","309","269","40"
"2012","Arizona St.","8","5","0","0.61538","499","316","183"
"2013","Arizona St.","10","4","0","0.71429","556","373","183"
"2011","Tulsa (OK)","8","5","0","0.61538","430","355","75"
"2012","Tulsa (OK)","11","3","0","0.78571","486","331","155"
"2013","Tulsa (OK)","3","9","0","0.25000","253","407","-154"
"1919","UCLA","2","6","0","0.25000","52","193","-141"
"1920","UCLA","0","5","0","0.00000","21","224","-203"
"1921","UCLA","0","5","0","0.00000","14","214","-200"
"1922","UCLA","2","3","1","0.41667","84","62","22"
"1943","Willamette (OR)","2","1","0","0.66667","52","18","34"
"1944","Willamette (OR)","3","2","0","0.60000","78","131","-53"
"1923","UCLA","2","5","0","0.28571","54","132","-78"
"1924","UCLA","0","5","3","0.18750","40","109","-69"
"1907","Western Michigan","3","2","1","0.58333","44","8","36"
"1908","Western Michigan","3","3","0","0.50000","33","98","-65"
"1909","Western Michigan","7","0","0","1.00000","194","9","185"
"1910","Western Michigan","4","1","1","0.75000","75","20","55"
"1911","Western Michigan","2","3","0","0.40000","110","59","51"
"1912","Western Michigan","3","2","1","0.58333","86","50","36"
"1913","Western Michigan","4","0","0","1.00000","59","15","44"
"1914","Western Michigan","6","0","0","1.00000","180","7","173"
"1915","Western Michigan","5","1","0","0.83333","291","43","248"
"1916","Western Michigan","5","1","0","0.83333","389","38","351"
"1917","Western Michigan","4","3","0","0.57143","203","105","98"
"1918","Western Michigan","3","2","0","0.60000","223","30","193"
"1919","Western Michigan","4","1","0","0.80000","156","91","65"
"1920","Western Michigan","3","4","0","0.42857","119","133","-14"
"1921","Western Michigan","6","2","0","0.75000","262","40","222"
"1922","Minnesota","3","3","1","0.50000","79","65","14"
"1923","Minnesota","5","1","1","0.78571","114","60","54"
"1924","Minnesota","3","3","2","0.50000","68","63","5"
"1925","UCLA","5","3","1","0.61111","91","130","-39"
"1926","UCLA","5","3","0","0.62500","153","67","86"
"1927","UCLA","6","2","1","0.72222","144","54","90"
"1928","UCLA","4","4","1","0.50000","171","136","35"
"1929","UCLA","4","4","0","0.50000","121","190","-69"
"1930","UCLA","3","5","0","0.37500","77","125","-48"
"1931","UCLA","3","4","1","0.43750","83","57","26"
"1932","UCLA","6","4","0","0.60000","149","61","88"
"1933","UCLA","5","4","1","0.55000","89","62","27"
"1934","UCLA","7","3","0","0.70000","146","69","77"
"1935","UCLA","8","2","0","0.80000","160","79","81"
"1936","UCLA","6","3","1","0.65000","143","91","52"
"1937","UCLA","2","6","1","0.27778","93","133","-40"
"1938","UCLA","7","4","1","0.62500","217","106","111"
"1939","UCLA","6","0","4","0.80000","127","62","65"
"1940","UCLA","1","9","0","0.10000","79","174","-95"
"1941","UCLA","5","5","1","0.50000","128","178","-50"
"1942","UCLA","7","4","0","0.63636","174","98","76"
"1943","UCLA","1","8","0","0.11111","59","199","-140"
"1944","UCLA","4","5","1","0.45000","189","149","40"
"1945","UCLA","5","4","0","0.55556","135","79","56"
"1946","UCLA","10","1","0","0.90909","327","117","210"
"1947","UCLA","5","4","0","0.55556","172","80","92"
"1948","UCLA","3","7","0","0.30000","156","235","-79"
"1940","Vanderbilt (TN)","3","6","1","0.35000","101","98","3"
"1941","Vanderbilt (TN)","8","2","0","0.80000","260","89","171"
"1942","Vanderbilt (TN)","6","4","0","0.60000","232","113","119"
"1946","Vanderbilt (TN)","5","4","0","0.55556","108","43","65"
"1947","Vanderbilt (TN)","6","4","0","0.60000","182","85","97"
"1948","Vanderbilt (TN)","8","2","1","0.77273","328","73","255"
"1949","UCLA","6","3","0","0.66667","227","188","39"
"1950","UCLA","6","3","0","0.66667","196","96","100"
"1951","UCLA","5","3","1","0.61111","188","120","68"
"1952","UCLA","8","1","0","0.88889","220","55","165"
"1953","UCLA","8","2","0","0.80000","224","76","148"
"1954","UCLA","9","0","0","1.00000","367","40","327"
"1955","UCLA","9","2","0","0.81818","299","74","225"
"1956","UCLA","7","3","0","0.70000","148","122","26"
"1957","UCLA","8","2","0","0.80000","190","90","100"
"1958","UCLA","1","2","0","0.33333","24","55","-31"
"1958","UCLA","2","4","1","0.35714","112","118","-6"
"1959","UCLA","5","4","1","0.55000","169","150","19"
"1960","UCLA","7","2","1","0.75000","175","84","91"
"1961","UCLA","7","4","0","0.63636","185","142","43"
"1962","UCLA","4","6","0","0.40000","118","139","-21"
"1963","UCLA","2","8","0","0.20000","96","219","-123"
"1964","UCLA","4","6","0","0.40000","145","236","-91"
"1955","Oregon St.","6","3","0","0.66667","126","120","6"
"1956","Oregon St.","7","3","1","0.68182","203","166","37"
"1957","Oregon St.","8","2","0","0.80000","203","129","74"
"1958","Oregon St.","6","4","0","0.60000","98","118","-20"
"1959","Oregon St.","3","7","0","0.30000","166","178","-12"
"1960","Oregon St.","6","3","1","0.65000","197","145","52"
"1961","Oregon St.","5","5","0","0.50000","165","137","28"
"1962","Oregon St.","9","2","0","0.81818","279","148","131"
"1963","Oregon St.","5","5","0","0.50000","198","192","6"
"1964","Oregon St.","8","3","0","0.72727","149","124","25"
"1965","UCLA","8","2","1","0.77273","257","168","89"
"1966","UCLA","9","1","0","0.90000","281","127","154"
"1967","UCLA","7","2","1","0.75000","284","161","123"
"1968","UCLA","3","7","0","0.30000","197","246","-49"
"1969","UCLA","8","1","1","0.85000","329","103","226"
"1970","UCLA","6","5","0","0.54545","274","240","34"
"1967","Kansas","5","5","0","0.50000","166","146","20"
"1968","Kansas","9","2","0","0.81818","394","190","204"
"1969","Kansas","1","9","0","0.10000","176","290","-114"
"1970","Kansas","5","6","0","0.45455","270","277","-7"
"1971","UCLA","2","7","1","0.25000","166","243","-77"
"1972","UCLA","8","3","0","0.72727","351","239","112"
"1973","UCLA","9","2","0","0.81818","470","199","271"
"1974","Georgia Tech","6","5","0","0.54545","238","212","26"
"1975","Georgia Tech","7","4","0","0.63636","270","200","70"
"1976","Georgia Tech","4","6","1","0.40909","221","267","-46"
"1977","Georgia Tech","6","5","0","0.54545","224","221","3"
"1978","Georgia Tech","7","5","0","0.58333","270","253","17"
"1979","Georgia Tech","4","6","1","0.40909","152","190","-38"
"1974","UCLA","6","3","2","0.63636","240","174","66"
"1975","UCLA","9","2","1","0.79167","349","243","106"
"1976","UCLA","9","2","1","0.79167","391","173","218"
"1977","UCLA","0","11","0","0.00000","269","196","73"
"1978","UCLA","8","3","1","0.70833","261","172","89"
"1979","UCLA","5","6","0","0.45455","257","256","1"
"1980","UCLA","9","2","0","0.81818","306","135","171"
"1981","UCLA","7","4","1","0.62500","302","197","105"
"1982","UCLA","10","1","1","0.87500","399","231","168"
"1983","UCLA","7","4","1","0.62500","309","265","44"
"1984","UCLA","9","3","0","0.75000","275","248","27"
"1985","UCLA","9","2","1","0.79167","363","214","149"
"1986","UCLA","8","3","1","0.70833","385","222","163"
"1987","UCLA","10","2","0","0.83333","426","195","231"
"1988","UCLA","10","2","0","0.83333","392","190","202"
"1989","UCLA","3","7","1","0.31818","209","246","-37"
"1990","UCLA","5","6","0","0.45455","305","332","-27"
"1991","UCLA","9","3","0","0.75000","323","190","133"
"1992","UCLA","6","5","0","0.54545","201","228","-27"
"1993","UCLA","8","4","0","0.66667","368","230","138"
"1994","UCLA","5","6","0","0.45455","239","295","-56"
"1995","UCLA","7","5","0","0.58333","338","300","38"
"1979","Pacific (CA)","3","7","0","0.30000","162","193","-31"
"1980","Pacific (CA)","4","8","0","0.33333","211","330","-119"
"1981","Pacific (CA)","5","6","0","0.45455","170","253","-83"
"1982","Pacific (CA)","2","9","0","0.18182","200","330","-130"
"1996","UCLA","5","6","0","0.45455","330","318","12"
"1997","UCLA","10","2","0","0.83333","477","247","230"
"1998","UCLA","10","2","0","0.83333","476","340","136"
"1999","UCLA","5","6","0","0.45455","230","311","-81"
"2000","UCLA","6","6","0","0.50000","353","368","-15"
"2001","UCLA","7","4","0","0.63636","317","225","92"
"2002","UCLA","7","5","0","0.58333","360","313","47"
"2007","Tulane (LA)","4","8","0","0.33333","293","375","-82"
"2008","Tulane (LA)","2","10","0","0.16667","200","414","-214"
"2009","Tulane (LA)","3","9","0","0.25000","193","440","-247"
"2010","Tulane (LA)","4","8","0","0.33333","299","446","-147"
"2011","Tulane (LA)","2","5","0","0.28571","173","248","-75"
"2002","UCLA","1","0","0","1.00000","27","13","14"
"2003","UCLA","6","7","0","0.46154","248","305","-57"
"2004","UCLA","6","6","0","0.50000","361","309","52"
"2005","UCLA","10","2","0","0.83333","469","410","59"
"2006","UCLA","7","6","0","0.53846","299","259","40"
"2007","UCLA","6","6","0","0.50000","275","273","2"
"2007","UCLA","0","1","0","0.00000","16","17","-1"
"2009","New Mexico St.","3","10","0","0.23077","149","411","-262"
"2010","New Mexico St.","2","10","0","0.16667","188","474","-286"
"2011","New Mexico St.","4","9","0","0.30769","319","478","-159"
"2012","New Mexico St.","1","11","0","0.08333","224","473","-249"
"1995","Colorado","10","2","0","0.83333","444","240","204"
"1996","Colorado","10","2","0","0.83333","352","220","132"
"1997","Colorado","5","6","0","0.45455","300","295","5"
"1998","Colorado","8","4","0","0.66667","302","253","49"
"1999","Washington","7","5","0","0.58333","331","302","29"
"2000","Washington","11","1","0","0.91667","387","270","117"
"2001","Washington","8","4","0","0.66667","353","370","-17"
"2002","Washington","7","6","0","0.53846","398","342","56"
"2008","UCLA","4","8","0","0.33333","212","348","-136"
"2009","UCLA","7","6","0","0.53846","286","276","10"
"2010","UCLA","4","8","0","0.33333","242","364","-122"
"2011","UCLA","6","7","0","0.46154","309","419","-110"
"2011","UCLA","0","1","0","0.00000","14","20","-6"
"2012","UCLA","9","5","0","0.64286","482","386","96"
"2013","UCLA","10","3","0","0.76923","480","301","179"
"1872","Stevens Tech (NJ)","0","1","0","0.00000","0","6","-6"
"1873","New York (NY)","3","3","0","0.50000","15","13","2"
"1874","Stevens Tech (NJ)","2","3","0","0.40000","10","20","-10"
"1875","Stevens Tech (NJ)","4","4","0","0.50000","21","20","1"
"1876","New York (NY)","2","3","1","0.41667","16","19","-3"
"1877","Stevens Tech (NJ)","3","1","2","0.66667","9","14","-5"
"1878","Stevens Tech (NJ)","3","3","3","0.50000","3","9","-6"
"1879","Stevens Tech (NJ)","2","3","5","0.45000","8","14","-6"
"1880","Stevens Tech (NJ)","1","5","0","0.16667","3","16","-13"
"1881","Stevens Tech (NJ)","3","8","3","0.32143","16","29","-13"
"1882","Lawrence (WI)","7","8","1","0.46875","17","25","-8"
"1883","Stevens Tech (NJ)","7","6","1","0.53571","187","128","59"
"1884","Fordham (NY)","9","10","0","0.47368","221","261","-40"
"1885","Georgetown (DC)","5","17","1","0.23913","359","612","-253"
"1886","New York (NY)","9","15","2","0.38462","180","565","-385"
"1887","Fordham (NY)","8","12","1","0.40476","157","445","-288"
"1888","Amherst (MA)","6","17","3","0.28846","192","791","-599"
"1889","New York (NY)","8","21","4","0.30303","278","647","-369"
"1890","New York (NY)","25","14","2","0.63415","727","538","189"
"1891","Delaware","32","30","7","0.51449","966","971","-5"
"1892","Beloit (WI)","29","31","3","0.48413","726","797","-71"
"1893","Marquette (WI)","39","34","3","0.53289","1091","885","206"
"1894","Manhattan (NY)","32","29","7","0.52206","853","692","161"
"1895","Delaware","44","35","6","0.55294","889","813","76"
"1896","Manhattan (NY)","51","49","6","0.50943","949","1164","-215"
"1897","Stevens Tech (NJ)","37","50","4","0.42857","661","1048","-387"
"1898","Manhattan (NY)","37","43","9","0.46629","781","1050","-269"
"1899","Manhattan (NY)","34","40","6","0.46250","594","1063","-469"
"1900","Manhattan (NY)","43","47","11","0.48020","991","1049","-58"
"1901","Ferris St. (MI)","51","44","7","0.53431","906","852","54"
"1902","Indiana St.","56","48","5","0.53670","1053","927","126"
"1903","Manhattan (NY)","30","49","7","0.38953","762","1319","-557"
"1904","Saint Francis (NY)","44","53","9","0.45755","787","1363","-576"
"1905","Bluffton (OH)","38","59","5","0.39706","850","1433","-583"
"1906","Ferris St. (MI)","32","43","12","0.43678","677","854","-177"
"1907","Ferris St. (MI)","32","48","10","0.41111","722","1208","-486"
"1908","Western Illinois","36","45","10","0.45055","760","1069","-309"
"1909","Delaware Valley (PA)","27","52","2","0.34568","682","1287","-605"
"1910","East Stroudsburg (PA)","23","31","3","0.42982","583","738","-155"
"1911","Western Illinois","32","44","7","0.42771","661","902","-241"
"1912","Indiana (PA)","36","56","7","0.39899","1134","1463","-329"
"1913","Saint Francis (NY)","52","67","8","0.44094","1672","2360","-688"
"1914","Delaware Valley (PA)","41","50","6","0.45361","1217","1585","-368"
"1915","Western Illinois","34","35","11","0.49375","932","1217","-285"
"1916","Morgan St. (MD)","44","43","7","0.50532","1493","1270","223"
"1917","Morgan St. (MD)","21","21","2","0.50000","408","883","-475"
"1918","Oklahoma Baptist University","7","16","2","0.32000","258","358","-100"
"1919","Western Illinois","53","41","8","0.55882","1478","1056","422"
"1920","Virginia Union","28","39","2","0.42029","506","893","-387"
"1921","Cooper Union (NY)","19","34","3","0.36607","441","1112","-671"
"1922","Cooper Union (NY)","27","34","6","0.44776","703","832","-129"
"1923","Cooper Union (NY)","31","45","2","0.41026","718","1112","-394"
"1924","East Stroudsburg (PA)","34","40","6","0.46250","946","1175","-229"
"1925","Saint Anselm (NH)","32","28","10","0.52857","847","802","45"
"1926","Saint Anselm (NH)","22","30","4","0.42857","515","702","-187"
"1927","Bethune-Cookman (FL)","20","29","8","0.42105","674","783","-109"
"1928","Saint Anselm (NH)","28","24","7","0.53390","564","1095","-531"
"1929","Saint Anselm (NH)","25","32","5","0.44355","616","843","-227"
"1930","Saint Anselm (NH)","31","27","10","0.52941","643","549","94"
"1931","Campbell (NC)","21","17","4","0.54762","465","428","37"
"1932","Campbell (NC)","7","30","3","0.21250","254","760","-506"
"1933","Campbell (NC)","11","13","3","0.46296","262","324","-62"
"1934","Bowie St. (MD)","4","7","2","0.38462","116","94","22"
"1935","Florida Southern","7","12","1","0.37500","170","162","8"
"1936","Bowie St. (MD)","5","2","1","0.68750","154","97","57"
"1937","Bowie St. (MD)","6","3","0","0.66667","98","87","11"
"1938","West Alabama","7","5","0","0.58333","151","88","63"
"1939","Elizabeth City St. (NC)","7","13","0","0.35000","150","307","-157"
"1940","Elizabeth City St. (NC)","6","5","4","0.53333","128","67","61"
"1941","Arkansas-Pine Bluff","3","9","5","0.32353","178","223","-45"
"1942","Brevard College (NC)","10","6","2","0.61111","225","189","36"
"1943","Clark Atlanta (GA)","6","8","0","0.42857","127","206","-79"
"1944","Abilene Christian (TX)","9","11","1","0.45238","158","255","-97"
"1945","Benedict (SC)","10","15","2","0.40741","299","296","3"
"1946","Elizabeth City St. (NC)","7","20","3","0.28333","144","540","-396"
"1947","Clark Atlanta (GA)","3","6","2","0.36364","49","230","-181"
"1948","Virginia-Lynchburg","4","6","1","0.40909","77","302","-225"
"1949","Virginia-Lynchburg","0","3","1","0.12500","7","70","-63"
"1950","Virginia-Lynchburg","2","3","0","0.40000","53","98","-45"
"1951","Lane (TN)","8","6","0","0.57143","295","234","61"
"1952","Lane (TN)","9","5","1","0.63333","220","206","14"
"1953","Lane (TN)","1","7","0","0.12500","58","215","-157"
"1954","Lane (TN)","2","6","0","0.25000","105","135","-30"
"1955","Lane (TN)","2","4","0","0.33333","83","129","-46"
"1957","Louisiana College","2","7","0","0.22222","106","179","-73"
"1959","Azusa Pacific (CA)","2","3","0","0.40000","117","90","27"
"1960","Azusa Pacific (CA)","4","3","1","0.56250","103","76","27"
"1961","Azusa Pacific (CA)","3","3","0","0.50000","123","147","-24"
"1963","San Francisco (CA)","2","5","0","0.28571","58","98","-40"
"1964","New York (NY)","0","2","0","0.00000","20","48","-28"
"1965","Adelphi (NY)","4","8","0","0.33333","198","216","-18"
"1966","Fairfield (CT)","18","22","2","0.45238","545","652","-107"
"1967","La Salle (PA)","25","31","0","0.44643","846","1080","-234"
"1968","Centenary (LA)","17","42","2","0.29508","726","1393","-667"
"1969","Bluffton (OH)","33","43","0","0.43421","1058","1548","-490"
"1970","Saint John's (NY)","35","54","1","0.39444","1379","1783","-404"
"1971","Bluffton (OH)","43","45","1","0.48876","1360","1384","-24"
"1972","Marquette (WI)","39","44","2","0.47059","1217","1351","-134"
"1973","Brooklyn (NY)","30","52","1","0.36747","1007","1611","-604"
"1974","Marquette (WI)","33","36","3","0.47917","959","1169","-210"
"1975","Marquette (WI)","31","22","4","0.57895","1042","932","110"
"1976","Bluffton (OH)","23","33","1","0.41228","862","1186","-324"
"1977","Manhattan (NY)","14","28","1","0.33721","568","923","-355"
"1978","Fairfield (CT)","5","7","1","0.42308","194","203","-9"
"1979","Fairfield (CT)","7","8","0","0.46667","247","260","-13"
"1980","Westfield St. (MA)","6","5","4","0.53333","184","196","-12"
"1981","San Francisco (CA)","17","14","0","0.54839","567","498","69"
"1982","Manhattan (NY)","18","16","0","0.52941","580","644","-64"
"1983","SUNY-Stony Brook (NY)","15","11","0","0.57692","474","453","21"
"1984","Stonehill (MA)","7","12","0","0.36842","231","439","-208"
"1985","Manhattan (NY)","10","10","0","0.50000","313","316","-3"
"1986","Marquette (WI)","13","17","0","0.43333","497","564","-67"
"1987","Marquette (WI)","10","17","0","0.37037","389","487","-98"
"1988","Marquette (WI)","1","5","0","0.16667","80","125","-45"
"1989","Marquette (WI)","4","4","0","0.50000","209","151","58"
"1990","Marquette (WI)","1","7","0","0.12500","80","180","-100"
"1991","Marquette (WI)","1","5","0","0.16667","106","182","-76"
"1992","Marquette (WI)","2","5","0","0.28571","81","129","-48"
"1993","Marquette (WI)","7","1","0","0.87500","212","126","86"
"1994","Marquette (WI)","1","6","0","0.14286","125","184","-59"
"1995","Marquette (WI)","3","4","0","0.42857","141","191","-50"
"1996","Marquette (WI)","3","5","0","0.37500","139","182","-43"
"1998","Madison College (WI)","2","15","0","0.11765","221","613","-392"
"1999","Marquette (WI)","0","7","0","0.00000","110","298","-188"
"2000","Marquette (WI)","1","5","0","0.16667","60","96","-36"
"2001","Marquette (WI)","2","6","0","0.25000","144","179","-35"
"2002","Marquette (WI)","3","4","0","0.42857","127","208","-81"
"2003","Marquette (WI)","1","6","0","0.14286","71","151","-80"
"2004","Marquette (WI)","0","6","0","0.00000","53","238","-185"
"2005","Marquette (WI)","2","5","0","0.28571","92","226","-134"
"2006","Marquette (WI)","1","6","0","0.14286","62","206","-144"
"2007","Marquette (WI)","2","5","0","0.28571","140","215","-75"
"2008","Marquette (WI)","0","7","0","0.00000","61","304","-243"
"2009","Marquette (WI)","0","1","0","0.00000","0","22","-22"
"1896","Utah","2","2","0","0.50000","18","16","2"
"1897","Utah","1","5","0","0.16667","12","66","-54"
"1898","Utah","2","1","0","0.66667","6","6","0"
"1900","Utah","2","2","0","0.50000","57","27","30"
"1901","Utah","5","1","0","0.83333","111","6","105"
"1902","Utah","6","2","1","0.72222","162","51","111"
"1903","Utah","3","5","0","0.37500","126","87","39"
"1904","Southern California","6","1","0","0.85714","199","27","172"
"1905","Southern California","6","3","1","0.65000","211","45","166"
"1906","Southern California","2","0","2","0.75000","36","0","36"
"1907","Southern California","5","1","0","0.83333","182","20","162"
"1909","Idaho St.","5","0","0","1.00000","77","10","67"
"1910","Idaho St.","6","1","0","0.85714","183","67","116"
"1911","Idaho St.","5","4","0","0.55556","47","129","-82"
"1912","Idaho St.","1","2","0","0.33333","60","56","4"
"1913","Idaho St.","5","2","0","0.71429","191","31","160"
"1914","Idaho St.","6","1","0","0.85714","146","33","113"
"1904","Utah","7","1","0","0.87500","301","38","263"
"1905","Utah","6","2","0","0.75000","260","74","186"
"1906","Utah","6","1","0","0.85714","170","6","164"
"1907","Utah","7","2","0","0.77778","147","66","81"
"1908","Utah","4","2","1","0.64286","211","49","162"
"1909","Utah","6","1","0","0.85714","180","19","161"
"1924","Oregon","4","3","2","0.55556","94","66","28"
"1910","Utah","4","2","0","0.66667","70","44","26"
"1911","Utah","5","1","1","0.78571","200","15","185"
"1912","Utah","5","1","1","0.78571","153","16","137"
"1913","Utah","2","4","1","0.35714","129","103","26"
"1914","Montana St.","5","1","0","0.83333","168","29","139"
"1915","Montana St.","4","2","1","0.64286","72","86","-14"
"1916","Montana St.","2","2","2","0.50000","78","44","34"
"1917","Montana St.","0","2","2","0.25000","41","69","-28"
"1914","Utah","3","3","0","0.50000","87","108","-21"
"1915","Utah","5","2","0","0.71429","162","71","91"
"1916","Utah","3","2","0","0.60000","113","45","68"
"1917","Utah","2","4","0","0.33333","48","116","-68"
"1919","Utah","5","2","0","0.71429","151","62","89"
"1920","Utah","1","5","1","0.21429","19","116","-97"
"1921","Utah","3","2","1","0.58333","55","55","0"
"1922","Utah","7","1","0","0.87500","153","41","112"
"1923","Utah","4","3","0","0.57143","241","48","193"
"1924","Utah","3","4","1","0.43750","116","95","21"
"1925","Utah","6","2","0","0.75000","110","51","59"
"1926","Utah","7","0","0","1.00000","164","23","141"
"1927","Utah","3","3","1","0.50000","93","60","33"
"1928","Utah","5","0","2","0.85714","117","41","76"
"1929","Utah","7","0","0","1.00000","219","23","196"
"1930","Utah","8","0","0","1.00000","340","20","320"
"1931","Utah","7","2","0","0.77778","301","31","270"
"1932","Utah","6","1","1","0.81250","162","47","115"
"1933","Utah","5","3","0","0.62500","129","78","51"
"1934","Utah","5","3","0","0.62500","150","42","108"
"1935","Utah","4","3","1","0.56250","166","69","97"
"1936","Utah","6","3","0","0.66667","142","75","67"
"1937","Utah","5","3","0","0.62500","133","52","81"
"1938","Utah","7","1","2","0.80000","187","36","151"
"1939","Utah","6","1","2","0.77778","261","74","187"
"1940","Utah","7","2","0","0.77778","169","87","82"
"1941","Utah","6","0","2","0.87500","209","65","144"
"1942","Utah","6","3","0","0.66667","155","84","71"
"1943","Utah","0","7","0","0.00000","38","297","-259"
"1944","Utah","5","2","1","0.68750","161","86","75"
"1945","Utah","4","4","0","0.50000","146","165","-19"
"1946","Utah","8","3","0","0.72727","257","114","143"
"1947","Utah","8","1","1","0.85000","207","80","127"
"1948","Utah","8","1","1","0.85000","221","96","125"
"1949","Utah","2","7","1","0.25000","141","166","-25"
"1940","West Texas A&M","7","3","0","0.70000","238","101","137"
"1941","West Texas A&M","8","2","0","0.80000","298","107","191"
"1946","Texas-El Paso","3","6","0","0.33333","136","150","-14"
"1947","Texas-El Paso","5","3","1","0.61111","159","79","80"
"1948","Texas-El Paso","8","2","1","0.77273","361","182","179"
"1949","Texas-El Paso","8","2","1","0.77273","292","113","179"
"1950","Utah","3","4","3","0.45000","240","254","-14"
"1951","Utah","7","4","0","0.63636","236","247","-11"
"1952","Utah","6","3","1","0.65000","188","128","60"
"1953","Utah","8","2","0","0.80000","264","150","114"
"1954","Utah","4","7","0","0.36364","172","212","-40"
"1955","Utah","6","3","0","0.66667","182","136","46"
"1956","Utah","5","5","0","0.50000","227","177","50"
"1957","Utah","6","4","0","0.60000","262","136","126"
"1958","Stanford (CA)","2","8","0","0.20000","93","226","-133"
"1959","Stanford (CA)","3","7","0","0.30000","232","261","-29"
"1960","Stanford (CA)","0","10","0","0.00000","111","254","-143"
"1961","Stanford (CA)","4","6","0","0.40000","105","163","-58"
"1962","Stanford (CA)","5","5","0","0.50000","124","174","-50"
"1958","Utah","4","7","0","0.36364","161","187","-26"
"1959","Utah","5","5","0","0.50000","224","195","29"
"1960","Utah","7","3","0","0.70000","194","90","104"
"1961","Utah","6","4","0","0.60000","176","134","42"
"1962","Utah","4","5","1","0.45000","169","196","-27"
"1963","Utah","4","6","0","0.40000","204","187","17"
"1964","Utah","9","2","0","0.81818","234","68","166"
"1965","Utah","3","7","0","0.30000","177","164","13"
"1966","Iowa","2","8","0","0.20000","86","253","-167"
"1967","Iowa","1","8","1","0.15000","161","277","-116"
"1968","Iowa","5","5","0","0.50000","322","289","33"
"1969","Iowa","5","5","0","0.50000","255","275","-20"
"1970","Iowa","3","6","1","0.35000","129","259","-130"
"1966","Utah","5","5","0","0.50000","176","203","-27"
"1967","Utah","4","7","0","0.36364","204","252","-48"
"1951","Kansas St.","0","9","0","0.00000","73","228","-155"
"1952","Kansas St.","1","9","0","0.10000","81","255","-174"
"1953","Kansas St.","6","3","1","0.65000","198","116","82"
"1954","Kansas St.","7","3","0","0.70000","191","154","37"
"1955","Houston (TX)","6","4","0","0.60000","176","139","37"
"1956","Houston (TX)","7","2","1","0.75000","185","90","95"
"1957","Southern Methodist (TX)","4","5","1","0.45000","127","175","-48"
"1958","Southern Methodist (TX)","6","4","0","0.60000","203","134","69"
"1959","Southern Methodist (TX)","5","4","1","0.55000","147","133","14"
"1960","Southern Methodist (TX)","0","9","1","0.05000","31","221","-190"
"1961","Southern Methodist (TX)","2","7","1","0.25000","92","191","-99"
"1968","Utah","3","7","0","0.30000","162","234","-72"
"1969","Utah","8","2","0","0.80000","231","107","124"
"1970","Utah","6","4","0","0.60000","208","176","32"
"1971","Utah","3","8","0","0.27273","244","315","-71"
"1972","Utah","6","5","0","0.54545","354","336","18"
"1973","Utah","7","5","0","0.58333","385","344","41"
"1974","Utah","1","10","0","0.09091","115","339","-224"
"1975","Utah","1","10","0","0.09091","132","332","-200"
"1976","Utah","3","8","0","0.27273","245","361","-116"
"1974","Cal St.-Long Beach","6","5","0","0.54545","252","238","14"
"1975","Cal St.-Long Beach","9","2","0","0.81818","274","169","105"
"1976","Cal St.-Long Beach","8","3","0","0.72727","229","140","89"
"1977","Utah","3","8","0","0.27273","212","379","-167"
"1978","Utah","8","3","0","0.72727","291","182","109"
"1979","Utah","6","6","0","0.50000","267","296","-29"
"1980","Utah","5","5","1","0.50000","259","293","-34"
"1981","Utah","8","2","1","0.77273","321","207","114"
"1977","Toledo (OH)","2","9","0","0.18182","112","287","-175"
"1978","Toledo (OH)","2","9","0","0.18182","144","256","-112"
"1979","Toledo (OH)","8","2","1","0.77273","213","190","23"
"1980","Toledo (OH)","4","7","0","0.36364","187","190","-3"
"1981","Toledo (OH)","9","3","0","0.75000","270","170","100"
"1982","Utah","5","6","0","0.45455","247","188","59"
"1983","Utah","5","6","0","0.45455","296","289","7"
"1984","Utah","6","5","1","0.54167","347","253","94"
"1989","Memphis (TN)","2","9","0","0.18182","174","338","-164"
"1990","Memphis (TN)","4","6","1","0.40909","212","233","-21"
"1991","Memphis (TN)","5","6","0","0.45455","228","229","-1"
"1992","Memphis (TN)","6","5","0","0.54545","312","181","131"
"1993","Memphis (TN)","6","5","0","0.54545","268","215","53"
"1994","Memphis (TN)","6","5","0","0.54545","163","159","4"
"1985","Utah","8","4","0","0.66667","405","343","62"
"1986","Utah","2","9","0","0.18182","278","444","-166"
"1987","Utah","5","7","0","0.41667","321","362","-41"
"1988","Utah","6","5","0","0.54545","399","357","42"
"1989","Utah","4","8","0","0.33333","365","524","-159"
"1990","Utah","4","7","0","0.36364","214","342","-128"
"1991","Utah","7","5","0","0.58333","276","277","-1"
"1992","Utah","6","6","0","0.50000","320","289","31"
"1993","Utah","7","6","0","0.53846","390","396","-6"
"1994","Utah","10","2","0","0.83333","426","210","216"
"1995","Utah","7","4","0","0.63636","296","230","66"
"1996","Utah","8","4","0","0.66667","313","309","4"
"1997","Utah","6","5","0","0.54545","253","200","53"
"1998","Utah","7","4","0","0.63636","339","227","112"
"1999","Utah","9","3","0","0.75000","380","210","170"
"2000","Utah","4","7","0","0.36364","234","207","27"
"2001","Utah","8","4","0","0.66667","329","210","119"
"2002","Utah","5","6","0","0.45455","249","226","23"
"2005","Weber St. (UT)","6","5","0","0.54545","277","277","0"
"2006","Weber St. (UT)","4","7","0","0.36364","201","265","-64"
"2007","Weber St. (UT)","5","6","0","0.45455","299","324","-25"
"2008","Weber St. (UT)","10","4","0","0.71429","493","317","176"
"2009","Weber St. (UT)","7","5","0","0.58333","338","260","78"
"2010","Weber St. (UT)","6","5","0","0.54545","279","342","-63"
"2011","Weber St. (UT)","5","6","0","0.45455","347","354","-7"
"2001","Bowling Green (OH)","8","3","0","0.72727","333","215","118"
"2002","Bowling Green (OH)","9","3","0","0.75000","490","304","186"
"2003","Utah","10","2","0","0.83333","344","229","115"
"2004","Utah","11","0","0","1.00000","509","227","282"
"2005","Florida","9","3","0","0.75000","343","226","117"
"2006","Florida","13","1","0","0.92857","416","189","227"
"2007","Florida","9","4","0","0.69231","552","331","221"
"2008","Florida","13","1","0","0.92857","611","181","430"
"2009","Florida","13","1","0","0.92857","502","174","328"
"2010","Florida","8","5","0","0.61538","388","277","111"
"2012","Ohio St.","12","0","0","1.00000","446","274","172"
"2013","Ohio St.","12","2","0","0.85714","637","317","320"
"2004","Utah","1","0","0","1.00000","35","7","28"
"2005","Utah","7","5","0","0.58333","360","289","71"
"2006","Utah","8","5","0","0.61538","363","258","105"
"2007","Utah","9","4","0","0.69231","341","219","122"
"2008","Utah","13","0","0","1.00000","480","224","256"
"2009","Utah","10","3","0","0.76923","388","263","125"
"2010","Utah","10","3","0","0.76923","430","264","166"
"2011","Utah","8","5","0","0.61538","325","263","62"
"2012","Utah","5","7","0","0.41667","320","301","19"
"2013","Utah","5","7","0","0.41667","350","336","14"
"1869","Rutgers (NJ)","2","2","0","0.50000","18","18","0"
"1870","Rutgers (NJ)","2","2","0","0.50000","17","17","0"
"1872","Columbia (NY)","5","4","0","0.55556","22","16","6"
"1873","Rutgers (NJ)","7","4","1","0.62500","31","26","5"
"1874","Harvard (MA)","9","7","0","0.56250","54","41","13"
"1875","Harvard (MA)","12","6","2","0.65000","52","29","23"
"1876","Harvard (MA)","13","8","1","0.61364","45","29","16"
"1877","Harvard (MA)","9","7","3","0.55263","31","21","10"
"1878","Pennsylvania","14","9","5","0.58929","42","24","18"
"1879","Harvard (MA)","13","9","12","0.55882","46","27","19"
"1880","Harvard (MA)","18","11","4","0.60606","75","53","22"
"1881","Rutgers (NJ)","22","18","8","0.54167","70","47","23"
"1882","Rutgers (NJ)","41","28","2","0.59155","176","111","65"
"1883","Rutgers (NJ)","38","32","1","0.54225","1288","965","323"
"1884","Pennsylvania","47","29","5","0.61111","1728","1184","544"
"1885","Michigan","34","17","4","0.65455","1437","612","825"
"1886","Lehigh (PA)","48","21","4","0.68493","1850","637","1213"
"1887","California","67","35","3","0.65238","2660","935","1725"
"1888","Princeton (NJ)","70","56","6","0.55303","2468","1899","569"
"1889","Brown (RI)","82","51","11","0.60764","2879","1796","1083"
"1890","Brown (RI)","77","76","9","0.50309","3002","2455","547"
"1891","Southern California","94","76","13","0.54918","2813","2189","624"
"1892","Minnesota","93","80","9","0.53571","2972","2394","578"
"1893","Duke (NC)","79","94","9","0.45879","2176","2912","-736"
"1894","Colorado St.","50","62","4","0.44828","1161","1518","-357"
"1895","Boston (MA)","31","44","11","0.42442","692","1031","-339"
"1896","Rhode Island","54","62","12","0.46875","1126","1201","-75"
"1897","Boston (MA)","32","40","6","0.44872","792","785","7"
"1898","Miami (OH)","47","23","4","0.66216","921","644","277"
"1899","New Hampshire","33","32","6","0.50704","571","522","49"
"1900","New Hampshire","22","35","11","0.40441","442","686","-244"
"1901","Marshall (WV)","18","34","3","0.35455","302","917","-615"
"1902","Saint John's (MN)","9","22","4","0.31429","148","460","-312"
"1903","Wichita St. (KS)","14","25","2","0.36585","376","546","-170"
"1904","Oklahoma St.","11","14","1","0.44231","194","394","-200"
"1905","Miami (OH)","7","25","5","0.25676","245","494","-249"
"1906","Rensselaer Tech (NY)","3","7","4","0.35714","92","107","-15"
"1907","Marshall (WV)","5","10","2","0.35294","71","238","-167"
"1908","Fort Hays St. (KS)","5","6","1","0.45833","56","91","-35"
"1909","Fort Hays St. (KS)","1","3","1","0.30000","12","68","-56"
"1910","Texas St.","0","1","0","0.00000","0","19","-19"
"1912","Fort Hays St. (KS)","1","2","0","0.33333","20","132","-112"
"1913","Eureka (IL)","1","6","0","0.14286","39","203","-164"
"1914","Eureka (IL)","3","4","0","0.42857","57","201","-144"
"1915","Texas St.","1","1","1","0.50000","13","20","-7"
"1916","Texas St.","0","2","1","0.16667","0","106","-106"
"1917","Boston (MA)","4","4","0","0.50000","73","136","-63"
"1918","Monmouth (IL)","1","7","0","0.12500","26","137","-111"
"1930","Troy (AL)","1","2","0","0.33333","7","73","-66"
"2013","Grambling St. (LA)","0","1","0","0.00000","0","0","0"
"1896","Utah St.","0","1","0","0.00000","0","6","-6"
"1898","Utah St.","0","1","0","0.00000","5","12","-7"
"1899","Utah St.","1","0","0","1.00000","10","6","4"
"1900","Utah St.","0","1","0","0.00000","0","21","-21"
"1901","Utah St.","3","2","1","0.58333","42","40","2"
"1902","Utah St.","0","4","0","0.00000","10","73","-63"
"1903","Utah St.","3","0","0","1.00000","78","0","78"
"1904","Utah St.","4","8","0","0.33333","63","253","-190"
"1905","Utah St.","2","2","1","0.50000","31","33","-2"
"1906","Utah St.","3","1","0","0.75000","37","51","-14"
"1907","Utah St.","6","1","0","0.85714","184","25","159"
"1908","Utah St.","4","2","0","0.66667","142","39","103"
"1921","DePauw (IN)","4","3","0","0.57143","167","107","60"
"1936","Wheaton (IL)","3","2","2","0.57143","50","51","-1"
"1937","Wheaton (IL)","3","5","0","0.37500","61","90","-29"
"1938","Wheaton (IL)","3","3","0","0.50000","53","76","-23"
"1939","Wheaton (IL)","2","4","2","0.37500","65","109","-44"
"1900","Eastern Michigan","2","4","0","0.33333","27","80","-53"
"1901","Eastern Michigan","3","5","0","0.37500","60","167","-107"
"1902","Eastern Michigan","1","5","1","0.21429","43","125","-82"
"1909","Utah St.","2","2","1","0.50000","34","55","-21"
"1910","Utah St.","5","2","0","0.71429","104","33","71"
"1911","Utah St.","5","0","0","1.00000","164","0","164"
"1912","Utah St.","4","2","1","0.64286","154","40","114"
"1913","Utah St.","3","3","0","0.50000","97","69","28"
"1914","Utah St.","2","5","0","0.28571","56","208","-152"
"1915","Utah St.","3","4","0","0.42857","56","99","-43"
"1916","Utah St.","1","5","1","0.21429","69","178","-109"
"1917","Utah St.","7","0","1","0.93750","267","26","241"
"1919","Utah St.","5","2","0","0.71429","234","44","190"
"1920","Utah St.","4","2","1","0.64286","84","48","36"
"1921","Utah St.","7","1","0","0.87500","151","82","69"
"1922","Utah St.","5","4","0","0.55556","132","83","49"
"1923","Utah St.","5","2","0","0.71429","147","59","88"
"1924","Utah St.","4","2","1","0.64286","127","52","75"
"1925","Utah St.","6","1","0","0.85714","111","39","72"
"1926","Utah St.","5","1","2","0.75000","93","43","50"
"1927","Utah St.","3","4","1","0.43750","129","53","76"
"1928","Utah St.","5","3","1","0.61111","182","87","95"
"1929","Utah St.","3","4","0","0.42857","50","60","-10"
"1930","Utah St.","3","5","1","0.38889","73","205","-132"
"1931","Utah St.","6","2","0","0.75000","147","72","75"
"1932","Utah St.","4","4","0","0.50000","123","105","18"
"1933","Utah St.","4","4","0","0.50000","115","61","54"
"1934","Utah St.","5","1","1","0.78571","131","42","89"
"1935","Utah St.","5","2","1","0.68750","165","73","92"
"1936","Utah St.","7","0","1","0.93750","99","13","86"
"1937","Utah St.","2","4","2","0.37500","47","152","-105"
"1938","Utah St.","4","4","0","0.50000","85","87","-2"
"1939","Utah St.","3","4","1","0.43750","76","81","-5"
"1940","Utah St.","2","5","1","0.31250","48","104","-56"
"1941","Utah St.","0","8","0","0.00000","46","153","-107"
"1942","Utah St.","6","3","1","0.65000","201","137","64"
"1944","Utah St.","3","3","0","0.50000","88","109","-21"
"1945","Utah St.","4","3","0","0.57143","173","92","81"
"1946","Utah St.","7","2","1","0.75000","219","75","144"
"1947","Utah St.","6","5","0","0.54545","228","210","18"
"1948","Utah St.","5","6","0","0.45455","196","238","-42"
"1949","Utah St.","3","7","0","0.30000","105","209","-104"
"1950","Utah St.","2","9","0","0.18182","107","374","-267"
"1951","Utah St.","3","5","1","0.38889","161","183","-22"
"1952","Utah St.","3","7","1","0.31818","121","209","-88"
"1953","Utah St.","8","3","0","0.72727","207","139","68"
"1954","Utah St.","4","6","0","0.40000","158","187","-29"
"1955","Denver (CO)","8","2","0","0.80000","310","89","221"
"1956","Denver (CO)","6","4","0","0.60000","250","206","44"
"1957","Denver (CO)","6","4","0","0.60000","150","155","-5"
"1958","Denver (CO)","2","8","0","0.20000","135","163","-28"
"1959","Denver (CO)","2","8","0","0.20000","104","230","-126"
"1960","Denver (CO)","3","7","0","0.30000","133","300","-167"
"1955","Utah St.","4","6","0","0.40000","177","172","5"
"1956","Utah St.","6","4","0","0.60000","221","199","22"
"1957","Utah St.","2","7","1","0.25000","153","255","-102"
"1958","Utah St.","3","7","0","0.30000","123","188","-65"
"1959","Utah St.","5","6","0","0.45455","181","185","-4"
"1960","Utah St.","9","2","0","0.81818","274","85","189"
"1961","Utah St.","9","1","1","0.86364","396","102","294"
"1962","Utah St.","8","2","0","0.80000","273","139","134"
"1963","Stanford (CA)","3","7","0","0.30000","154","199","-45"
"1964","Stanford (CA)","5","5","0","0.50000","150","138","12"
"1965","Stanford (CA)","6","3","1","0.65000","144","149","-5"
"1966","Stanford (CA)","5","5","0","0.50000","149","146","3"
"1967","Stanford (CA)","5","5","0","0.50000","157","179","-22"
"1968","Stanford (CA)","6","3","1","0.65000","268","162","106"
"1969","Stanford (CA)","7","2","1","0.75000","349","172","177"
"1970","Stanford (CA)","9","3","0","0.75000","343","206","137"
"1971","Stanford (CA)","9","3","0","0.75000","261","135","126"
"1993","San Jose St. (CA)","2","9","0","0.18182","282","337","-55"
"1994","San Jose St. (CA)","3","8","0","0.27273","200","377","-177"
"1995","San Jose St. (CA)","3","8","0","0.27273","271","378","-107"
"1996","San Jose St. (CA)","3","9","0","0.25000","221","448","-227"
"1963","Utah St.","8","2","0","0.80000","317","99","218"
"1964","Utah St.","5","4","1","0.55000","294","136","158"
"1965","Utah St.","8","2","0","0.80000","271","136","135"
"1966","Utah St.","4","6","0","0.40000","181","163","18"
"1968","Boise St. (ID)","8","2","0","0.80000","324","124","200"
"1969","Boise St. (ID)","9","1","0","0.90000","391","98","293"
"1970","Boise St. (ID)","8","3","0","0.72727","293","129","164"
"1971","Boise St. (ID)","10","2","0","0.83333","351","247","104"
"1972","Boise St. (ID)","7","4","0","0.63636","345","240","105"
"1973","Boise St. (ID)","10","3","0","0.76923","470","221","249"
"1974","Boise St. (ID)","10","2","0","0.83333","497","259","238"
"1975","Boise St. (ID)","9","2","1","0.79167","401","265","136"
"1976","Nevada-Las Vegas","9","3","0","0.75000","359","288","71"
"1977","Nevada-Las Vegas","9","2","0","0.81818","300","243","57"
"1978","Nevada-Las Vegas","7","4","0","0.63636","249","182","67"
"1979","Nevada-Las Vegas","9","1","2","0.83333","370","300","70"
"1980","Nevada-Las Vegas","7","4","0","0.63636","384","257","127"
"1981","Nevada-Las Vegas","6","6","0","0.50000","326","433","-107"
"1962","Indiana (PA)","5","2","1","0.68750","121","56","65"
"1963","Indiana (PA)","7","1","1","0.83333","207","77","130"
"1964","Merchant Marine (NY)","3","7","0","0.30000","107","208","-101"
"1967","Utah St.","7","2","1","0.75000","205","143","62"
"1968","Utah St.","7","3","0","0.70000","247","142","105"
"1969","Utah St.","3","7","0","0.30000","134","250","-116"
"1970","Utah St.","5","5","0","0.50000","217","225","-8"
"1971","Utah St.","8","3","0","0.72727","243","183","60"
"1972","Utah St.","8","3","0","0.72727","329","230","99"
"1973","Wake Forest (NC)","1","9","1","0.13636","73","326","-253"
"1974","Wake Forest (NC)","1","10","0","0.09091","74","348","-274"
"1975","Wake Forest (NC)","3","8","0","0.27273","221","264","-43"
"1976","Wake Forest (NC)","5","6","0","0.45455","177","206","-29"
"1977","Wake Forest (NC)","1","10","0","0.09091","113","270","-157"
"1980","Southern Oregon","3","7","0","0.30000","138","223","-85"
"1981","Southern Oregon","6","4","0","0.60000","169","182","-13"
"1982","Southern Oregon","6","4","0","0.60000","234","157","77"
"1983","Southern Oregon","9","2","0","0.81818","342","204","138"
"1984","Southern Oregon","0","10","0","0.00000","226","186","40"
"1985","Southern Oregon","3","6","1","0.35000","170","238","-68"
"1986","Southern Oregon","5","5","0","0.50000","129","161","-32"
"1987","Southern Oregon","7","5","0","0.58333","253","258","-5"
"1988","Southern Oregon","5","4","0","0.55556","223","237","-14"
"1997","Coast Guard (CT)","9","2","0","0.81818","256","169","87"
"1964","Fresno St. (CA)","4","6","0","0.40000","212","204","8"
"1965","Fresno St. (CA)","6","4","0","0.60000","191","116","75"
"1973","Utah St.","7","4","0","0.63636","220","202","18"
"1974","Utah St.","8","3","0","0.72727","181","199","-18"
"1975","Utah St.","6","5","0","0.54545","193","240","-47"
"1976","Utah St.","3","8","0","0.27273","170","263","-93"
"1977","Utah St.","4","7","0","0.36364","177","249","-72"
"1978","Utah St.","7","4","0","0.63636","269","214","55"
"1979","Utah St.","8","2","1","0.77273","347","270","77"
"1980","Utah St.","6","5","0","0.54545","290","255","35"
"1981","Utah St.","5","5","1","0.50000","204","210","-6"
"1982","Utah St.","5","6","0","0.45455","192","262","-70"
"1987","California","3","6","2","0.36364","239","267","-28"
"1988","California","5","5","1","0.50000","243","244","-1"
"1989","California","4","7","0","0.36364","200","288","-88"
"1990","California","7","4","1","0.62500","325","341","-16"
"1991","California","10","2","0","0.83333","443","239","204"
"1992","Arizona St.","6","5","0","0.54545","235","185","50"
"1993","Arizona St.","6","5","0","0.54545","282","248","34"
"1994","Arizona St.","3","8","0","0.27273","242","347","-105"
"1995","Arizona St.","6","5","0","0.54545","308","330","-22"
"1996","Arizona St.","11","1","0","0.91667","488","216","272"
"1997","Arizona St.","9","3","0","0.75000","324","210","114"
"1998","Arizona St.","5","6","0","0.45455","333","338","-5"
"1999","Arizona St.","7","5","0","0.58333","285","311","-26"
"2000","Arizona St.","6","6","0","0.50000","313","303","10"
"1983","Utah St.","5","6","0","0.45455","193","214","-21"
"1984","Utah St.","1","10","0","0.09091","196","390","-194"
"1985","Utah St.","3","8","0","0.27273","177","319","-142"
"1977","Drake (IA)","2","9","0","0.18182","184","317","-133"
"1978","Drake (IA)","4","7","0","0.36364","211","264","-53"
"1979","Drake (IA)","3","8","0","0.27273","218","242","-24"
"1980","Drake (IA)","8","3","0","0.72727","306","175","131"
"1981","Drake (IA)","10","1","0","0.90909","252","196","56"
"1982","Drake (IA)","4","7","0","0.36364","275","312","-37"
"1983","Drake (IA)","1","10","0","0.09091","136","337","-201"
"1984","Drake (IA)","4","7","0","0.36364","197","260","-63"
"1985","Drake (IA)","4","7","0","0.36364","196","255","-59"
"1986","Utah St.","3","8","0","0.27273","134","243","-109"
"1987","Utah St.","5","6","0","0.45455","205","306","-101"
"1988","Utah St.","4","7","0","0.36364","215","362","-147"
"1989","Utah St.","4","7","0","0.36364","191","355","-164"
"1990","Utah St.","5","5","1","0.50000","287","310","-23"
"1991","Utah St.","5","6","0","0.45455","219","265","-46"
"1992","Pacific (CA)","3","8","0","0.27273","253","287","-34"
"1993","Pacific (CA)","3","8","0","0.27273","184","260","-76"
"1994","Pacific (CA)","6","5","0","0.54545","252","275","-23"
"1995","Pacific (CA)","3","8","0","0.27273","240","439","-199"
"1992","Utah St.","5","6","0","0.45455","300","328","-28"
"1993","Utah St.","7","5","0","0.58333","363","354","9"
"1994","Utah St.","3","8","0","0.27273","209","313","-104"
"1995","Navy (MD)","5","6","0","0.45455","223","189","34"
"1996","Navy (MD)","9","3","0","0.75000","392","309","83"
"1997","Navy (MD)","7","4","0","0.63636","398","209","189"
"1998","Navy (MD)","3","8","0","0.27273","255","376","-121"
"1999","Navy (MD)","5","7","0","0.41667","326","306","20"
"2000","Navy (MD)","1","10","0","0.09091","182","391","-209"
"2001","Navy (MD)","0","7","0","0.00000","122","242","-120"
"2003","Louisiana-Monroe","1","11","0","0.08333","239","467","-228"
"2004","Louisiana-Monroe","5","6","0","0.45455","211","303","-92"
"2005","Louisiana-Monroe","5","6","0","0.45455","239","339","-100"
"2006","Louisiana-Monroe","4","8","0","0.33333","262","267","-5"
"2007","Louisiana-Monroe","6","6","0","0.50000","282","332","-50"
"2008","Louisiana-Monroe","4","8","0","0.33333","284","374","-90"
"2009","Louisiana-Monroe","6","6","0","0.50000","307","328","-21"
"1989","Idaho","9","3","0","0.75000","407","314","93"
"1990","Idaho","9","4","0","0.69231","477","342","135"
"1991","Idaho","6","5","0","0.54545","375","313","62"
"1992","Idaho","9","3","0","0.75000","466","247","219"
"1993","Idaho","11","3","0","0.78571","593","353","240"
"1994","Idaho","9","3","0","0.75000","493","289","204"
"1995","Utah St.","4","7","0","0.36364","293","287","6"
"1996","Utah St.","6","5","0","0.54545","330","339","-9"
"1997","Utah St.","6","6","0","0.50000","389","296","93"
"1998","Louisville (KY)","7","5","0","0.58333","473","435","38"
"1999","Louisville (KY)","7","5","0","0.58333","443","365","78"
"2000","Louisville (KY)","9","3","0","0.75000","405","268","137"
"2001","Louisville (KY)","11","2","0","0.84615","394","223","171"
"2002","Louisville (KY)","7","6","0","0.53846","374","319","55"
"2003","Michigan St.","8","5","0","0.61538","363","293","70"
"2004","Michigan St.","5","7","0","0.41667","353","326","27"
"2005","Michigan St.","5","6","0","0.45455","372","316","56"
"2006","Michigan St.","4","8","0","0.33333","302","341","-39"
"2012","Arkansas","4","8","0","0.33333","282","365","-83"
"2013","Fort Lewis (CO)","4","7","0","0.36364","161","334","-173"
"1989","Weber St. (UT)","3","8","0","0.27273","286","301","-15"
"1990","Weber St. (UT)","5","6","0","0.45455","309","307","2"
"1991","Weber St. (UT)","8","4","0","0.66667","516","421","95"
"1992","Weber St. (UT)","6","5","0","0.54545","283","269","14"
"1993","Weber St. (UT)","7","4","0","0.63636","315","319","-4"
"1994","Weber St. (UT)","5","6","0","0.45455","308","300","8"
"1995","Weber St. (UT)","6","5","0","0.54545","314","318","-4"
"1996","Weber St. (UT)","7","4","0","0.63636","325","262","63"
"1997","Weber St. (UT)","6","5","0","0.54545","257","251","6"
"1998","Utah St.","3","8","0","0.27273","237","309","-72"
"1999","Utah St.","4","7","0","0.36364","234","301","-67"
"1996","Montana","14","1","0","0.93333","638","264","374"
"1997","Montana","8","4","0","0.66667","368","206","162"
"1998","Montana","8","4","0","0.66667","339","315","24"
"1999","Montana","9","3","0","0.75000","537","284","253"
"2000","Utah St.","5","6","0","0.45455","292","356","-64"
"2001","Utah St.","4","7","0","0.36364","316","421","-105"
"2002","Utah St.","4","7","0","0.36364","305","432","-127"
"2003","Utah St.","3","9","0","0.25000","264","315","-51"
"2004","Utah St.","3","8","0","0.27273","184","333","-149"
"2005","Utah St.","3","8","0","0.27273","208","360","-152"
"2006","Utah St.","1","11","0","0.08333","130","462","-332"
"2007","Utah St.","2","10","0","0.16667","247","406","-159"
"2008","Utah St.","3","9","0","0.25000","288","416","-128"
"2003","Southern Utah","4","7","0","0.36364","240","283","-43"
"2009","Utah St.","4","8","0","0.33333","349","408","-59"
"2010","Utah St.","4","8","0","0.33333","264","405","-141"
"2011","Utah St.","7","6","0","0.53846","437","363","74"
"2012","Utah St.","11","2","0","0.84615","454","200","254"
"2013","Wisconsin","9","4","0","0.69231","453","212","241"
"2013","Utah St.","9","5","0","0.64286","445","239","206"
"1890","Vanderbilt (TN)","1","0","0","1.00000","40","0","40"
"1891","Vanderbilt (TN)","3","1","0","0.75000","58","28","30"
"1892","Vanderbilt (TN)","4","4","0","0.50000","114","106","8"
"1893","Vanderbilt (TN)","6","1","0","0.85714","181","50","131"
"1894","Vanderbilt (TN)","7","1","0","0.87500","238","20","218"
"1895","Vanderbilt (TN)","5","3","1","0.61111","67","50","17"
"1896","Vanderbilt (TN)","3","2","2","0.57143","58","76","-18"
"1897","Vanderbilt (TN)","6","0","1","0.92857","141","0","141"
"1898","Vanderbilt (TN)","1","5","0","0.16667","9","61","-52"
"1899","Vanderbilt (TN)","7","2","0","0.77778","109","42","67"
"1900","Vanderbilt (TN)","4","4","1","0.50000","90","92","-2"
"1900","Auburn (AL)","4","0","0","1.00000","148","5","143"
"1901","Vanderbilt (TN)","8","4","2","0.64286","228","86","142"
"1902","Vanderbilt (TN)","8","1","0","0.88889","214","60","154"
"1902","DePauw (IN)","5","5","0","0.50000","187","126","61"
"1903","Vanderbilt (TN)","6","1","1","0.81250","192","16","176"
"1904","Vanderbilt (TN)","8","0","0","1.00000","452","4","448"
"1905","Vanderbilt (TN)","7","1","0","0.87500","372","22","350"
"1906","Vanderbilt (TN)","8","1","0","0.88889","278","16","262"
"1907","Vanderbilt (TN)","5","1","1","0.78571","242","36","206"
"1908","Vanderbilt (TN)","7","2","1","0.75000","207","61","146"
"1909","Vanderbilt (TN)","7","3","0","0.70000","210","32","178"
"1910","Vanderbilt (TN)","8","0","1","0.94444","166","8","158"
"1911","Vanderbilt (TN)","8","1","0","0.88889","259","9","250"
"1912","Vanderbilt (TN)","8","1","1","0.85000","391","19","372"
"1913","Vanderbilt (TN)","5","3","0","0.62500","218","100","118"
"1914","Vanderbilt (TN)","3","6","0","0.33333","166","95","71"
"1915","Vanderbilt (TN)","9","1","0","0.90000","513","38","475"
"1916","Vanderbilt (TN)","7","1","1","0.83333","328","25","303"
"1917","Vanderbilt (TN)","5","3","0","0.62500","142","170","-28"
"1919","Vanderbilt (TN)","5","1","2","0.75000","110","68","42"
"1920","Vanderbilt (TN)","5","3","1","0.61111","169","124","45"
"1921","Vanderbilt (TN)","7","0","1","0.93750","161","21","140"
"1922","Vanderbilt (TN)","8","0","1","0.94444","177","16","161"
"1923","Vanderbilt (TN)","5","2","1","0.68750","137","33","104"
"1924","Vanderbilt (TN)","6","3","1","0.65000","150","53","97"
"1925","Vanderbilt (TN)","6","3","0","0.66667","158","63","95"
"1926","Vanderbilt (TN)","8","1","0","0.88889","241","42","199"
"1927","Vanderbilt (TN)","8","1","2","0.81818","295","93","202"
"1928","Vanderbilt (TN)","8","2","0","0.80000","152","57","95"
"1929","Vanderbilt (TN)","7","2","0","0.77778","187","56","131"
"1930","Vanderbilt (TN)","8","2","0","0.80000","225","45","180"
"1931","Vanderbilt (TN)","5","4","0","0.55556","192","109","83"
"1932","Vanderbilt (TN)","6","1","2","0.77778","128","46","82"
"1933","Vanderbilt (TN)","4","3","3","0.55000","126","107","19"
"1934","Vanderbilt (TN)","6","3","0","0.66667","105","100","5"
"1915","Southern Methodist (TX)","2","5","0","0.28571","20","131","-111"
"1916","Southern Methodist (TX)","0","8","2","0.10000","27","455","-428"
"1918","Vanderbilt (TN)","4","2","0","0.66667","176","31","145"
"1924","Southern Methodist (TX)","5","1","4","0.70000","92","62","30"
"1925","Southern Methodist (TX)","5","2","2","0.66667","148","41","107"
"1926","Southern Methodist (TX)","8","0","1","0.94444","229","47","182"
"1927","Southern Methodist (TX)","7","2","0","0.77778","267","81","186"
"1928","Southern Methodist (TX)","6","3","1","0.65000","254","78","176"
"1929","Southern Methodist (TX)","6","0","4","0.80000","172","36","136"
"1930","Southern Methodist (TX)","6","3","1","0.65000","187","93","94"
"1931","Southern Methodist (TX)","9","1","1","0.86364","160","48","112"
"1932","Southern Methodist (TX)","3","7","2","0.33333","82","112","-30"
"1933","Southern Methodist (TX)","4","7","1","0.37500","99","104","-5"
"1934","Southern Methodist (TX)","8","2","2","0.75000","224","63","161"
"1935","Vanderbilt (TN)","7","3","0","0.70000","179","68","111"
"1936","Vanderbilt (TN)","3","5","1","0.38889","115","87","28"
"1937","Vanderbilt (TN)","7","2","0","0.77778","121","42","79"
"1938","Vanderbilt (TN)","6","3","0","0.66667","86","49","37"
"1939","Vanderbilt (TN)","2","7","1","0.25000","96","165","-69"
"1940","Temple (PA)","4","4","1","0.50000","155","113","42"
"1941","Temple (PA)","7","2","0","0.77778","176","146","30"
"1942","Temple (PA)","2","5","3","0.35000","48","135","-87"
"1943","Temple (PA)","2","6","0","0.25000","65","163","-98"
"1944","Temple (PA)","2","4","2","0.37500","93","96","-3"
"1945","Temple (PA)","7","1","0","0.87500","198","51","147"
"1946","Temple (PA)","2","4","2","0.37500","61","114","-53"
"1947","Temple (PA)","3","6","0","0.33333","91","128","-37"
"1948","Temple (PA)","2","6","1","0.27778","95","182","-87"
"1940","Vanderbilt (TN)","3","6","1","0.35000","101","98","3"
"1941","Vanderbilt (TN)","8","2","0","0.80000","260","89","171"
"1942","Vanderbilt (TN)","6","4","0","0.60000","232","113","119"
"1946","Vanderbilt (TN)","5","4","0","0.55556","108","43","65"
"1947","Vanderbilt (TN)","6","4","0","0.60000","182","85","97"
"1948","Vanderbilt (TN)","8","2","1","0.77273","328","73","255"
"1949","UCLA","6","3","0","0.66667","227","188","39"
"1950","UCLA","6","3","0","0.66667","196","96","100"
"1951","UCLA","5","3","1","0.61111","188","120","68"
"1952","UCLA","8","1","0","0.88889","220","55","165"
"1953","UCLA","8","2","0","0.80000","224","76","148"
"1954","UCLA","9","0","0","1.00000","367","40","327"
"1955","UCLA","9","2","0","0.81818","299","74","225"
"1956","UCLA","7","3","0","0.70000","148","122","26"
"1957","UCLA","8","2","0","0.80000","190","90","100"
"1939","Middle Tennessee St.","1","6","1","0.18750","39","125","-86"
"1943","Vanderbilt (TN)","5","0","0","1.00000","143","33","110"
"1944","Vanderbilt (TN)","3","0","1","0.87500","67","23","44"
"1945","Vanderbilt (TN)","3","6","0","0.33333","71","215","-144"
"1949","Vanderbilt (TN)","5","5","0","0.50000","177","183","-6"
"1950","Vanderbilt (TN)","7","4","0","0.63636","252","216","36"
"1951","Vanderbilt (TN)","6","5","0","0.54545","201","195","6"
"1952","Vanderbilt (TN)","3","5","2","0.40000","151","199","-48"
"1946","Virginia","4","4","1","0.50000","180","170","10"
"1947","Virginia","7","3","0","0.70000","244","99","145"
"1948","Virginia","5","3","1","0.61111","175","157","18"
"1949","Virginia","7","2","0","0.77778","199","121","78"
"1950","Virginia","8","2","0","0.80000","260","151","109"
"1951","Virginia","8","1","0","0.88889","278","104","174"
"1952","Virginia","8","2","0","0.80000","297","90","207"
"1953","Vanderbilt (TN)","3","7","0","0.30000","131","258","-127"
"1954","Vanderbilt (TN)","2","7","0","0.22222","134","169","-35"
"1955","Vanderbilt (TN)","8","3","0","0.72727","240","86","154"
"1956","Vanderbilt (TN)","5","5","0","0.50000","147","113","34"
"1957","Vanderbilt (TN)","5","3","2","0.60000","113","108","5"
"1958","Vanderbilt (TN)","5","2","3","0.65000","131","71","60"
"1959","Vanderbilt (TN)","5","3","2","0.60000","138","106","32"
"1960","Vanderbilt (TN)","3","7","0","0.30000","74","193","-119"
"1961","Vanderbilt (TN)","2","8","0","0.20000","95","220","-125"
"1962","Vanderbilt (TN)","1","9","0","0.10000","62","215","-153"
"1963","Vanderbilt (TN)","1","7","2","0.20000","73","146","-73"
"1964","Vanderbilt (TN)","3","6","1","0.35000","79","122","-43"
"1965","Vanderbilt (TN)","2","7","1","0.25000","85","180","-95"
"1966","Vanderbilt (TN)","1","9","0","0.10000","72","237","-165"
"1967","Vanderbilt (TN)","2","7","1","0.25000","165","241","-76"
"1968","Vanderbilt (TN)","5","4","1","0.55000","163","147","16"
"1969","Vanderbilt (TN)","4","6","0","0.40000","242","264","-22"
"1970","Vanderbilt (TN)","4","7","0","0.36364","201","213","-12"
"1971","Vanderbilt (TN)","4","6","1","0.40909","136","208","-72"
"1972","Vanderbilt (TN)","3","8","0","0.27273","129","243","-114"
"1973","Vanderbilt (TN)","5","6","0","0.45455","181","262","-81"
"1974","Vanderbilt (TN)","7","3","2","0.66667","313","199","114"
"1975","Texas Tech","6","5","0","0.54545","272","251","21"
"1976","Texas Tech","10","2","0","0.83333","336","206","130"
"1977","Texas Tech","7","5","0","0.58333","299","246","53"
"1978","Mississippi","5","6","0","0.45455","181","240","-59"
"1979","Mississippi","4","7","0","0.36364","251","298","-47"
"1980","Mississippi","3","8","0","0.27273","263","266","-3"
"1981","Mississippi","4","6","1","0.40909","167","284","-117"
"1982","Mississippi","4","7","0","0.36364","208","262","-54"
"1983","Duke (NC)","3","8","0","0.27273","246","350","-104"
"1984","Duke (NC)","2","9","0","0.18182","128","301","-173"
"1985","Duke (NC)","4","7","0","0.36364","193","252","-59"
"1986","Duke (NC)","4","7","0","0.36364","200","284","-84"
"1972","Memphis (TN)","5","5","1","0.50000","265","254","11"
"1973","Memphis (TN)","8","3","0","0.72727","264","167","97"
"1974","Memphis (TN)","7","4","0","0.63636","225","148","77"
"1975","Vanderbilt (TN)","7","4","0","0.63636","119","200","-81"
"1976","Vanderbilt (TN)","2","9","0","0.18182","131","282","-151"
"1977","Vanderbilt (TN)","2","9","0","0.18182","141","276","-135"
"1978","Vanderbilt (TN)","2","9","0","0.18182","164","418","-254"
"1975","Tennessee-Martin","2","8","0","0.20000","100","164","-64"
"1976","Tennessee-Martin","8","3","0","0.72727","276","125","151"
"1977","Tennessee-Martin","8","3","0","0.72727","311","185","126"
"1979","Vanderbilt (TN)","1","10","0","0.09091","179","418","-239"
"1980","Vanderbilt (TN)","2","9","0","0.18182","140","352","-212"
"1981","Vanderbilt (TN)","4","7","0","0.36364","211","281","-70"
"1982","Vanderbilt (TN)","8","4","0","0.66667","293","242","51"
"1983","Vanderbilt (TN)","2","9","0","0.18182","183","274","-91"
"1984","Vanderbilt (TN)","5","6","0","0.45455","276","277","-1"
"1985","Vanderbilt (TN)","3","7","1","0.31818","166","308","-142"
"1979","Austin Peay St. (TN)","7","4","0","0.63636","198","150","48"
"1980","Austin Peay St. (TN)","7","4","0","0.63636","217","148","69"
"1983","Cincinnati (OH)","4","6","1","0.40909","208","234","-26"
"1984","Rice (TX)","1","10","0","0.09091","213","382","-169"
"1985","Rice (TX)","3","8","0","0.27273","233","404","-171"
"1986","Vanderbilt (TN)","1","10","0","0.09091","193","347","-154"
"1987","Vanderbilt (TN)","4","7","0","0.36364","286","355","-69"
"1988","Vanderbilt (TN)","3","8","0","0.27273","202","277","-75"
"1989","Vanderbilt (TN)","1","10","0","0.09091","162","265","-103"
"1990","Vanderbilt (TN)","1","10","0","0.09091","227","457","-230"
"1995","Alabama-Birmingham","5","6","0","0.45455","273","261","12"
"1996","Alabama-Birmingham","5","6","0","0.45455","266","279","-13"
"1997","Alabama-Birmingham","5","6","0","0.45455","222","238","-16"
"1998","Alabama-Birmingham","4","7","0","0.36364","237","308","-71"
"1999","Alabama-Birmingham","5","6","0","0.45455","248","279","-31"
"2000","Alabama-Birmingham","7","4","0","0.63636","238","192","46"
"2001","Alabama-Birmingham","6","5","0","0.54545","265","206","59"
"2002","Alabama-Birmingham","5","7","0","0.41667","268","370","-102"
"2003","Alabama-Birmingham","5","7","0","0.41667","245","287","-42"
"2004","Alabama-Birmingham","7","5","0","0.58333","372","351","21"
"2005","Alabama-Birmingham","5","6","0","0.45455","307","264","43"
"2006","Alabama-Birmingham","3","9","0","0.25000","225","297","-72"
"2007","Tennessee Tech","4","7","0","0.36364","329","352","-23"
"2008","Tennessee Tech","3","9","0","0.25000","240","420","-180"
"2009","Tennessee Tech","6","5","0","0.54545","267","286","-19"
"2010","Tennessee Tech","5","6","0","0.45455","264","317","-53"
"2011","Tennessee Tech","7","4","0","0.63636","355","279","76"
"2012","Tennessee Tech","3","8","0","0.27273","347","433","-86"
"2013","Tennessee Tech","5","7","0","0.41667","313","353","-40"
"1991","Vanderbilt (TN)","5","6","0","0.45455","205","267","-62"
"1992","Vanderbilt (TN)","4","7","0","0.36364","224","277","-53"
"1993","Vanderbilt (TN)","5","6","0","0.45455","137","290","-153"
"1994","Vanderbilt (TN)","5","6","0","0.45455","203","277","-74"
"1995","Louisiana St.","7","4","1","0.62500","324","186","138"
"1996","Louisiana St.","10","2","0","0.83333","335","210","125"
"1997","Louisiana St.","9","3","0","0.75000","373","188","185"
"1998","Louisiana St.","4","7","0","0.36364","337","279","58"
"1999","Louisiana St.","2","8","0","0.20000","188","249","-61"
"2002","Indiana","3","9","0","0.25000","258","445","-187"
"2003","Indiana","2","10","0","0.16667","177","388","-211"
"2004","Indiana","3","8","0","0.27273","262","343","-81"
"1979","Stanford (CA)","5","5","1","0.50000","259","239","20"
"1995","Vanderbilt (TN)","2","9","0","0.18182","122","281","-159"
"1996","Vanderbilt (TN)","2","9","0","0.18182","122","234","-112"
"1985","Missouri","1","10","0","0.09091","206","342","-136"
"1986","Missouri","3","8","0","0.27273","196","314","-118"
"1987","Missouri","5","6","0","0.45455","226","209","17"
"1988","Missouri","3","7","1","0.31818","234","330","-96"
"1997","Vanderbilt (TN)","3","8","0","0.27273","138","204","-66"
"1998","Vanderbilt (TN)","2","9","0","0.18182","142","369","-227"
"1999","Vanderbilt (TN)","5","6","0","0.45455","252","256","-4"
"2000","Vanderbilt (TN)","3","8","0","0.27273","193","273","-80"
"2001","Vanderbilt (TN)","2","9","0","0.18182","226","402","-176"
"1994","Furman (SC)","3","8","0","0.27273","253","325","-72"
"1995","Furman (SC)","6","5","0","0.54545","274","261","13"
"1996","Furman (SC)","9","4","0","0.69231","335","301","34"
"1997","Furman (SC)","7","4","0","0.63636","281","223","58"
"1998","Furman (SC)","5","6","0","0.45455","267","283","-16"
"1999","Furman (SC)","9","3","0","0.75000","432","220","212"
"2000","Furman (SC)","9","3","0","0.75000","379","209","170"
"2001","Furman (SC)","12","3","0","0.80000","477","221","256"
"2002","Vanderbilt (TN)","2","10","0","0.16667","221","368","-147"
"2003","Vanderbilt (TN)","2","10","0","0.16667","235","358","-123"
"2004","Vanderbilt (TN)","2","9","0","0.18182","212","286","-74"
"2005","Vanderbilt (TN)","5","6","0","0.45455","299","321","-22"
"2006","Vanderbilt (TN)","4","8","0","0.33333","264","284","-20"
"2007","Vanderbilt (TN)","5","7","0","0.41667","260","271","-11"
"2008","Vanderbilt (TN)","7","6","0","0.53846","249","255","-6"
"2009","Vanderbilt (TN)","2","10","0","0.16667","196","280","-84"
"2010","Vanderbilt (TN)","2","10","0","0.16667","203","374","-171"
"2011","Vanderbilt (TN)","6","7","0","0.46154","347","281","66"
"2012","Vanderbilt (TN)","9","4","0","0.69231","390","243","147"
"2013","Vanderbilt (TN)","9","4","0","0.69231","391","320","71"
"1869","Rutgers (NJ)","2","2","0","0.50000","18","18","0"
"1870","Rutgers (NJ)","2","2","0","0.50000","17","17","0"
"1872","Columbia (NY)","5","4","0","0.55556","22","16","6"
"1873","Rutgers (NJ)","7","4","1","0.62500","31","26","5"
"1874","Harvard (MA)","9","7","0","0.56250","54","41","13"
"1875","Harvard (MA)","12","6","2","0.65000","52","29","23"
"1876","Harvard (MA)","13","8","1","0.61364","45","29","16"
"1877","Harvard (MA)","9","7","3","0.55263","31","21","10"
"1878","Pennsylvania","14","9","5","0.58929","42","24","18"
"1879","Harvard (MA)","13","9","12","0.55882","46","27","19"
"1880","Harvard (MA)","18","11","4","0.60606","75","53","22"
"1881","Rutgers (NJ)","22","18","8","0.54167","70","47","23"
"1882","Rutgers (NJ)","41","28","2","0.59155","176","111","65"
"1883","Rutgers (NJ)","38","32","1","0.54225","1288","965","323"
"1884","Pennsylvania","47","29","5","0.61111","1728","1184","544"
"1885","Michigan","34","17","4","0.65455","1437","612","825"
"1886","Lehigh (PA)","48","21","4","0.68493","1850","637","1213"
"1887","California","67","35","3","0.65238","2660","935","1725"
"1888","Princeton (NJ)","70","56","6","0.55303","2468","1899","569"
"1889","Brown (RI)","82","51","11","0.60764","2879","1796","1083"
"1890","Brown (RI)","77","76","9","0.50309","3002","2455","547"
"1891","Southern California","94","76","13","0.54918","2813","2189","624"
"1892","Minnesota","93","80","9","0.53571","2972","2394","578"
"1893","Duke (NC)","79","94","9","0.45879","2176","2912","-736"
"1894","Colorado St.","50","62","4","0.44828","1161","1518","-357"
"1895","Boston (MA)","31","44","11","0.42442","692","1031","-339"
"1896","Rhode Island","54","62","12","0.46875","1126","1201","-75"
"1897","Boston (MA)","32","40","6","0.44872","792","785","7"
"1898","Miami (OH)","47","23","4","0.66216","921","644","277"
"1899","New Hampshire","33","32","6","0.50704","571","522","49"
"1900","New Hampshire","22","35","11","0.40441","442","686","-244"
"1901","Marshall (WV)","18","34","3","0.35455","302","917","-615"
"1902","Saint John's (MN)","9","22","4","0.31429","148","460","-312"
"1903","Wichita St. (KS)","14","25","2","0.36585","376","546","-170"
"1904","Oklahoma St.","11","14","1","0.44231","194","394","-200"
"1905","Miami (OH)","7","25","5","0.25676","245","494","-249"
"1906","Rensselaer Tech (NY)","3","7","4","0.35714","92","107","-15"
"1907","Marshall (WV)","5","10","2","0.35294","71","238","-167"
"1908","Fort Hays St. (KS)","5","6","1","0.45833","56","91","-35"
"1909","Fort Hays St. (KS)","1","3","1","0.30000","12","68","-56"
"1910","Texas St.","0","1","0","0.00000","0","19","-19"
"1912","Fort Hays St. (KS)","1","2","0","0.33333","20","132","-112"
"1913","Eureka (IL)","1","6","0","0.14286","39","203","-164"
"1914","Eureka (IL)","3","4","0","0.42857","57","201","-144"
"1915","Texas St.","1","1","1","0.50000","13","20","-7"
"1916","Texas St.","0","2","1","0.16667","0","106","-106"
"1917","Boston (MA)","4","4","0","0.50000","73","136","-63"
"1918","Monmouth (IL)","1","7","0","0.12500","26","137","-111"
"1930","Troy (AL)","1","2","0","0.33333","7","73","-66"
"2013","Grambling St. (LA)","0","1","0","0.00000","0","0","0"
"1893","Virginia","8","3","0","0.72727","244","78","166"
"1894","Virginia","8","2","0","0.80000","404","30","374"
"1896","Navy (MD)","5","3","0","0.62500","180","53","127"
"1895","Virginia","9","3","0","0.75000","206","104","102"
"1896","Virginia","7","2","2","0.72727","238","86","152"
"1897","Virginia","6","2","1","0.72222","111","54","57"
"1894","Virginia Tech","4","1","0","0.80000","112","10","102"
"1898","Virginia","6","6","0","0.50000","117","80","37"
"1899","Virginia","4","3","2","0.55556","92","88","4"
"1900","Virginia","7","2","1","0.75000","186","37","149"
"1901","Virginia","8","2","0","0.80000","270","48","222"
"1902","Virginia","8","1","1","0.85000","157","51","106"
"1903","Virginia","7","2","1","0.75000","177","34","143"
"1899","Columbia (NY)","8","3","0","0.72727","194","85","109"
"1900","Columbia (NY)","6","3","1","0.65000","79","77","2"
"1901","Columbia (NY)","8","5","0","0.61538","157","91","66"
"1904","Virginia","6","3","0","0.66667","78","54","24"
"1913","Rutgers (NJ)","6","3","0","0.66667","247","76","171"
"1914","Rutgers (NJ)","5","3","1","0.61111","208","73","135"
"1915","Rutgers (NJ)","7","1","0","0.87500","351","33","318"
"1916","Rutgers (NJ)","3","2","2","0.57143","106","52","54"
"1917","Rutgers (NJ)","7","1","1","0.83333","295","28","267"
"1918","Rutgers (NJ)","5","2","0","0.71429","192","78","114"
"1919","Rutgers (NJ)","5","3","0","0.62500","115","70","45"
"1920","Rutgers (NJ)","2","7","0","0.22222","32","132","-100"
"1921","Rutgers (NJ)","4","5","0","0.44444","99","168","-69"
"1922","Rutgers (NJ)","5","4","0","0.55556","133","117","16"
"1923","Rutgers (NJ)","7","1","1","0.83333","260","36","224"
"1905","Virginia","5","4","0","0.55556","169","78","91"
"1906","Virginia","7","2","2","0.72727","159","41","118"
"1907","Nebraska","8","2","0","0.80000","323","69","254"
"1908","Nebraska","7","2","1","0.75000","165","93","72"
"1909","Nebraska","3","3","2","0.50000","69","53","16"
"1910","Nebraska","7","1","0","0.87500","260","36","224"
"1907","Virginia","6","3","1","0.65000","169","64","105"
"1908","Virginia","7","0","1","0.93750","106","9","97"
"1909","Virginia","7","1","0","0.87500","155","11","144"
"1910","South Carolina","4","4","0","0.50000","67","109","-42"
"1911","South Carolina","1","4","2","0.28571","22","102","-80"
"1910","Virginia","6","2","0","0.75000","117","37","80"
"1911","Virginia","8","2","0","0.80000","262","30","232"
"1912","Virginia","6","3","0","0.66667","220","48","172"
"1913","Virginia","7","1","0","0.87500","265","28","237"
"1920","Virginia","5","2","2","0.66667","140","53","87"
"1921","Virginia","5","4","0","0.55556","101","83","18"
"1914","Virginia","8","1","0","0.88889","353","38","315"
"1915","Virginia","8","1","0","0.88889","219","26","193"
"1916","Virginia","4","5","0","0.44444","106","172","-66"
"1919","Virginia","2","5","2","0.33333","39","134","-95"
"1916","North Carolina","5","4","0","0.55556","134","93","41"
"1919","North Carolina","4","3","1","0.56250","49","94","-45"
"1922","Virginia","4","4","1","0.50000","102","60","42"
"1916","West Virginia Wesleyan","5","6","0","0.45455","233","199","34"
"1917","West Virginia Wesleyan","5","2","0","0.71429","141","30","111"
"1923","Virginia","3","5","1","0.38889","87","81","6"
"1924","Virginia","5","4","0","0.55556","72","83","-11"
"1925","Virginia","7","1","1","0.83333","144","31","113"
"1926","Virginia","6","2","2","0.70000","161","53","108"
"1927","Virginia","5","4","0","0.55556","117","122","-5"
"1928","Virginia","2","6","1","0.27778","121","142","-21"
"1931","West Virginia","4","6","0","0.40000","91","122","-31"
"1932","West Virginia","5","5","0","0.50000","137","115","22"
"1933","West Virginia","3","5","3","0.40909","87","145","-58"
"1917","Virginia Military Institute","4","4","1","0.50000","162","114","48"
"1919","Sewanee (TN)","3","6","0","0.33333","81","132","-51"
"1920","Sewanee (TN)","4","3","1","0.56250","124","81","43"
"1923","Mississippi St.","5","2","2","0.66667","83","66","17"
"1924","Mississippi St.","5","4","0","0.55556","82","89","-7"
"1928","Colgate (NY)","6","3","0","0.66667","175","107","68"
"1929","Virginia","4","3","2","0.55556","129","139","-10"
"1930","Virginia","4","6","0","0.40000","144","215","-71"
"1918","Columbia (NY)","5","1","0","0.83333","87","27","60"
"1919","Columbia (NY)","2","4","3","0.38889","48","107","-59"
"1921","Nebraska","7","1","0","0.87500","283","17","266"
"1922","Nebraska","7","1","0","0.87500","276","28","248"
"1923","Nebraska","4","2","2","0.62500","112","71","41"
"1924","Nebraska","5","3","0","0.62500","120","77","43"
"1925","Denver (CO)","1","6","0","0.14286","27","152","-125"
"1926","Denver (CO)","4","4","0","0.50000","106","72","34"
"1927","Denver (CO)","5","2","0","0.71429","120","51","69"
"1928","Denver (CO)","4","4","1","0.50000","128","96","32"
"1931","Virginia","1","7","2","0.20000","40","112","-72"
"1932","Virginia","5","4","0","0.55556","95","67","28"
"1933","Virginia","2","6","2","0.30000","83","149","-66"
"1925","North Carolina St.","3","5","1","0.38889","51","74","-23"
"1926","North Carolina St.","4","6","0","0.40000","66","102","-36"
"1927","North Carolina St.","9","1","0","0.90000","216","69","147"
"1928","North Carolina St.","4","5","1","0.45000","157","100","57"
"1929","North Carolina St.","1","8","0","0.11111","44","207","-163"
"1934","Virginia","3","6","0","0.33333","70","151","-81"
"1935","Virginia","1","5","4","0.30000","39","133","-94"
"1936","Virginia","2","7","0","0.22222","73","222","-149"
"1922","Marquette (WI)","8","0","1","0.94444","213","3","210"
"1923","Marquette (WI)","8","0","0","1.00000","162","12","150"
"1924","Marquette (WI)","5","2","0","0.71429","158","68","90"
"1925","Marquette (WI)","7","2","0","0.77778","108","21","87"
"1926","Marquette (WI)","6","3","0","0.66667","146","64","82"
"1927","Marquette (WI)","6","3","0","0.66667","153","49","104"
"1928","Marquette (WI)","5","3","1","0.61111","121","68","53"
"1929","Marquette (WI)","4","3","1","0.56250","118","53","65"
"1930","Marquette (WI)","8","0","1","0.94444","155","7","148"
"1931","Marquette (WI)","8","1","0","0.88889","172","25","147"
"1932","Marquette (WI)","4","3","1","0.56250","98","48","50"
"1933","Marquette (WI)","3","4","1","0.43750","62","82","-20"
"1934","Marquette (WI)","4","5","0","0.44444","129","104","25"
"1935","Marquette (WI)","7","1","0","0.87500","173","65","108"
"1936","Marquette (WI)","7","2","0","0.77778","136","60","76"
"1937","Virginia","2","7","0","0.22222","52","169","-117"
"1938","Virginia","4","4","1","0.50000","113","169","-56"
"1939","Virginia","5","4","0","0.55556","143","75","68"
"1940","Virginia","4","5","0","0.44444","117","103","14"
"1941","Virginia","8","1","0","0.88889","279","42","237"
"1942","Virginia","2","6","1","0.27778","123","181","-58"
"1943","Virginia","3","4","1","0.43750","106","133","-27"
"1944","Virginia","6","1","2","0.77778","197","52","145"
"1945","Virginia","7","2","0","0.77778","265","79","186"
"1946","Marquette (WI)","4","5","0","0.44444","139","148","-9"
"1947","Marquette (WI)","4","5","0","0.44444","185","223","-38"
"1948","Marquette (WI)","2","8","0","0.20000","127","212","-85"
"1949","Marquette (WI)","4","5","0","0.44444","257","209","48"
"1946","Virginia","4","4","1","0.50000","180","170","10"
"1947","Virginia","7","3","0","0.70000","244","99","145"
"1948","Virginia","5","3","1","0.61111","175","157","18"
"1949","Virginia","7","2","0","0.77778","199","121","78"
"1950","Virginia","8","2","0","0.80000","260","151","109"
"1951","Virginia","8","1","0","0.88889","278","104","174"
"1952","Virginia","8","2","0","0.80000","297","90","207"
"1953","Vanderbilt (TN)","3","7","0","0.30000","131","258","-127"
"1954","Vanderbilt (TN)","2","7","0","0.22222","134","169","-35"
"1955","Vanderbilt (TN)","8","3","0","0.72727","240","86","154"
"1956","Vanderbilt (TN)","5","5","0","0.50000","147","113","34"
"1957","Vanderbilt (TN)","5","3","2","0.60000","113","108","5"
"1958","Vanderbilt (TN)","5","2","3","0.65000","131","71","60"
"1959","Vanderbilt (TN)","5","3","2","0.60000","138","106","32"
"1960","Vanderbilt (TN)","3","7","0","0.30000","74","193","-119"
"1961","Vanderbilt (TN)","2","8","0","0.20000","95","220","-125"
"1962","Vanderbilt (TN)","1","9","0","0.10000","62","215","-153"
"1953","Virginia","1","8","0","0.11111","75","242","-167"
"1954","Virginia","3","6","0","0.33333","113","162","-49"
"1955","Virginia","1","9","0","0.10000","96","201","-105"
"1956","Virginia","4","6","0","0.40000","92","167","-75"
"1957","Virginia","3","6","1","0.35000","117","171","-54"
"1958","Air Force (CO)","9","0","2","0.90909","247","102","145"
"1959","Air Force (CO)","5","4","1","0.55000","160","124","36"
"1960","Air Force (CO)","4","6","0","0.40000","147","178","-31"
"1961","Air Force (CO)","3","7","0","0.30000","87","173","-86"
"1962","Air Force (CO)","5","5","0","0.50000","173","171","2"
"1963","Air Force (CO)","7","4","0","0.63636","249","150","99"
"1964","Air Force (CO)","4","5","1","0.45000","106","146","-40"
"1965","Air Force (CO)","3","6","1","0.35000","166","156","10"
"1966","Air Force (CO)","4","6","0","0.40000","154","161","-7"
"1967","Air Force (CO)","2","6","2","0.30000","86","173","-87"
"1968","Air Force (CO)","7","3","0","0.70000","251","156","95"
"1969","Air Force (CO)","6","4","0","0.60000","267","177","90"
"1970","Air Force (CO)","9","3","0","0.75000","356","239","117"
"1971","Air Force (CO)","6","4","0","0.60000","187","187","0"
"1972","Air Force (CO)","6","4","0","0.60000","303","183","120"
"1973","Air Force (CO)","6","4","0","0.60000","223","239","-16"
"1974","Air Force (CO)","2","9","0","0.18182","178","215","-37"
"1975","Air Force (CO)","2","8","1","0.22727","156","265","-109"
"1976","Air Force (CO)","4","7","0","0.36364","180","273","-93"
"1977","Air Force (CO)","2","8","1","0.22727","114","296","-182"
"1958","Virginia","1","9","0","0.10000","89","301","-212"
"1959","Virginia","0","10","0","0.00000","80","393","-313"
"1960","Virginia","0","10","0","0.00000","103","332","-229"
"1960","George Washington (DC)","5","3","1","0.61111","128","111","17"
"1961","Virginia","4","6","0","0.40000","123","190","-67"
"1962","Virginia","5","5","0","0.50000","194","167","27"
"1963","Virginia","2","7","1","0.25000","76","169","-93"
"1964","Virginia","5","5","0","0.50000","163","214","-51"
"1965","Navy (MD)","4","4","2","0.50000","128","129","-1"
"1966","Navy (MD)","4","6","0","0.40000","147","152","-5"
"1967","Navy (MD)","5","4","1","0.55000","205","253","-48"
"1968","Navy (MD)","2","8","0","0.20000","136","303","-167"
"1948","Miami (OH)","7","1","1","0.83333","249","90","159"
"1955","Cincinnati (OH)","1","6","2","0.22222","97","199","-102"
"1956","Cincinnati (OH)","4","5","0","0.44444","156","140","16"
"1957","Cincinnati (OH)","5","4","1","0.55000","130","101","29"
"1958","Cincinnati (OH)","6","2","2","0.70000","139","104","35"
"1959","Cincinnati (OH)","5","4","1","0.55000","193","148","45"
"1960","Cincinnati (OH)","4","6","0","0.40000","113","150","-37"
"1965","Virginia","4","6","0","0.40000","170","189","-19"
"1966","Virginia","4","6","0","0.40000","214","235","-21"
"1967","Virginia","5","5","0","0.50000","172","169","3"
"1968","Virginia","7","3","0","0.70000","328","222","106"
"1969","Virginia","3","7","0","0.30000","115","170","-55"
"1970","Virginia","5","6","0","0.45455","240","187","53"
"1971","Virginia","3","8","0","0.27273","134","272","-138"
"1972","Virginia","4","7","0","0.36364","199","276","-77"
"1973","Virginia","4","7","0","0.36364","199","300","-101"
"1971","East Carolina (NC)","4","6","0","0.40000","181","300","-119"
"1972","East Carolina (NC)","9","2","0","0.81818","269","176","93"
"1973","East Carolina (NC)","9","2","0","0.81818","352","151","201"
"1974","Virginia","4","7","0","0.36364","207","239","-32"
"1975","Virginia","1","10","0","0.09091","175","428","-253"
"1979","Marshall (WV)","1","10","0","0.09091","95","309","-214"
"1980","Marshall (WV)","2","8","1","0.22727","137","245","-108"
"1981","Marshall (WV)","2","9","0","0.18182","104","284","-180"
"1982","Marshall (WV)","3","8","0","0.27273","117","279","-162"
"1983","Marshall (WV)","4","7","0","0.36364","209","214","-5"
"1976","Virginia","2","9","0","0.18182","106","266","-160"
"1977","Virginia","1","9","1","0.13636","56","280","-224"
"1978","Virginia","2","9","0","0.18182","139","236","-97"
"1979","Virginia","6","5","0","0.54545","258","134","124"
"1980","Virginia","4","7","0","0.36364","144","259","-115"
"1981","Virginia","1","10","0","0.09091","127","261","-134"
"1973","Navy (MD)","4","7","0","0.36364","221","232","-11"
"1974","Navy (MD)","4","7","0","0.36364","131","229","-98"
"1975","Navy (MD)","7","4","0","0.63636","227","125","102"
"1976","Navy (MD)","4","7","0","0.36364","187","257","-70"
"1977","Navy (MD)","5","6","0","0.45455","229","230","-1"
"1978","Navy (MD)","9","3","0","0.75000","260","136","124"
"1979","Navy (MD)","7","4","0","0.63636","180","154","26"
"1980","Navy (MD)","8","4","0","0.66667","226","146","80"
"1981","Navy (MD)","7","4","1","0.62500","244","183","61"
"1982","Virginia","2","9","0","0.18182","208","320","-112"
"1983","Virginia","6","5","0","0.54545","252","280","-28"
"1984","Virginia","8","2","2","0.75000","325","233","92"
"1985","Virginia","6","5","0","0.54545","262","217","45"
"1986","Virginia","3","8","0","0.27273","198","315","-117"
"1987","Virginia","8","4","0","0.66667","292","276","16"
"1988","Virginia","7","4","0","0.63636","251","244","7"
"1989","Virginia","10","3","0","0.76923","371","272","99"
"1990","Virginia","8","4","0","0.66667","464","227","237"
"1991","Virginia","8","3","1","0.70833","327","167","160"
"1992","Virginia","7","4","0","0.63636","341","229","112"
"1993","Virginia","7","5","0","0.58333","317","217","100"
"1994","Virginia","9","3","0","0.75000","370","195","175"
"1995","Virginia","9","4","0","0.69231","378","270","108"
"1996","Virginia","7","5","0","0.58333","341","203","138"
"1997","Virginia","7","4","0","0.63636","277","242","35"
"1998","Virginia","9","3","0","0.75000","358","247","111"
"1999","Virginia","7","5","0","0.58333","345","365","-20"
"2000","Virginia","6","6","0","0.50000","242","292","-50"
"1981","Wake Forest (NC)","4","7","0","0.36364","217","365","-148"
"1982","Wake Forest (NC)","3","8","0","0.27273","200","322","-122"
"1983","Wake Forest (NC)","4","7","0","0.36364","257","281","-24"
"1984","Wake Forest (NC)","6","5","0","0.54545","205","232","-27"
"1985","Wake Forest (NC)","4","7","0","0.36364","212","249","-37"
"1986","Wake Forest (NC)","5","6","0","0.45455","325","295","30"
"2001","Virginia","5","7","0","0.41667","249","331","-82"
"2002","Virginia","9","5","0","0.64286","402","348","54"
"2003","Virginia","8","5","0","0.61538","364","265","99"
"2004","Virginia","8","4","0","0.66667","363","212","151"
"2005","Virginia","7","5","0","0.58333","320","279","41"
"2006","Virginia","5","7","0","0.41667","181","214","-33"
"2007","Virginia","9","4","0","0.69231","317","256","61"
"2008","Virginia","5","7","0","0.41667","193","260","-67"
"2009","Virginia","3","9","0","0.25000","232","316","-84"
"2008","Richmond (VA)","13","3","0","0.81250","506","250","256"
"2009","Richmond (VA)","11","2","0","0.84615","389","212","177"
"2010","Virginia","4","8","0","0.33333","304","339","-35"
"2011","Virginia","8","5","0","0.61538","302","310","-8"
"2012","Virginia","4","8","0","0.33333","273","347","-74"
"2013","Virginia","2","10","0","0.16667","237","399","-162"
"1892","Virginia Tech","1","1","0","0.50000","14","22","-8"
"1893","Virginia Tech","0","2","0","0.00000","6","40","-34"
"1894","Virginia Tech","4","1","0","0.80000","112","10","102"
"1898","Virginia","6","6","0","0.50000","117","80","37"
"1895","Virginia Tech","4","2","0","0.66667","69","76","-7"
"1896","Virginia Tech","5","2","1","0.68750","158","50","108"
"1901","Ohio","6","3","2","0.63636","108","88","20"
"1897","Virginia Tech","5","2","0","0.71429","149","36","113"
"1898","Virginia Tech","3","2","0","0.60000","110","51","59"
"1898","Texas Christian","1","3","1","0.30000","41","61","-20"
"1899","Virginia Tech","4","1","0","0.80000","106","28","78"
"1900","Virginia Tech","3","3","1","0.50000","65","42","23"
"1901","Virginia Tech","6","1","0","0.85714","115","33","82"
"1902","Virginia Tech","3","2","1","0.58333","89","23","66"
"1904","North Carolina","5","2","2","0.66667","170","34","136"
"1905","Washington & Lee (VA)","7","2","0","0.77778","145","36","109"
"1906","Washington & Lee (VA)","4","1","1","0.75000","59","14","45"
"1907","Washington & Lee (VA)","3","2","1","0.58333","44","17","27"
"1908","Washington & Lee (VA)","5","1","1","0.78571","144","71","73"
"1909","Tulane (LA)","4","3","2","0.55556","40","50","-10"
"1923","New Mexico St.","9","0","0","1.00000","218","17","201"
"1924","New Mexico St.","7","3","0","0.70000","241","30","211"
"1925","New Mexico St.","5","3","1","0.61111","151","75","76"
"1903","Virginia Tech","5","1","0","0.83333","108","21","87"
"1908","West Virginia","5","3","0","0.62500","101","29","72"
"1909","West Virginia","4","3","2","0.55556","118","81","37"
"1910","West Virginia","2","4","1","0.35714","20","95","-75"
"1911","West Virginia","6","3","0","0.66667","91","67","24"
"1904","Virginia Tech","5","3","0","0.62500","121","27","94"
"1907","Dartmouth (NH)","8","0","1","0.94444","150","10","140"
"1908","Dartmouth (NH)","6","1","1","0.81250","97","17","80"
"1905","Virginia Tech","9","1","0","0.90000","305","24","281"
"1906","Virginia Tech","5","2","2","0.66667","74","15","59"
"1902","South Carolina","6","1","0","0.85714","195","16","179"
"1903","South Carolina","8","2","0","0.80000","239","35","204"
"1904","Davidson (NC)","6","1","1","0.81250","115","8","107"
"1905","Davidson (NC)","3","3","0","0.50000","93","28","65"
"1906","Clemson (SC)","4","0","3","0.78571","38","4","34"
"1907","Virginia Tech","7","2","0","0.77778","157","30","127"
"1909","Clemson (SC)","6","3","0","0.66667","93","43","50"
"1913","Clemson (SC)","4","4","0","0.50000","112","98","14"
"1914","Clemson (SC)","6","3","1","0.65000","197","123","74"
"1915","Clemson (SC)","2","4","2","0.37500","113","48","65"
"1908","Virginia Tech","5","4","0","0.55556","104","41","63"
"1911","Virginia Tech","6","1","2","0.77778","176","52","124"
"1908","Georgia","5","2","1","0.68750","71","45","26"
"1909","Virginia Tech","6","1","0","0.85714","148","27","121"
"1910","Virginia Tech","6","2","0","0.75000","109","18","91"
"1911","North Carolina","6","1","1","0.81250","66","31","35"
"1912","Virginia Tech","5","4","0","0.55556","202","92","110"
"1913","Virginia Tech","7","1","1","0.83333","175","60","115"
"1914","Virginia Tech","6","2","1","0.72222","143","33","110"
"1915","Virginia Tech","4","4","0","0.50000","91","109","-18"
"1920","Louisiana St.","5","3","1","0.61111","206","63","143"
"1921","Louisiana St.","6","1","1","0.81250","180","56","124"
"1925","South Carolina","7","3","0","0.70000","150","27","123"
"1926","South Carolina","6","4","0","0.60000","159","62","97"
"1928","William & Mary (VA)","6","3","2","0.63636","218","54","164"
"1929","William & Mary (VA)","8","2","0","0.80000","250","77","173"
"1930","William & Mary (VA)","7","2","1","0.75000","247","39","208"
"1936","William & Mary (VA)","1","8","0","0.11111","51","112","-61"
"1937","William & Mary (VA)","4","5","0","0.44444","129","103","26"
"1938","William & Mary (VA)","3","7","0","0.30000","105","154","-49"
"1911","Colgate (NY)","3","6","0","0.33333","61","103","-42"
"1916","Virginia Tech","7","2","0","0.77778","193","60","133"
"1917","Virginia Tech","6","2","1","0.72222","220","75","145"
"1918","Virginia Tech","7","0","0","1.00000","152","13","139"
"1919","Virginia Tech","5","4","0","0.55556","186","52","134"
"1920","Virginia Tech","4","6","0","0.40000","171","111","60"
"1921","Virginia Tech","7","3","0","0.70000","191","50","141"
"1922","Virginia Tech","8","1","1","0.85000","262","32","230"
"1923","Virginia Tech","6","3","0","0.66667","116","55","61"
"1924","Virginia Tech","4","2","3","0.61111","103","18","85"
"1925","Virginia Tech","5","3","2","0.60000","39","52","-13"
"1926","Virginia Tech","5","3","1","0.61111","134","80","54"
"1927","Virginia Tech","5","4","0","0.55556","125","48","77"
"1928","Virginia Tech","7","2","0","0.77778","198","92","106"
"1929","Virginia Tech","5","4","0","0.55556","170","128","42"
"1948","Miami (FL)","4","6","0","0.40000","154","179","-25"
"1949","Miami (FL)","6","3","0","0.66667","165","96","69"
"1950","Miami (FL)","9","1","1","0.86364","251","97","154"
"1951","Miami (FL)","8","3","0","0.72727","196","126","70"
"1952","Miami (FL)","4","7","0","0.36364","181","192","-11"
"1953","Miami (FL)","4","5","0","0.44444","155","137","18"
"1954","Miami (FL)","8","1","0","0.88889","257","94","163"
"1955","Miami (FL)","6","3","0","0.66667","181","81","100"
"1956","Miami (FL)","8","1","1","0.85000","161","53","108"
"1957","Miami (FL)","5","4","1","0.55000","161","103","58"
"1958","Miami (FL)","2","8","0","0.20000","88","195","-107"
"1959","Miami (FL)","6","4","0","0.60000","140","140","0"
"1960","Miami (FL)","6","4","0","0.60000","163","143","20"
"1961","Miami (FL)","7","4","0","0.63636","146","85","61"
"1962","Miami (FL)","7","4","0","0.63636","189","217","-28"
"1963","Miami (FL)","3","7","0","0.30000","116","174","-58"
"1930","Virginia Tech","5","3","1","0.61111","122","130","-8"
"1931","Virginia Tech","3","4","2","0.44444","76","104","-28"
"1932","Virginia Tech","8","1","0","0.88889","153","28","125"
"1933","Virginia Tech","4","3","3","0.55000","54","86","-32"
"1934","Virginia Tech","5","5","0","0.50000","95","113","-18"
"1935","Virginia Tech","4","3","2","0.55556","68","47","21"
"1936","Virginia Tech","5","5","0","0.50000","63","100","-37"
"1937","Virginia Tech","5","5","0","0.50000","117","116","1"
"1938","Virginia Tech","3","5","2","0.40000","75","86","-11"
"1939","Virginia Tech","4","5","1","0.45000","106","84","22"
"1940","Virginia Tech","5","5","0","0.50000","140","145","-5"
"1934","Rice (TX)","9","1","1","0.86364","204","44","160"
"1935","Rice (TX)","8","3","0","0.72727","201","95","106"
"1936","Rice (TX)","5","7","0","0.41667","127","108","19"
"1937","Rice (TX)","6","3","2","0.63636","117","94","23"
"1938","Rice (TX)","4","6","0","0.40000","91","133","-42"
"1939","Rice (TX)","1","9","1","0.13636","77","143","-66"
"1941","Virginia Tech","6","4","0","0.60000","112","120","-8"
"1946","Virginia Tech","3","4","3","0.45000","102","149","-47"
"1947","Virginia Tech","4","5","0","0.44444","162","191","-29"
"1942","Virginia Tech","7","2","1","0.75000","161","114","47"
"1945","Virginia Tech","2","6","0","0.25000","78","150","-72"
"1948","Virginia Tech","0","8","1","0.05556","28","209","-181"
"1949","Virginia Tech","1","7","2","0.20000","130","272","-142"
"1950","Virginia Tech","0","10","0","0.00000","72","430","-358"
"1951","Virginia Tech","2","8","0","0.20000","105","311","-206"
"1952","Virginia Tech","5","6","0","0.45455","155","221","-66"
"1953","Virginia Tech","5","5","0","0.50000","142","124","18"
"1954","Virginia Tech","8","0","1","0.94444","198","75","123"
"1955","Virginia Tech","6","3","1","0.65000","191","133","58"
"1956","Virginia Tech","7","2","1","0.75000","264","98","166"
"1957","Virginia Tech","4","6","0","0.40000","114","148","-34"
"1958","Virginia Tech","5","4","1","0.55000","165","196","-31"
"1959","Virginia Tech","6","4","0","0.60000","222","178","44"
"1960","Virginia Tech","6","4","0","0.60000","173","103","70"
"1961","Virginia Tech","4","5","0","0.44444","93","112","-19"
"1962","Virginia Tech","5","5","0","0.50000","137","137","0"
"1963","Virginia Tech","8","2","0","0.80000","216","126","90"
"1964","Virginia Tech","6","4","0","0.60000","224","178","46"
"1965","Virginia Tech","7","3","0","0.70000","188","134","54"
"1966","Virginia Tech","8","2","1","0.77273","245","104","141"
"1967","Virginia Tech","7","3","0","0.70000","183","112","71"
"1968","Virginia Tech","7","4","0","0.63636","240","165","75"
"1969","Virginia Tech","4","5","1","0.45000","234","110","124"
"1970","Virginia Tech","5","6","0","0.45455","199","228","-29"
"1972","Maryland","5","5","1","0.50000","243","217","26"
"1973","Maryland","8","4","0","0.66667","335","141","194"
"1974","Maryland","8","4","0","0.66667","316","104","212"
"1975","Maryland","9","2","1","0.79167","312","150","162"
"1976","Maryland","11","1","0","0.91667","294","115","179"
"1977","Maryland","8","4","0","0.66667","254","179","75"
"1978","Maryland","9","3","0","0.75000","261","167","94"
"1979","Maryland","7","4","0","0.63636","198","135","63"
"1980","Maryland","8","4","0","0.66667","211","165","46"
"1981","Maryland","4","6","1","0.40909","232","194","38"
"1982","Kentucky","0","10","1","0.04545","96","287","-191"
"1983","Kentucky","6","5","1","0.54167","228","237","-9"
"1984","Kentucky","9","3","0","0.75000","293","221","72"
"1985","Kentucky","5","6","0","0.45455","194","211","-17"
"1986","Kentucky","5","5","1","0.50000","228","207","21"
"1987","Kentucky","5","6","0","0.45455","258","187","71"
"1988","Kentucky","5","6","0","0.45455","217","208","9"
"1989","Kentucky","6","5","0","0.54545","212","220","-8"
"1971","Virginia Tech","4","7","0","0.36364","249","272","-23"
"1972","Virginia Tech","6","4","1","0.59091","307","253","54"
"1973","Virginia Tech","2","9","0","0.18182","223","380","-157"
"1974","Virginia Tech","4","7","0","0.36364","278","261","17"
"1975","Virginia Tech","8","3","0","0.72727","238","151","87"
"1976","Virginia Tech","6","5","0","0.54545","223","176","47"
"1977","Virginia Tech","3","7","1","0.31818","174","210","-36"
"1967","North Carolina","2","8","0","0.20000","104","182","-78"
"1968","North Carolina","3","7","0","0.30000","178","272","-94"
"1969","North Carolina","5","5","0","0.50000","200","164","36"
"1970","North Carolina","8","4","0","0.66667","372","227","145"
"1971","North Carolina","9","3","0","0.75000","288","152","136"
"1972","North Carolina","11","1","0","0.91667","324","210","114"
"1973","North Carolina","4","7","0","0.36364","242","266","-24"
"1974","North Carolina","7","5","0","0.58333","364","279","85"
"1975","North Carolina","3","7","1","0.31818","207","272","-65"
"1976","North Carolina","9","3","0","0.75000","243","220","23"
"1977","North Carolina","8","3","1","0.70833","251","102","149"
"1978","Virginia Tech","4","7","0","0.36364","162","225","-63"
"1979","Virginia Tech","5","6","0","0.45455","224","222","2"
"1980","Virginia Tech","8","4","0","0.66667","249","129","120"
"1981","Virginia Tech","7","4","0","0.63636","232","128","104"
"1982","Virginia Tech","7","4","0","0.63636","211","141","70"
"1983","Virginia Tech","9","2","0","0.81818","301","91","210"
"1984","Virginia Tech","8","4","0","0.66667","253","150","103"
"1985","Virginia Tech","6","5","0","0.54545","274","219","55"
"1986","Virginia Tech","10","1","1","0.87500","286","208","78"
"1987","Wake Forest (NC)","7","4","0","0.63636","201","185","16"
"1988","Wake Forest (NC)","6","4","1","0.59091","282","238","44"
"1989","Wake Forest (NC)","2","8","1","0.22727","194","319","-125"
"1990","Wake Forest (NC)","3","8","0","0.27273","247","351","-104"
"1991","Wake Forest (NC)","3","8","0","0.27273","195","300","-105"
"1992","Wake Forest (NC)","8","4","0","0.66667","266","260","6"
"1981","Murray St. (KY)","8","3","0","0.72727","229","160","69"
"1982","Murray St. (KY)","4","7","0","0.36364","143","162","-19"
"1983","Murray St. (KY)","7","4","0","0.63636","209","134","75"
"1984","Murray St. (KY)","9","2","0","0.81818","311","162","149"
"1985","Murray St. (KY)","7","3","1","0.68182","278","208","70"
"1986","Murray St. (KY)","7","4","1","0.62500","258","225","33"
"1987","Virginia Tech","2","9","0","0.18182","203","300","-97"
"1988","Virginia Tech","3","8","0","0.27273","176","264","-88"
"1989","Virginia Tech","6","4","1","0.59091","203","180","23"
"1990","Virginia Tech","6","5","0","0.54545","245","227","18"
"1991","Virginia Tech","5","6","0","0.45455","275","229","46"
"1992","Virginia Tech","2","8","1","0.22727","270","282","-12"
"1993","Virginia Tech","9","3","0","0.75000","445","270","175"
"1994","Virginia Tech","8","4","0","0.66667","327","247","80"
"1995","Virginia Tech","10","2","0","0.83333","349","165","184"
"1996","Virginia Tech","10","2","0","0.83333","370","209","161"
"1997","Virginia Tech","7","5","0","0.58333","324","227","97"
"1998","Virginia Tech","9","3","0","0.75000","381","149","232"
"1999","Virginia Tech","11","1","0","0.91667","484","162","322"
"2000","Virginia Tech","11","1","0","0.91667","484","269","215"
"2001","Virginia Tech","8","4","0","0.66667","376","177","199"
"2002","Virginia Tech","10","4","0","0.71429","429","263","166"
"2003","Virginia Tech","8","5","0","0.61538","460","299","161"
"2004","Virginia Tech","10","3","0","0.76923","400","167","233"
"2005","Virginia Tech","11","2","0","0.84615","440","168","272"
"2006","Virginia Tech","10","3","0","0.76923","336","143","193"
"2007","Virginia Tech","11","3","0","0.78571","402","225","177"
"2008","Virginia Tech","10","4","0","0.71429","309","234","75"
"2009","Virginia Tech","10","3","0","0.76923","414","203","211"
"2010","Virginia Tech","11","3","0","0.78571","474","288","186"
"2011","Virginia Tech","11","3","0","0.78571","391","247","144"
"2012","Virginia Tech","7","6","0","0.53846","326","297","29"
"2013","Virginia Tech","8","5","0","0.61538","293","251","42"
"1888","Wake Forest (NC)","1","0","0","1.00000","6","4","2"
"1888","Wake Forest (NC)","1","1","0","0.50000","32","33","-1"
"1889","Wake Forest (NC)","2","2","0","0.50000","58","76","-18"
"1898","North Carolina St.","1","1","0","0.50000","21","34","-13"
"1899","North Carolina St.","1","2","2","0.40000","29","55","-26"
"1891","Wake Forest (NC)","1","0","0","1.00000","4","6","-2"
"1892","Wake Forest (NC)","4","0","1","0.90000","94","18","76"
"1893","Wake Forest (NC)","1","2","0","0.33333","70","52","18"
"1872","Stevens Tech (NJ)","0","1","0","0.00000","0","6","-6"
"1873","New York (NY)","3","3","0","0.50000","15","13","2"
"1874","Stevens Tech (NJ)","2","3","0","0.40000","10","20","-10"
"1875","Stevens Tech (NJ)","4","4","0","0.50000","21","20","1"
"1876","New York (NY)","2","3","1","0.41667","16","19","-3"
"1877","Stevens Tech (NJ)","3","1","2","0.66667","9","14","-5"
"1878","Stevens Tech (NJ)","3","3","3","0.50000","3","9","-6"
"1879","Stevens Tech (NJ)","2","3","5","0.45000","8","14","-6"
"1880","Stevens Tech (NJ)","1","5","0","0.16667","3","16","-13"
"1881","Stevens Tech (NJ)","3","8","3","0.32143","16","29","-13"
"1882","Lawrence (WI)","7","8","1","0.46875","17","25","-8"
"1883","Stevens Tech (NJ)","7","6","1","0.53571","187","128","59"
"1884","Fordham (NY)","9","10","0","0.47368","221","261","-40"
"1885","Georgetown (DC)","5","17","1","0.23913","359","612","-253"
"1886","New York (NY)","9","15","2","0.38462","180","565","-385"
"1887","Fordham (NY)","8","12","1","0.40476","157","445","-288"
"1888","Amherst (MA)","6","17","3","0.28846","192","791","-599"
"1889","New York (NY)","8","21","4","0.30303","278","647","-369"
"1890","New York (NY)","25","14","2","0.63415","727","538","189"
"1891","Delaware","32","30","7","0.51449","966","971","-5"
"1892","Beloit (WI)","29","31","3","0.48413","726","797","-71"
"1893","Marquette (WI)","39","34","3","0.53289","1091","885","206"
"1894","Manhattan (NY)","32","29","7","0.52206","853","692","161"
"1895","Delaware","44","35","6","0.55294","889","813","76"
"1896","Manhattan (NY)","51","49","6","0.50943","949","1164","-215"
"1897","Stevens Tech (NJ)","37","50","4","0.42857","661","1048","-387"
"1898","Manhattan (NY)","37","43","9","0.46629","781","1050","-269"
"1899","Manhattan (NY)","34","40","6","0.46250","594","1063","-469"
"1900","Manhattan (NY)","43","47","11","0.48020","991","1049","-58"
"1901","Ferris St. (MI)","51","44","7","0.53431","906","852","54"
"1902","Indiana St.","56","48","5","0.53670","1053","927","126"
"1903","Manhattan (NY)","30","49","7","0.38953","762","1319","-557"
"1904","Saint Francis (NY)","44","53","9","0.45755","787","1363","-576"
"1905","Bluffton (OH)","38","59","5","0.39706","850","1433","-583"
"1906","Ferris St. (MI)","32","43","12","0.43678","677","854","-177"
"1907","Ferris St. (MI)","32","48","10","0.41111","722","1208","-486"
"1908","Western Illinois","36","45","10","0.45055","760","1069","-309"
"1909","Delaware Valley (PA)","27","52","2","0.34568","682","1287","-605"
"1910","East Stroudsburg (PA)","23","31","3","0.42982","583","738","-155"
"1911","Western Illinois","32","44","7","0.42771","661","902","-241"
"1912","Indiana (PA)","36","56","7","0.39899","1134","1463","-329"
"1913","Saint Francis (NY)","52","67","8","0.44094","1672","2360","-688"
"1914","Delaware Valley (PA)","41","50","6","0.45361","1217","1585","-368"
"1915","Western Illinois","34","35","11","0.49375","932","1217","-285"
"1916","Morgan St. (MD)","44","43","7","0.50532","1493","1270","223"
"1917","Morgan St. (MD)","21","21","2","0.50000","408","883","-475"
"1918","Oklahoma Baptist University","7","16","2","0.32000","258","358","-100"
"1919","Western Illinois","53","41","8","0.55882","1478","1056","422"
"1920","Virginia Union","28","39","2","0.42029","506","893","-387"
"1921","Cooper Union (NY)","19","34","3","0.36607","441","1112","-671"
"1922","Cooper Union (NY)","27","34","6","0.44776","703","832","-129"
"1923","Cooper Union (NY)","31","45","2","0.41026","718","1112","-394"
"1924","East Stroudsburg (PA)","34","40","6","0.46250","946","1175","-229"
"1925","Saint Anselm (NH)","32","28","10","0.52857","847","802","45"
"1926","Saint Anselm (NH)","22","30","4","0.42857","515","702","-187"
"1927","Bethune-Cookman (FL)","20","29","8","0.42105","674","783","-109"
"1928","Saint Anselm (NH)","28","24","7","0.53390","564","1095","-531"
"1929","Saint Anselm (NH)","25","32","5","0.44355","616","843","-227"
"1930","Saint Anselm (NH)","31","27","10","0.52941","643","549","94"
"1931","Campbell (NC)","21","17","4","0.54762","465","428","37"
"1932","Campbell (NC)","7","30","3","0.21250","254","760","-506"
"1933","Campbell (NC)","11","13","3","0.46296","262","324","-62"
"1934","Bowie St. (MD)","4","7","2","0.38462","116","94","22"
"1935","Florida Southern","7","12","1","0.37500","170","162","8"
"1936","Bowie St. (MD)","5","2","1","0.68750","154","97","57"
"1937","Bowie St. (MD)","6","3","0","0.66667","98","87","11"
"1938","West Alabama","7","5","0","0.58333","151","88","63"
"1939","Elizabeth City St. (NC)","7","13","0","0.35000","150","307","-157"
"1940","Elizabeth City St. (NC)","6","5","4","0.53333","128","67","61"
"1941","Arkansas-Pine Bluff","3","9","5","0.32353","178","223","-45"
"1942","Brevard College (NC)","10","6","2","0.61111","225","189","36"
"1943","Clark Atlanta (GA)","6","8","0","0.42857","127","206","-79"
"1944","Abilene Christian (TX)","9","11","1","0.45238","158","255","-97"
"1945","Benedict (SC)","10","15","2","0.40741","299","296","3"
"1946","Elizabeth City St. (NC)","7","20","3","0.28333","144","540","-396"
"1947","Clark Atlanta (GA)","3","6","2","0.36364","49","230","-181"
"1948","Virginia-Lynchburg","4","6","1","0.40909","77","302","-225"
"1949","Virginia-Lynchburg","0","3","1","0.12500","7","70","-63"
"1950","Virginia-Lynchburg","2","3","0","0.40000","53","98","-45"
"1951","Lane (TN)","8","6","0","0.57143","295","234","61"
"1952","Lane (TN)","9","5","1","0.63333","220","206","14"
"1953","Lane (TN)","1","7","0","0.12500","58","215","-157"
"1954","Lane (TN)","2","6","0","0.25000","105","135","-30"
"1955","Lane (TN)","2","4","0","0.33333","83","129","-46"
"1957","Louisiana College","2","7","0","0.22222","106","179","-73"
"1959","Azusa Pacific (CA)","2","3","0","0.40000","117","90","27"
"1960","Azusa Pacific (CA)","4","3","1","0.56250","103","76","27"
"1961","Azusa Pacific (CA)","3","3","0","0.50000","123","147","-24"
"1963","San Francisco (CA)","2","5","0","0.28571","58","98","-40"
"1964","New York (NY)","0","2","0","0.00000","20","48","-28"
"1965","Adelphi (NY)","4","8","0","0.33333","198","216","-18"
"1966","Fairfield (CT)","18","22","2","0.45238","545","652","-107"
"1967","La Salle (PA)","25","31","0","0.44643","846","1080","-234"
"1968","Centenary (LA)","17","42","2","0.29508","726","1393","-667"
"1969","Bluffton (OH)","33","43","0","0.43421","1058","1548","-490"
"1970","Saint John's (NY)","35","54","1","0.39444","1379","1783","-404"
"1971","Bluffton (OH)","43","45","1","0.48876","1360","1384","-24"
"1972","Marquette (WI)","39","44","2","0.47059","1217","1351","-134"
"1973","Brooklyn (NY)","30","52","1","0.36747","1007","1611","-604"
"1974","Marquette (WI)","33","36","3","0.47917","959","1169","-210"
"1975","Marquette (WI)","31","22","4","0.57895","1042","932","110"
"1976","Bluffton (OH)","23","33","1","0.41228","862","1186","-324"
"1977","Manhattan (NY)","14","28","1","0.33721","568","923","-355"
"1978","Fairfield (CT)","5","7","1","0.42308","194","203","-9"
"1979","Fairfield (CT)","7","8","0","0.46667","247","260","-13"
"1980","Westfield St. (MA)","6","5","4","0.53333","184","196","-12"
"1981","San Francisco (CA)","17","14","0","0.54839","567","498","69"
"1982","Manhattan (NY)","18","16","0","0.52941","580","644","-64"
"1983","SUNY-Stony Brook (NY)","15","11","0","0.57692","474","453","21"
"1984","Stonehill (MA)","7","12","0","0.36842","231","439","-208"
"1985","Manhattan (NY)","10","10","0","0.50000","313","316","-3"
"1986","Marquette (WI)","13","17","0","0.43333","497","564","-67"
"1987","Marquette (WI)","10","17","0","0.37037","389","487","-98"
"1988","Marquette (WI)","1","5","0","0.16667","80","125","-45"
"1989","Marquette (WI)","4","4","0","0.50000","209","151","58"
"1990","Marquette (WI)","1","7","0","0.12500","80","180","-100"
"1991","Marquette (WI)","1","5","0","0.16667","106","182","-76"
"1992","Marquette (WI)","2","5","0","0.28571","81","129","-48"
"1993","Marquette (WI)","7","1","0","0.87500","212","126","86"
"1994","Marquette (WI)","1","6","0","0.14286","125","184","-59"
"1995","Marquette (WI)","3","4","0","0.42857","141","191","-50"
"1996","Marquette (WI)","3","5","0","0.37500","139","182","-43"
"1998","Madison College (WI)","2","15","0","0.11765","221","613","-392"
"1999","Marquette (WI)","0","7","0","0.00000","110","298","-188"
"2000","Marquette (WI)","1","5","0","0.16667","60","96","-36"
"2001","Marquette (WI)","2","6","0","0.25000","144","179","-35"
"2002","Marquette (WI)","3","4","0","0.42857","127","208","-81"
"2003","Marquette (WI)","1","6","0","0.14286","71","151","-80"
"2004","Marquette (WI)","0","6","0","0.00000","53","238","-185"
"2005","Marquette (WI)","2","5","0","0.28571","92","226","-134"
"2006","Marquette (WI)","1","6","0","0.14286","62","206","-144"
"2007","Marquette (WI)","2","5","0","0.28571","140","215","-75"
"2008","Marquette (WI)","0","7","0","0.00000","61","304","-243"
"2009","Marquette (WI)","0","1","0","0.00000","0","22","-22"
"1908","Wake Forest (NC)","1","4","0","0.20000","25","149","-124"
"1909","Wake Forest (NC)","2","4","0","0.33333","11","45","-34"
"1909","Elon (NC)","4","2","1","0.64286","77","90","-13"
"1910","Wake Forest (NC)","2","7","0","0.22222","53","154","-101"
"1911","Wake Forest (NC)","3","5","0","0.37500","159","81","78"
"1912","Wake Forest (NC)","2","6","0","0.25000","108","87","21"
"1913","Wake Forest (NC)","0","8","0","0.00000","30","200","-170"
"1914","Wake Forest (NC)","3","6","0","0.33333","86","221","-135"
"1915","Wake Forest (NC)","3","4","0","0.42857","161","90","71"
"1916","Wake Forest (NC)","3","3","0","0.50000","107","85","22"
"1914","Louisiana St.","4","4","1","0.50000","163","148","15"
"1915","Louisiana St.","6","2","0","0.75000","126","49","77"
"1916","Louisiana St.","4","1","0","0.80000","146","14","132"
"1917","Wake Forest (NC)","1","6","1","0.18750","59","215","-156"
"1918","Wake Forest (NC)","1","3","0","0.25000","40","59","-19"
"1919","Wake Forest (NC)","2","6","0","0.25000","118","143","-25"
"1920","Wake Forest (NC)","2","7","0","0.22222","98","190","-92"
"1921","Wake Forest (NC)","2","8","0","0.20000","66","222","-156"
"1907","Tennessee","7","2","1","0.75000","169","17","152"
"1908","Tennessee","7","2","0","0.77778","124","41","83"
"1909","Tennessee","1","6","2","0.22222","11","113","-102"
"1922","Wake Forest (NC)","3","5","2","0.40000","62","144","-82"
"1923","Wake Forest (NC)","6","3","0","0.66667","125","64","61"
"1924","Wake Forest (NC)","7","2","0","0.77778","206","62","144"
"1925","Wake Forest (NC)","6","2","1","0.72222","185","40","145"
"1919","Maine","6","1","0","0.85714","213","26","187"
"1920","Maine","3","3","3","0.50000","122","142","-20"
"1921","Duke (NC)","6","1","2","0.77778","147","32","115"
"1922","Lehigh (PA)","3","5","1","0.38889","84","79","5"
"1923","Lehigh (PA)","6","2","1","0.72222","107","57","50"
"1924","Lehigh (PA)","4","1","3","0.68750","62","36","26"
"1926","Wake Forest (NC)","5","4","1","0.55000","186","46","140"
"1927","Wake Forest (NC)","2","6","2","0.30000","64","222","-158"
"1928","Wake Forest (NC)","2","6","2","0.30000","64","203","-139"
"1929","Wake Forest (NC)","6","5","1","0.54167","108","155","-47"
"1930","Wake Forest (NC)","5","3","1","0.61111","125","77","48"
"1931","Wake Forest (NC)","4","4","0","0.50000","44","138","-94"
"1932","Wake Forest (NC)","3","3","2","0.50000","39","36","3"
"1933","Wake Forest (NC)","0","5","1","0.08333","13","93","-80"
"1934","Wake Forest (NC)","3","7","0","0.30000","118","141","-23"
"1935","Wake Forest (NC)","2","7","0","0.22222","52","106","-54"
"1936","Wake Forest (NC)","5","4","0","0.55556","110","72","38"
"1926","Atlantic Christian (NC)","6","1","1","0.81250","139","7","132"
"1927","Elon (NC)","3","4","1","0.43750","64","104","-40"
"1928","Elon (NC)","2","7","0","0.22222","59","237","-178"
"1929","Elon (NC)","5","3","0","0.62500","130","92","38"
"1930","Elon (NC)","6","3","0","0.66667","178","112","66"
"1931","Elon (NC)","3","5","0","0.37500","106","128","-22"
"1932","Elon (NC)","2","6","0","0.25000","46","113","-67"
"1933","Elon (NC)","5","3","1","0.61111","151","81","70"
"1934","Elon (NC)","6","2","1","0.72222","133","51","82"
"1935","Elon (NC)","6","3","0","0.66667","168","29","139"
"1936","Elon (NC)","6","5","0","0.54545","204","158","46"
"1937","Wake Forest (NC)","3","6","0","0.33333","68","220","-152"
"1938","Wake Forest (NC)","4","5","1","0.45000","161","98","63"
"1939","Wake Forest (NC)","7","3","0","0.70000","257","89","168"
"1940","Wake Forest (NC)","7","3","0","0.70000","193","113","80"
"1941","Wake Forest (NC)","5","5","1","0.50000","218","168","50"
"1942","Wake Forest (NC)","6","2","1","0.72222","134","66","68"
"1943","Wake Forest (NC)","4","5","0","0.44444","165","101","64"
"1944","Wake Forest (NC)","8","1","0","0.88889","178","75","103"
"1945","Wake Forest (NC)","5","3","1","0.61111","163","151","12"
"1946","Wake Forest (NC)","6","3","0","0.66667","156","92","64"
"1947","Wake Forest (NC)","6","4","0","0.60000","133","101","32"
"1948","Wake Forest (NC)","6","4","0","0.60000","224","168","56"
"1949","Wake Forest (NC)","4","6","0","0.40000","207","183","24"
"1950","Wake Forest (NC)","6","1","2","0.77778","168","47","121"
"1951","Wake Forest (NC)","6","4","0","0.60000","200","142","58"
"1952","Wake Forest (NC)","5","4","1","0.55000","162","133","29"
"1953","Wake Forest (NC)","3","6","1","0.35000","114","157","-43"
"1954","Wake Forest (NC)","2","7","1","0.25000","129","165","-36"
"1955","Wake Forest (NC)","5","4","1","0.55000","131","153","-22"
"1956","Wake Forest (NC)","2","5","3","0.35000","91","102","-11"
"1957","Wake Forest (NC)","0","10","0","0.00000","64","225","-161"
"1958","Wake Forest (NC)","3","7","0","0.30000","124","163","-39"
"1959","Wake Forest (NC)","6","4","0","0.60000","218","178","40"
"1960","Wake Forest (NC)","2","8","0","0.20000","119","215","-96"
"1961","Wake Forest (NC)","4","6","0","0.40000","103","159","-56"
"1962","Wake Forest (NC)","0","10","0","0.00000","66","278","-212"
"1963","Wake Forest (NC)","1","9","0","0.10000","37","318","-281"
"1964","Wake Forest (NC)","5","5","0","0.50000","172","178","-6"
"1965","Wake Forest (NC)","3","7","0","0.30000","88","204","-116"
"1966","Wake Forest (NC)","3","7","0","0.30000","90","162","-72"
"1967","Wake Forest (NC)","4","6","0","0.40000","175","256","-81"
"1968","Wake Forest (NC)","2","7","1","0.25000","212","228","-16"
"1969","Wake Forest (NC)","3","7","0","0.30000","125","279","-154"
"1970","Wake Forest (NC)","6","5","0","0.54545","191","241","-50"
"1971","Wake Forest (NC)","6","5","0","0.54545","218","178","40"
"1972","Minnesota","4","7","0","0.36364","185","304","-119"
"1973","Minnesota","7","4","0","0.63636","260","295","-35"
"1974","Minnesota","4","7","0","0.36364","161","332","-171"
"1975","Minnesota","6","5","0","0.54545","236","192","44"
"1976","Minnesota","6","5","0","0.54545","201","211","-10"
"1977","Minnesota","7","5","0","0.58333","171","180","-9"
"1978","Minnesota","5","6","0","0.45455","210","267","-57"
"1972","Wake Forest (NC)","2","9","0","0.18182","88","339","-251"
"1962","Indiana (PA)","5","2","1","0.68750","121","56","65"
"1963","Indiana (PA)","7","1","1","0.83333","207","77","130"
"1964","Merchant Marine (NY)","3","7","0","0.30000","107","208","-101"
"1967","Utah St.","7","2","1","0.75000","205","143","62"
"1968","Utah St.","7","3","0","0.70000","247","142","105"
"1969","Utah St.","3","7","0","0.30000","134","250","-116"
"1970","Utah St.","5","5","0","0.50000","217","225","-8"
"1971","Utah St.","8","3","0","0.72727","243","183","60"
"1972","Utah St.","8","3","0","0.72727","329","230","99"
"1973","Wake Forest (NC)","1","9","1","0.13636","73","326","-253"
"1974","Wake Forest (NC)","1","10","0","0.09091","74","348","-274"
"1975","Wake Forest (NC)","3","8","0","0.27273","221","264","-43"
"1976","Wake Forest (NC)","5","6","0","0.45455","177","206","-29"
"1977","Wake Forest (NC)","1","10","0","0.09091","113","270","-157"
"1980","Southern Oregon","3","7","0","0.30000","138","223","-85"
"1981","Southern Oregon","6","4","0","0.60000","169","182","-13"
"1982","Southern Oregon","6","4","0","0.60000","234","157","77"
"1983","Southern Oregon","9","2","0","0.81818","342","204","138"
"1984","Southern Oregon","0","10","0","0.00000","226","186","40"
"1985","Southern Oregon","3","6","1","0.35000","170","238","-68"
"1986","Southern Oregon","5","5","0","0.50000","129","161","-32"
"1987","Southern Oregon","7","5","0","0.58333","253","258","-5"
"1988","Southern Oregon","5","4","0","0.55556","223","237","-14"
"1997","Coast Guard (CT)","9","2","0","0.81818","256","169","87"
"1978","Wake Forest (NC)","1","10","0","0.09091","104","274","-170"
"1979","Wake Forest (NC)","8","4","0","0.66667","240","283","-43"
"1980","Wake Forest (NC)","5","6","0","0.45455","251","213","38"
"1988","Illinois","6","5","1","0.54167","245","243","2"
"1989","Illinois","10","2","0","0.83333","332","182","150"
"1990","Illinois","8","4","0","0.66667","293","246","47"
"1991","Illinois","6","5","0","0.54545","261","182","79"
"1992","Texas","6","5","0","0.54545","292","282","10"
"1993","Texas","5","5","1","0.50000","281","269","12"
"1994","Texas","8","4","0","0.66667","366","291","75"
"1995","Texas","10","2","1","0.80769","390","255","135"
"1996","Texas","8","5","0","0.61538","447","305","142"
"1997","Texas","4","7","0","0.36364","283","366","-83"
"2001","Arizona","5","6","0","0.45455","320","377","-57"
"2002","Arizona","4","8","0","0.33333","227","310","-83"
"2003","Arizona","1","4","0","0.20000","82","186","-104"
"1981","Wake Forest (NC)","4","7","0","0.36364","217","365","-148"
"1982","Wake Forest (NC)","3","8","0","0.27273","200","322","-122"
"1983","Wake Forest (NC)","4","7","0","0.36364","257","281","-24"
"1984","Wake Forest (NC)","6","5","0","0.54545","205","232","-27"
"1985","Wake Forest (NC)","4","7","0","0.36364","212","249","-37"
"1986","Wake Forest (NC)","5","6","0","0.45455","325","295","30"
"2001","Virginia","5","7","0","0.41667","249","331","-82"
"2002","Virginia","9","5","0","0.64286","402","348","54"
"2003","Virginia","8","5","0","0.61538","364","265","99"
"2004","Virginia","8","4","0","0.66667","363","212","151"
"2005","Virginia","7","5","0","0.58333","320","279","41"
"2006","Virginia","5","7","0","0.41667","181","214","-33"
"2007","Virginia","9","4","0","0.69231","317","256","61"
"2008","Virginia","5","7","0","0.41667","193","260","-67"
"2009","Virginia","3","9","0","0.25000","232","316","-84"
"1967","North Carolina","2","8","0","0.20000","104","182","-78"
"1968","North Carolina","3","7","0","0.30000","178","272","-94"
"1969","North Carolina","5","5","0","0.50000","200","164","36"
"1970","North Carolina","8","4","0","0.66667","372","227","145"
"1971","North Carolina","9","3","0","0.75000","288","152","136"
"1972","North Carolina","11","1","0","0.91667","324","210","114"
"1973","North Carolina","4","7","0","0.36364","242","266","-24"
"1974","North Carolina","7","5","0","0.58333","364","279","85"
"1975","North Carolina","3","7","1","0.31818","207","272","-65"
"1976","North Carolina","9","3","0","0.75000","243","220","23"
"1977","North Carolina","8","3","1","0.70833","251","102","149"
"1978","Virginia Tech","4","7","0","0.36364","162","225","-63"
"1979","Virginia Tech","5","6","0","0.45455","224","222","2"
"1980","Virginia Tech","8","4","0","0.66667","249","129","120"
"1981","Virginia Tech","7","4","0","0.63636","232","128","104"
"1982","Virginia Tech","7","4","0","0.63636","211","141","70"
"1983","Virginia Tech","9","2","0","0.81818","301","91","210"
"1984","Virginia Tech","8","4","0","0.66667","253","150","103"
"1985","Virginia Tech","6","5","0","0.54545","274","219","55"
"1986","Virginia Tech","10","1","1","0.87500","286","208","78"
"1987","Wake Forest (NC)","7","4","0","0.63636","201","185","16"
"1988","Wake Forest (NC)","6","4","1","0.59091","282","238","44"
"1989","Wake Forest (NC)","2","8","1","0.22727","194","319","-125"
"1990","Wake Forest (NC)","3","8","0","0.27273","247","351","-104"
"1991","Wake Forest (NC)","3","8","0","0.27273","195","300","-105"
"1992","Wake Forest (NC)","8","4","0","0.66667","266","260","6"
"1993","Wake Forest (NC)","2","9","0","0.18182","199","318","-119"
"1994","Wake Forest (NC)","3","8","0","0.27273","143","373","-230"
"1995","Wake Forest (NC)","1","10","0","0.09091","190","360","-170"
"1996","Wake Forest (NC)","3","8","0","0.27273","144","374","-230"
"1997","Wake Forest (NC)","5","6","0","0.45455","245","288","-43"
"1998","Wake Forest (NC)","3","8","0","0.27273","235","335","-100"
"1999","Wake Forest (NC)","7","5","0","0.58333","266","209","57"
"2000","Wake Forest (NC)","2","9","0","0.18182","181","362","-181"
"1995","Ohio","2","8","1","0.22727","161","320","-159"
"1996","Ohio","6","6","0","0.50000","302","237","65"
"1997","Ohio","8","3","0","0.72727","301","177","124"
"1998","Ohio","5","6","0","0.45455","269","303","-34"
"1999","Ohio","5","6","0","0.45455","271","287","-16"
"2000","Ohio","7","4","0","0.63636","343","208","135"
"2001","Wake Forest (NC)","6","5","0","0.54545","292","311","-19"
"2002","Wake Forest (NC)","7","6","0","0.53846","356","327","29"
"2003","Wake Forest (NC)","5","7","0","0.41667","335","347","-12"
"2004","Wake Forest (NC)","4","7","0","0.36364","230","253","-23"
"2005","Wake Forest (NC)","4","7","0","0.36364","269","316","-47"
"2006","Wake Forest (NC)","11","3","0","0.78571","302","215","87"
"2007","Wake Forest (NC)","9","4","0","0.69231","362","289","73"
"2008","Wake Forest (NC)","8","5","0","0.61538","273","238","35"
"2009","Wake Forest (NC)","5","7","0","0.41667","316","315","1"
"2010","Wake Forest (NC)","3","9","0","0.25000","273","430","-157"
"2011","Wake Forest (NC)","6","7","0","0.46154","338","356","-18"
"2012","Wake Forest (NC)","5","7","0","0.41667","222","382","-160"
"2013","Wake Forest (NC)","4","8","0","0.33333","220","289","-69"
"1869","Rutgers (NJ)","2","2","0","0.50000","18","18","0"
"1870","Rutgers (NJ)","2","2","0","0.50000","17","17","0"
"1872","Columbia (NY)","5","4","0","0.55556","22","16","6"
"1873","Rutgers (NJ)","7","4","1","0.62500","31","26","5"
"1874","Harvard (MA)","9","7","0","0.56250","54","41","13"
"1875","Harvard (MA)","12","6","2","0.65000","52","29","23"
"1876","Harvard (MA)","13","8","1","0.61364","45","29","16"
"1877","Harvard (MA)","9","7","3","0.55263","31","21","10"
"1878","Pennsylvania","14","9","5","0.58929","42","24","18"
"1879","Harvard (MA)","13","9","12","0.55882","46","27","19"
"1880","Harvard (MA)","18","11","4","0.60606","75","53","22"
"1881","Rutgers (NJ)","22","18","8","0.54167","70","47","23"
"1882","Rutgers (NJ)","41","28","2","0.59155","176","111","65"
"1883","Rutgers (NJ)","38","32","1","0.54225","1288","965","323"
"1884","Pennsylvania","47","29","5","0.61111","1728","1184","544"
"1885","Michigan","34","17","4","0.65455","1437","612","825"
"1886","Lehigh (PA)","48","21","4","0.68493","1850","637","1213"
"1887","California","67","35","3","0.65238","2660","935","1725"
"1888","Princeton (NJ)","70","56","6","0.55303","2468","1899","569"
"1889","Brown (RI)","82","51","11","0.60764","2879","1796","1083"
"1890","Brown (RI)","77","76","9","0.50309","3002","2455","547"
"1891","Southern California","94","76","13","0.54918","2813","2189","624"
"1892","Minnesota","93","80","9","0.53571","2972","2394","578"
"1893","Duke (NC)","79","94","9","0.45879","2176","2912","-736"
"1894","Colorado St.","50","62","4","0.44828","1161","1518","-357"
"1895","Boston (MA)","31","44","11","0.42442","692","1031","-339"
"1896","Rhode Island","54","62","12","0.46875","1126","1201","-75"
"1897","Boston (MA)","32","40","6","0.44872","792","785","7"
"1898","Miami (OH)","47","23","4","0.66216","921","644","277"
"1899","New Hampshire","33","32","6","0.50704","571","522","49"
"1900","New Hampshire","22","35","11","0.40441","442","686","-244"
"1901","Marshall (WV)","18","34","3","0.35455","302","917","-615"
"1902","Saint John's (MN)","9","22","4","0.31429","148","460","-312"
"1903","Wichita St. (KS)","14","25","2","0.36585","376","546","-170"
"1904","Oklahoma St.","11","14","1","0.44231","194","394","-200"
"1905","Miami (OH)","7","25","5","0.25676","245","494","-249"
"1906","Rensselaer Tech (NY)","3","7","4","0.35714","92","107","-15"
"1907","Marshall (WV)","5","10","2","0.35294","71","238","-167"
"1908","Fort Hays St. (KS)","5","6","1","0.45833","56","91","-35"
"1909","Fort Hays St. (KS)","1","3","1","0.30000","12","68","-56"
"1910","Texas St.","0","1","0","0.00000","0","19","-19"
"1912","Fort Hays St. (KS)","1","2","0","0.33333","20","132","-112"
"1913","Eureka (IL)","1","6","0","0.14286","39","203","-164"
"1914","Eureka (IL)","3","4","0","0.42857","57","201","-144"
"1915","Texas St.","1","1","1","0.50000","13","20","-7"
"1916","Texas St.","0","2","1","0.16667","0","106","-106"
"1917","Boston (MA)","4","4","0","0.50000","73","136","-63"
"1918","Monmouth (IL)","1","7","0","0.12500","26","137","-111"
"1930","Troy (AL)","1","2","0","0.33333","7","73","-66"
"2013","Grambling St. (LA)","0","1","0","0.00000","0","0","0"
"1892","Washington","1","1","0","0.50000","14","28","-14"
"1893","Washington","1","3","1","0.30000","18","86","-68"
"1894","Washington","1","1","1","0.50000","60","38","22"
"1895","Washington","4","0","1","0.90000","98","8","90"
"1896","Washington","2","3","0","0.40000","20","40","-20"
"1898","Washington","1","1","0","0.50000","24","18","6"
"1897","Washington","1","2","0","0.33333","16","26","-10"
"1902","Stanford (CA)","6","1","0","0.85714","111","37","74"
"1899","Washington","4","1","1","0.75000","71","21","50"
"1900","Washington","1","2","2","0.40000","27","71","-44"
"1901","Washington","3","3","0","0.50000","43","42","1"
"1903","Kentucky","7","1","0","0.87500","204","22","182"
"1902","Washington","5","1","0","0.83333","65","17","48"
"1903","Washington","6","1","0","0.85714","63","11","52"
"1904","Washington","4","2","1","0.64286","113","66","47"
"1903","Purdue (IN)","4","2","0","0.66667","87","48","39"
"1904","Purdue (IN)","9","3","0","0.75000","176","66","110"
"1905","Washington","5","2","2","0.66667","96","52","44"
"1906","Washington","4","1","4","0.66667","49","35","14"
"1907","Washington","4","4","2","0.50000","96","48","48"
"1908","Notre Dame (IN)","8","1","0","0.88889","326","20","306"
"1906","North Dakota St.","5","0","0","1.00000","236","4","232"
"1907","North Dakota St.","3","0","0","1.00000","164","10","154"
"1908","Washington","6","0","1","0.92857","128","15","113"
"1909","Washington","7","0","0","1.00000","214","6","208"
"1910","Washington","6","0","0","1.00000","150","8","142"
"1911","Washington","7","0","0","1.00000","277","9","268"
"1912","Washington","6","0","0","1.00000","190","17","173"
"1913","Washington","7","0","0","1.00000","266","20","246"
"1914","Washington","6","0","1","0.92857","242","13","229"
"1915","Washington","7","0","0","1.00000","274","14","260"
"1916","Washington","6","0","1","0.92857","189","16","173"
"1917","Navy (MD)","7","1","0","0.87500","442","23","419"
"1918","Navy (MD)","4","1","0","0.80000","283","20","263"
"1919","Navy (MD)","7","1","0","0.87500","298","18","280"
"1920","Cornell (NY)","6","2","0","0.75000","231","68","163"
"1921","Cornell (NY)","8","0","0","1.00000","392","21","371"
"1922","Cornell (NY)","8","0","0","1.00000","339","27","312"
"1923","Cornell (NY)","8","0","0","1.00000","320","33","287"
"1924","Cornell (NY)","4","4","0","0.50000","209","71","138"
"1925","Cornell (NY)","6","2","0","0.75000","258","83","175"
"1926","Cornell (NY)","6","1","1","0.81250","191","64","127"
"1927","Cornell (NY)","3","3","2","0.50000","136","121","15"
"1928","Cornell (NY)","3","3","2","0.50000","72","86","-14"
"1929","Cornell (NY)","6","2","0","0.75000","204","60","144"
"1930","Cornell (NY)","6","2","0","0.75000","273","63","210"
"1931","Cornell (NY)","7","1","0","0.87500","239","20","219"
"1932","Cornell (NY)","5","2","1","0.68750","174","39","135"
"1933","Cornell (NY)","4","3","0","0.57143","116","89","27"
"1934","Cornell (NY)","2","5","0","0.28571","55","114","-59"
"1935","Cornell (NY)","0","6","1","0.07143","59","201","-142"
"1936","Boston College (MA)","6","1","2","0.77778","109","55","54"
"1937","Boston College (MA)","4","4","1","0.50000","109","68","41"
"1938","Boston College (MA)","6","1","2","0.77778","186","87","99"
"1918","Washington","1","1","0","0.50000","6","7","-1"
"1919","New Mexico St.","2","3","1","0.41667","83","69","14"
"1917","Washington","1","2","1","0.37500","14","47","-33"
"1919","Washington","5","1","0","0.83333","202","31","171"
"1920","Washington","1","5","0","0.16667","54","83","-29"
"1922","South Dakota","3","6","1","0.35000","69","167","-98"
"1923","South Dakota","4","3","1","0.56250","119","59","60"
"1924","South Dakota","6","2","0","0.75000","108","51","57"
"1925","South Dakota","3","5","0","0.37500","93","39","54"
"1926","South Dakota","5","3","1","0.61111","90","76","14"
"1935","California","9","1","0","0.90000","163","22","141"
"1936","California","6","5","0","0.54545","147","74","73"
"1937","California","10","0","1","0.95455","214","33","181"
"1938","California","10","1","0","0.90909","219","44","175"
"1939","California","3","7","0","0.30000","93","134","-41"
"1940","California","4","6","0","0.40000","84","128","-44"
"1941","California","4","5","0","0.44444","107","71","36"
"1942","California","5","5","0","0.50000","98","107","-9"
"1943","California","4","6","0","0.40000","99","143","-44"
"1944","California","3","6","1","0.35000","78","149","-71"
"1921","Washington","3","4","1","0.43750","69","145","-76"
"1922","Washington","6","1","1","0.81250","129","72","57"
"1923","Washington","10","1","1","0.87500","298","58","240"
"1924","Washington","8","1","1","0.85000","355","24","331"
"1925","Washington","10","1","1","0.87500","480","59","421"
"1926","Washington","8","2","0","0.80000","213","60","153"
"1927","Washington","9","2","0","0.81818","287","59","228"
"1928","Washington","7","4","0","0.63636","188","74","114"
"1929","Washington","2","6","1","0.27778","145","127","18"
"1920","Missouri","7","1","0","0.87500","156","61","95"
"1921","Missouri","6","2","0","0.75000","136","50","86"
"1922","Purdue (IN)","1","5","1","0.21429","36","126","-90"
"1923","Purdue (IN)","2","5","1","0.31250","65","106","-41"
"1924","Purdue (IN)","5","2","0","0.71429","137","46","91"
"1925","Purdue (IN)","3","4","1","0.43750","119","39","80"
"1926","Purdue (IN)","5","2","1","0.68750","146","67","79"
"1927","Purdue (IN)","6","2","0","0.75000","170","38","132"
"1928","Purdue (IN)","5","2","1","0.68750","143","41","102"
"1929","Purdue (IN)","8","0","0","1.00000","187","44","143"
"1930","Washington","5","4","0","0.55556","182","67","115"
"1931","Washington","5","3","1","0.61111","166","83","83"
"1932","Washington","6","2","2","0.70000","193","56","137"
"1933","Washington","5","4","0","0.55556","88","81","7"
"1934","Washington","6","1","1","0.81250","104","51","53"
"1935","Washington","5","3","0","0.62500","93","42","51"
"1936","Washington","7","2","1","0.75000","148","56","92"
"1937","Washington","7","2","2","0.72727","187","52","135"
"1938","Washington","3","5","1","0.38889","68","83","-15"
"1939","Washington","4","5","0","0.44444","77","93","-16"
"1940","Washington","7","2","0","0.77778","169","54","115"
"1941","Washington","5","4","0","0.55556","120","94","26"
"1942","Saint Mary's (CA)","6","3","1","0.65000","135","46","89"
"1943","Saint Mary's (CA)","2","5","0","0.28571","93","126","-33"
"1944","Saint Mary's (CA)","0","5","0","0.00000","14","148","-134"
"1945","Saint Mary's (CA)","7","2","0","0.77778","282","65","217"
"1946","Saint Mary's (CA)","6","3","0","0.66667","229","160","69"
"1947","Saint Mary's (CA)","3","7","0","0.30000","178","246","-68"
"1942","Washington","4","3","3","0.55000","113","60","53"
"1943","Washington","4","1","0","0.80000","150","61","89"
"1944","Washington","5","3","0","0.62500","293","132","161"
"1945","Washington","6","3","0","0.66667","91","54","37"
"1946","Washington","5","4","0","0.55556","144","140","4"
"1947","Washington","3","6","0","0.33333","98","99","-1"
"1942","Yale (CT)","5","3","0","0.62500","116","83","33"
"1943","Yale (CT)","4","5","0","0.44444","132","166","-34"
"1944","Yale (CT)","7","0","1","0.93750","120","32","88"
"1945","Yale (CT)","6","3","0","0.66667","160","102","58"
"1946","Yale (CT)","7","1","1","0.83333","272","72","200"
"1947","Yale (CT)","6","3","0","0.66667","182","101","81"
"1948","Washington","2","7","1","0.25000","89","189","-100"
"1949","Washington","3","7","0","0.30000","167","285","-118"
"1950","Washington","8","2","0","0.80000","265","134","131"
"1951","Washington","3","6","1","0.35000","273","218","55"
"1952","Washington","7","3","0","0.70000","248","201","47"
"1953","Washington","3","6","1","0.35000","154","217","-63"
"1954","Washington","2","8","0","0.20000","78","215","-137"
"1955","Washington","5","4","1","0.55000","141","93","48"
"1954","Mississippi St.","6","4","0","0.60000","192","120","72"
"1955","Mississippi St.","6","4","0","0.60000","173","142","31"
"1956","Washington","5","5","0","0.50000","232","206","26"
"1957","Texas","6","4","1","0.59091","159","149","10"
"1958","Texas","7","3","0","0.70000","157","152","5"
"1959","Texas","9","2","0","0.81818","216","96","120"
"1960","Texas","7","3","1","0.68182","167","78","89"
"1961","Texas","10","1","0","0.90909","303","66","237"
"1962","Texas","9","1","1","0.86364","184","72","112"
"1963","Texas","11","0","0","1.00000","243","71","172"
"1964","Texas","10","1","0","0.90909","220","81","139"
"1965","Texas","6","4","0","0.60000","231","153","78"
"1966","Texas","7","4","0","0.63636","194","111","83"
"1967","Texas","6","4","0","0.60000","186","123","63"
"1968","Texas","9","1","1","0.86364","379","198","181"
"1969","Texas","11","0","0","1.00000","435","119","316"
"1970","Texas","10","1","0","0.90909","423","149","274"
"1971","Texas","8","3","0","0.72727","281","168","113"
"1972","Texas","10","1","0","0.90909","271","121","150"
"1973","Texas","8","3","0","0.72727","367","162","205"
"1974","Texas","8","4","0","0.66667","367","197","170"
"1975","Texas","10","2","0","0.83333","401","181","220"
"1976","Texas","5","5","1","0.50000","195","188","7"
"1957","Washington","3","6","1","0.35000","120","212","-92"
"1958","Washington","3","7","0","0.30000","102","146","-44"
"1959","Washington","10","1","0","0.90909","253","73","180"
"1960","Washington","10","1","0","0.90909","272","107","165"
"1961","Washington","5","4","1","0.55000","119","98","21"
"1962","Washington","7","1","2","0.80000","208","83","125"
"1963","Washington","6","5","0","0.54545","183","141","42"
"1964","Washington","6","4","0","0.60000","139","110","29"
"1965","Washington","5","5","0","0.50000","205","185","20"
"1966","Washington","6","4","0","0.60000","171","141","30"
"1967","Washington","5","5","0","0.50000","136","130","6"
"1968","Washington","3","5","2","0.40000","154","177","-23"
"1969","Washington","1","9","0","0.10000","116","304","-188"
"1970","Washington","6","4","0","0.60000","334","216","118"
"1971","Washington","8","3","0","0.72727","357","188","169"
"1972","Washington","8","3","0","0.72727","208","204","4"
"1973","Washington","2","9","0","0.18182","218","376","-158"
"1974","Washington","5","6","0","0.45455","272","285","-13"
"1971","Kent St. (OH)","3","8","0","0.27273","169","304","-135"
"1972","Kent St. (OH)","6","5","1","0.54167","191","196","-5"
"1973","Kent St. (OH)","9","2","0","0.81818","300","131","169"
"1974","Kent St. (OH)","7","4","0","0.63636","254","161","93"
"1975","Washington","6","5","0","0.54545","196","250","-54"
"1976","Washington","5","6","0","0.45455","237","207","30"
"1977","Washington","10","2","0","0.83333","344","194","150"
"1978","Washington","7","4","0","0.63636","270","155","115"
"1979","Washington","10","2","0","0.83333","321","154","167"
"1980","Washington","9","3","0","0.75000","333","198","135"
"1981","Washington","10","2","0","0.83333","281","171","110"
"1982","Washington","10","2","0","0.83333","354","193","161"
"1983","Washington","8","4","0","0.66667","285","178","107"
"1984","Washington","11","1","0","0.91667","352","145","207"
"1985","Washington","7","5","0","0.58333","238","225","13"
"1986","Washington","8","3","1","0.70833","378","197","181"
"1987","Washington","7","4","1","0.62500","295","254","41"
"1988","Washington","6","5","0","0.54545","254","223","31"
"1989","Washington","8","4","0","0.66667","332","225","107"
"1990","Washington","10","2","0","0.83333","440","184","256"
"1991","Washington","12","0","0","1.00000","495","115","380"
"1992","Washington","9","3","0","0.75000","337","186","151"
"1993","Washington","7","4","0","0.63636","288","198","90"
"1994","Washington","7","4","0","0.63636","295","233","62"
"1995","Washington","7","4","1","0.62500","312","280","32"
"1996","Washington","9","3","0","0.75000","391","254","137"
"1997","Washington","8","4","0","0.66667","420","259","161"
"1998","Washington","6","6","0","0.50000","303","343","-40"
"1995","Colorado","10","2","0","0.83333","444","240","204"
"1996","Colorado","10","2","0","0.83333","352","220","132"
"1997","Colorado","5","6","0","0.45455","300","295","5"
"1998","Colorado","8","4","0","0.66667","302","253","49"
"1999","Washington","7","5","0","0.58333","331","302","29"
"2000","Washington","11","1","0","0.91667","387","270","117"
"2001","Washington","8","4","0","0.66667","353","370","-17"
"2002","Washington","7","6","0","0.53846","398","342","56"
"2008","UCLA","4","8","0","0.33333","212","348","-136"
"2009","UCLA","7","6","0","0.53846","286","276","10"
"2010","UCLA","4","8","0","0.33333","242","364","-122"
"2011","UCLA","6","7","0","0.46154","309","419","-110"
"1986","Idaho","8","4","0","0.66667","307","244","63"
"1987","Idaho","9","3","0","0.75000","358","339","19"
"1988","Idaho","11","2","0","0.84615","392","305","87"
"1992","California","4","7","0","0.36364","284","284","0"
"1993","California","9","4","0","0.69231","411","303","108"
"1994","California","4","7","0","0.36364","212","248","-36"
"1995","California","3","8","0","0.27273","243","286","-43"
"2003","Washington","6","6","0","0.50000","312","316","-4"
"2004","Washington","1","10","0","0.09091","154","334","-180"
"1995","Stanford (CA)","7","4","1","0.62500","344","307","37"
"1996","Stanford (CA)","7","5","0","0.58333","247","229","18"
"1997","Stanford (CA)","5","6","0","0.45455","276","317","-41"
"1998","Stanford (CA)","3","8","0","0.27273","261","365","-104"
"1999","Stanford (CA)","8","4","0","0.66667","418","364","54"
"2000","Stanford (CA)","5","6","0","0.45455","261","294","-33"
"2001","Stanford (CA)","9","3","0","0.75000","422","339","83"
"2002","Notre Dame (IN)","10","3","0","0.76923","290","217","73"
"2003","Notre Dame (IN)","5","7","0","0.41667","243","315","-72"
"2004","Notre Dame (IN)","6","5","0","0.54545","268","251","17"
"2005","Washington","2","9","0","0.18182","237","337","-100"
"2006","Washington","5","7","0","0.41667","262","311","-49"
"2007","Washington","4","9","0","0.30769","380","411","-31"
"2008","Washington","0","12","0","0.00000","159","463","-304"
"2009","Washington","5","7","0","0.41667","313","320","-7"
"2010","Washington","7","6","0","0.53846","284","381","-97"
"2011","Washington","7","6","0","0.53846","434","467","-33"
"2012","Washington","7","6","0","0.53846","312","314","-2"
"2013","Washington","8","4","0","0.66667","462","281","181"
"2013","Washington","1","0","0","1.00000","31","16","15"
"1872","Stevens Tech (NJ)","0","1","0","0.00000","0","6","-6"
"1873","New York (NY)","3","3","0","0.50000","15","13","2"
"1874","Stevens Tech (NJ)","2","3","0","0.40000","10","20","-10"
"1875","Stevens Tech (NJ)","4","4","0","0.50000","21","20","1"
"1876","New York (NY)","2","3","1","0.41667","16","19","-3"
"1877","Stevens Tech (NJ)","3","1","2","0.66667","9","14","-5"
"1878","Stevens Tech (NJ)","3","3","3","0.50000","3","9","-6"
"1879","Stevens Tech (NJ)","2","3","5","0.45000","8","14","-6"
"1880","Stevens Tech (NJ)","1","5","0","0.16667","3","16","-13"
"1881","Stevens Tech (NJ)","3","8","3","0.32143","16","29","-13"
"1882","Lawrence (WI)","7","8","1","0.46875","17","25","-8"
"1883","Stevens Tech (NJ)","7","6","1","0.53571","187","128","59"
"1884","Fordham (NY)","9","10","0","0.47368","221","261","-40"
"1885","Georgetown (DC)","5","17","1","0.23913","359","612","-253"
"1886","New York (NY)","9","15","2","0.38462","180","565","-385"
"1887","Fordham (NY)","8","12","1","0.40476","157","445","-288"
"1888","Amherst (MA)","6","17","3","0.28846","192","791","-599"
"1889","New York (NY)","8","21","4","0.30303","278","647","-369"
"1890","New York (NY)","25","14","2","0.63415","727","538","189"
"1891","Delaware","32","30","7","0.51449","966","971","-5"
"1892","Beloit (WI)","29","31","3","0.48413","726","797","-71"
"1893","Marquette (WI)","39","34","3","0.53289","1091","885","206"
"1894","Manhattan (NY)","32","29","7","0.52206","853","692","161"
"1895","Delaware","44","35","6","0.55294","889","813","76"
"1896","Manhattan (NY)","51","49","6","0.50943","949","1164","-215"
"1897","Stevens Tech (NJ)","37","50","4","0.42857","661","1048","-387"
"1898","Manhattan (NY)","37","43","9","0.46629","781","1050","-269"
"1899","Manhattan (NY)","34","40","6","0.46250","594","1063","-469"
"1900","Manhattan (NY)","43","47","11","0.48020","991","1049","-58"
"1901","Ferris St. (MI)","51","44","7","0.53431","906","852","54"
"1902","Indiana St.","56","48","5","0.53670","1053","927","126"
"1903","Manhattan (NY)","30","49","7","0.38953","762","1319","-557"
"1904","Saint Francis (NY)","44","53","9","0.45755","787","1363","-576"
"1905","Bluffton (OH)","38","59","5","0.39706","850","1433","-583"
"1906","Ferris St. (MI)","32","43","12","0.43678","677","854","-177"
"1907","Ferris St. (MI)","32","48","10","0.41111","722","1208","-486"
"1908","Western Illinois","36","45","10","0.45055","760","1069","-309"
"1909","Delaware Valley (PA)","27","52","2","0.34568","682","1287","-605"
"1910","East Stroudsburg (PA)","23","31","3","0.42982","583","738","-155"
"1911","Western Illinois","32","44","7","0.42771","661","902","-241"
"1912","Indiana (PA)","36","56","7","0.39899","1134","1463","-329"
"1913","Saint Francis (NY)","52","67","8","0.44094","1672","2360","-688"
"1914","Delaware Valley (PA)","41","50","6","0.45361","1217","1585","-368"
"1915","Western Illinois","34","35","11","0.49375","932","1217","-285"
"1916","Morgan St. (MD)","44","43","7","0.50532","1493","1270","223"
"1917","Morgan St. (MD)","21","21","2","0.50000","408","883","-475"
"1918","Oklahoma Baptist University","7","16","2","0.32000","258","358","-100"
"1919","Western Illinois","53","41","8","0.55882","1478","1056","422"
"1920","Virginia Union","28","39","2","0.42029","506","893","-387"
"1921","Cooper Union (NY)","19","34","3","0.36607","441","1112","-671"
"1922","Cooper Union (NY)","27","34","6","0.44776","703","832","-129"
"1923","Cooper Union (NY)","31","45","2","0.41026","718","1112","-394"
"1924","East Stroudsburg (PA)","34","40","6","0.46250","946","1175","-229"
"1925","Saint Anselm (NH)","32","28","10","0.52857","847","802","45"
"1926","Saint Anselm (NH)","22","30","4","0.42857","515","702","-187"
"1927","Bethune-Cookman (FL)","20","29","8","0.42105","674","783","-109"
"1928","Saint Anselm (NH)","28","24","7","0.53390","564","1095","-531"
"1929","Saint Anselm (NH)","25","32","5","0.44355","616","843","-227"
"1930","Saint Anselm (NH)","31","27","10","0.52941","643","549","94"
"1931","Campbell (NC)","21","17","4","0.54762","465","428","37"
"1932","Campbell (NC)","7","30","3","0.21250","254","760","-506"
"1933","Campbell (NC)","11","13","3","0.46296","262","324","-62"
"1934","Bowie St. (MD)","4","7","2","0.38462","116","94","22"
"1935","Florida Southern","7","12","1","0.37500","170","162","8"
"1936","Bowie St. (MD)","5","2","1","0.68750","154","97","57"
"1937","Bowie St. (MD)","6","3","0","0.66667","98","87","11"
"1938","West Alabama","7","5","0","0.58333","151","88","63"
"1939","Elizabeth City St. (NC)","7","13","0","0.35000","150","307","-157"
"1940","Elizabeth City St. (NC)","6","5","4","0.53333","128","67","61"
"1941","Arkansas-Pine Bluff","3","9","5","0.32353","178","223","-45"
"1942","Brevard College (NC)","10","6","2","0.61111","225","189","36"
"1943","Clark Atlanta (GA)","6","8","0","0.42857","127","206","-79"
"1944","Abilene Christian (TX)","9","11","1","0.45238","158","255","-97"
"1945","Benedict (SC)","10","15","2","0.40741","299","296","3"
"1946","Elizabeth City St. (NC)","7","20","3","0.28333","144","540","-396"
"1947","Clark Atlanta (GA)","3","6","2","0.36364","49","230","-181"
"1948","Virginia-Lynchburg","4","6","1","0.40909","77","302","-225"
"1949","Virginia-Lynchburg","0","3","1","0.12500","7","70","-63"
"1950","Virginia-Lynchburg","2","3","0","0.40000","53","98","-45"
"1951","Lane (TN)","8","6","0","0.57143","295","234","61"
"1952","Lane (TN)","9","5","1","0.63333","220","206","14"
"1953","Lane (TN)","1","7","0","0.12500","58","215","-157"
"1954","Lane (TN)","2","6","0","0.25000","105","135","-30"
"1955","Lane (TN)","2","4","0","0.33333","83","129","-46"
"1957","Louisiana College","2","7","0","0.22222","106","179","-73"
"1959","Azusa Pacific (CA)","2","3","0","0.40000","117","90","27"
"1960","Azusa Pacific (CA)","4","3","1","0.56250","103","76","27"
"1961","Azusa Pacific (CA)","3","3","0","0.50000","123","147","-24"
"1963","San Francisco (CA)","2","5","0","0.28571","58","98","-40"
"1964","New York (NY)","0","2","0","0.00000","20","48","-28"
"1965","Adelphi (NY)","4","8","0","0.33333","198","216","-18"
"1966","Fairfield (CT)","18","22","2","0.45238","545","652","-107"
"1967","La Salle (PA)","25","31","0","0.44643","846","1080","-234"
"1968","Centenary (LA)","17","42","2","0.29508","726","1393","-667"
"1969","Bluffton (OH)","33","43","0","0.43421","1058","1548","-490"
"1970","Saint John's (NY)","35","54","1","0.39444","1379","1783","-404"
"1971","Bluffton (OH)","43","45","1","0.48876","1360","1384","-24"
"1972","Marquette (WI)","39","44","2","0.47059","1217","1351","-134"
"1973","Brooklyn (NY)","30","52","1","0.36747","1007","1611","-604"
"1974","Marquette (WI)","33","36","3","0.47917","959","1169","-210"
"1975","Marquette (WI)","31","22","4","0.57895","1042","932","110"
"1976","Bluffton (OH)","23","33","1","0.41228","862","1186","-324"
"1977","Manhattan (NY)","14","28","1","0.33721","568","923","-355"
"1978","Fairfield (CT)","5","7","1","0.42308","194","203","-9"
"1979","Fairfield (CT)","7","8","0","0.46667","247","260","-13"
"1980","Westfield St. (MA)","6","5","4","0.53333","184","196","-12"
"1981","San Francisco (CA)","17","14","0","0.54839","567","498","69"
"1982","Manhattan (NY)","18","16","0","0.52941","580","644","-64"
"1983","SUNY-Stony Brook (NY)","15","11","0","0.57692","474","453","21"
"1984","Stonehill (MA)","7","12","0","0.36842","231","439","-208"
"1985","Manhattan (NY)","10","10","0","0.50000","313","316","-3"
"1986","Marquette (WI)","13","17","0","0.43333","497","564","-67"
"1987","Marquette (WI)","10","17","0","0.37037","389","487","-98"
"1988","Marquette (WI)","1","5","0","0.16667","80","125","-45"
"1989","Marquette (WI)","4","4","0","0.50000","209","151","58"
"1990","Marquette (WI)","1","7","0","0.12500","80","180","-100"
"1991","Marquette (WI)","1","5","0","0.16667","106","182","-76"
"1992","Marquette (WI)","2","5","0","0.28571","81","129","-48"
"1993","Marquette (WI)","7","1","0","0.87500","212","126","86"
"1994","Marquette (WI)","1","6","0","0.14286","125","184","-59"
"1995","Marquette (WI)","3","4","0","0.42857","141","191","-50"
"1996","Marquette (WI)","3","5","0","0.37500","139","182","-43"
"1998","Madison College (WI)","2","15","0","0.11765","221","613","-392"
"1999","Marquette (WI)","0","7","0","0.00000","110","298","-188"
"2000","Marquette (WI)","1","5","0","0.16667","60","96","-36"
"2001","Marquette (WI)","2","6","0","0.25000","144","179","-35"
"2002","Marquette (WI)","3","4","0","0.42857","127","208","-81"
"2003","Marquette (WI)","1","6","0","0.14286","71","151","-80"
"2004","Marquette (WI)","0","6","0","0.00000","53","238","-185"
"2005","Marquette (WI)","2","5","0","0.28571","92","226","-134"
"2006","Marquette (WI)","1","6","0","0.14286","62","206","-144"
"2007","Marquette (WI)","2","5","0","0.28571","140","215","-75"
"2008","Marquette (WI)","0","7","0","0.00000","61","304","-243"
"2009","Marquette (WI)","0","1","0","0.00000","0","22","-22"
"1894","Washington St.","1","1","0","0.50000","10","18","-8"
"1895","Washington St.","2","0","0","1.00000","36","8","28"
"1896","Washington St.","2","0","1","0.83333","56","6","50"
"1897","Washington St.","2","0","0","1.00000","32","12","20"
"1898","Washington St.","0","0","1","0.50000","0","0","0"
"1899","Washington St.","1","1","0","0.50000","21","11","10"
"1900","Washington St.","4","0","1","0.90000","39","5","34"
"1902","Washington St.","2","3","0","0.40000","28","39","-11"
"1901","Washington St.","5","1","0","0.83333","71","7","64"
"1903","Washington St.","3","3","2","0.50000","92","54","38"
"1922","DePauw (IN)","4","3","2","0.55556","102","96","6"
"1923","DePauw (IN)","4","2","1","0.64286","63","39","24"
"1924","DePauw (IN)","1","7","0","0.12500","30","206","-176"
"1903","Morningside (IA)","5","3","0","0.62500","167","72","95"
"1904","Washington St.","2","2","0","0.50000","46","26","20"
"1905","Washington St.","4","4","0","0.50000","175","61","114"
"1908","Washington St.","4","0","2","0.83333","164","10","154"
"1904","North Carolina St.","3","1","2","0.66667","89","11","78"
"1905","Colorado","8","1","0","0.88889","359","28","331"
"1906","North Carolina","1","4","2","0.28571","18","83","-65"
"1907","Auburn (AL)","6","2","1","0.72222","185","30","155"
"1909","Washington St.","4","1","0","0.80000","159","17","142"
"1910","Washington St.","2","3","0","0.40000","25","34","-9"
"1911","Washington St.","3","3","0","0.50000","92","42","50"
"1906","Washington St.","6","0","0","1.00000","44","0","44"
"1907","Washington St.","7","1","0","0.87500","282","19","263"
"1912","Washington St.","2","3","0","0.40000","17","71","-54"
"1913","Washington St.","4","4","0","0.50000","111","61","50"
"1914","Washington St.","2","4","0","0.33333","10","75","-65"
"1915","Kansas St.","3","4","1","0.43750","43","84","-41"
"1916","Tennessee","8","0","1","0.94444","168","19","149"
"1919","Tennessee","3","3","3","0.50000","103","62","41"
"1920","Tennessee","7","2","0","0.77778","243","40","203"
"1915","Washington St.","7","0","0","1.00000","204","10","194"
"1916","Washington St.","4","2","0","0.66667","136","25","111"
"1917","Washington St.","6","0","1","0.92857","112","3","109"
"1921","Purdue (IN)","1","6","0","0.14286","9","95","-86"
"1922","Louisiana Tech","5","1","1","0.78571","290","26","264"
"1923","Louisiana Tech","6","2","0","0.75000","194","63","131"
"1924","Wyoming","2","6","0","0.25000","59","133","-74"
"1925","Wyoming","6","3","0","0.66667","147","83","64"
"1926","Wyoming","2","4","2","0.37500","152","91","61"
"1919","Washington St.","5","2","0","0.71429","156","33","123"
"1920","Washington St.","5","1","0","0.83333","129","76","53"
"1921","Washington St.","4","2","1","0.64286","109","62","47"
"1922","Washington St.","2","5","0","0.28571","44","163","-119"
"1914","Georgetown (DC)","2","4","2","0.37500","52","76","-24"
"1915","Georgetown (DC)","7","2","0","0.77778","317","30","287"
"1916","Georgetown (DC)","9","1","0","0.90000","473","32","441"
"1917","Georgetown (DC)","7","1","0","0.87500","169","53","116"
"1918","Georgetown (DC)","3","2","0","0.60000","188","48","140"
"1919","Georgetown (DC)","7","3","0","0.70000","244","79","165"
"1920","Georgetown (DC)","6","4","0","0.60000","235","138","97"
"1921","Georgetown (DC)","8","1","0","0.88889","245","51","194"
"1922","Georgetown (DC)","6","3","1","0.65000","175","77","98"
"1923","Washington St.","2","4","1","0.35714","56","84","-28"
"1924","Washington St.","1","5","2","0.25000","107","88","19"
"1925","Washington St.","3","4","1","0.43750","67","104","-37"
"1934","Oklahoma St.","4","5","1","0.45000","54","130","-76"
"1935","Oklahoma St.","3","7","0","0.30000","59","152","-93"
"1926","Washington St.","6","1","0","0.85714","85","28","57"
"1927","Washington St.","3","3","2","0.50000","120","67","53"
"1928","Washington St.","7","3","0","0.70000","202","65","137"
"1929","Washington St.","10","2","0","0.83333","294","74","220"
"1930","Washington St.","9","1","0","0.90000","218","56","162"
"1931","Washington St.","6","4","0","0.60000","123","111","12"
"1932","Washington St.","7","1","1","0.83333","130","28","102"
"1933","Washington St.","6","3","1","0.65000","170","67","103"
"1934","Washington St.","5","3","1","0.61111","144","28","116"
"1935","Washington St.","5","3","1","0.61111","141","81","60"
"1936","Washington St.","6","3","1","0.65000","108","102","6"
"1937","Washington St.","3","3","3","0.50000","36","67","-31"
"1938","Washington St.","2","8","0","0.20000","44","159","-115"
"1939","Washington St.","4","5","0","0.44444","67","134","-67"
"1940","Washington St.","4","4","2","0.50000","131","147","-16"
"1941","Washington St.","6","4","0","0.60000","157","63","94"
"1942","Washington St.","6","2","2","0.70000","157","95","62"
"1945","Washington St.","6","2","1","0.72222","157","70","87"
"1946","Washington St.","1","6","1","0.18750","118","147","-29"
"1947","Washington St.","3","7","0","0.30000","93","148","-55"
"1948","Washington St.","4","5","1","0.45000","164","219","-55"
"1949","Washington St.","3","6","0","0.33333","149","205","-56"
"1966","Hawaii","4","6","0","0.40000","110","245","-135"
"1941","Hamilton (NY)","5","2","0","0.71429","150","64","86"
"1950","Washington St.","4","3","2","0.55556","168","182","-14"
"1951","Washington St.","7","3","0","0.70000","280","187","93"
"1952","Iowa","2","7","0","0.22222","121","220","-99"
"1953","Iowa","5","3","1","0.61111","187","91","96"
"1954","Iowa","5","4","0","0.55556","192","141","51"
"1955","Iowa","3","5","1","0.38889","166","173","-7"
"1956","Iowa","9","1","0","0.90000","219","84","135"
"1957","Iowa","7","1","1","0.83333","263","112","151"
"1958","Iowa","8","1","1","0.85000","272","146","126"
"1959","Iowa","5","4","0","0.55556","233","100","133"
"1960","Iowa","8","1","0","0.88889","234","108","126"
"1952","Washington St.","4","6","0","0.40000","171","215","-44"
"1953","Washington St.","4","6","0","0.40000","146","256","-110"
"1954","Washington St.","4","6","0","0.40000","149","225","-76"
"1955","Washington St.","1","7","2","0.20000","67","257","-190"
"1956","Washington St.","3","6","1","0.35000","163","247","-84"
"1957","Washington St.","6","4","0","0.60000","193","161","32"
"1958","Washington St.","7","3","0","0.70000","199","117","82"
"1959","Washington St.","6","4","0","0.60000","177","121","56"
"1960","Washington St.","4","5","1","0.45000","210","161","49"
"1961","Washington St.","3","7","0","0.30000","163","213","-50"
"1962","Washington St.","5","4","1","0.55000","213","167","46"
"1963","Washington St.","3","6","1","0.35000","95","160","-65"
"1964","Washington St.","3","6","1","0.35000","165","208","-43"
"1965","Washington St.","7","3","0","0.70000","139","103","36"
"1966","Washington St.","3","7","0","0.30000","132","211","-79"
"1967","Washington St.","2","8","0","0.20000","141","266","-125"
"1963","Montana St.","6","3","0","0.66667","195","89","106"
"1964","Montana St.","7","4","0","0.63636","223","111","112"
"1965","Montana St.","3","7","0","0.30000","119","185","-66"
"1966","Montana St.","8","3","0","0.72727","401","162","239"
"1967","Montana St.","7","3","0","0.70000","228","151","77"
"1968","Washington St.","3","6","1","0.35000","189","188","1"
"1969","Washington St.","1","9","0","0.10000","143","339","-196"
"1970","Washington St.","1","10","0","0.09091","231","460","-229"
"1971","Washington St.","4","7","0","0.36364","246","286","-40"
"1972","Washington St.","7","4","0","0.63636","274","241","33"
"1973","Washington St.","5","6","0","0.45455","250","290","-40"
"1974","Washington St.","2","9","0","0.18182","162","272","-110"
"1975","Washington St.","3","8","0","0.27273","262","295","-33"
"1976","Fresno St. (CA)","6","5","0","0.54545","237","165","72"
"1977","Fresno St. (CA)","9","2","0","0.81818","354","163","191"
"1980","Fresno St. (CA)","5","6","0","0.45455","192","245","-53"
"1981","Fresno St. (CA)","5","6","0","0.45455","264","299","-35"
"1982","Fresno St. (CA)","11","1","0","0.91667","381","228","153"
"1983","Fresno St. (CA)","6","5","0","0.54545","242","214","28"
"1984","Fresno St. (CA)","6","6","0","0.50000","293","253","40"
"1985","Fresno St. (CA)","11","0","1","0.95833","481","209","272"
"1986","Fresno St. (CA)","9","2","0","0.81818","302","150","152"
"1987","Fresno St. (CA)","6","5","0","0.54545","260","179","81"
"1988","Fresno St. (CA)","10","2","0","0.83333","393","169","224"
"1989","Fresno St. (CA)","11","1","0","0.91667","441","220","221"
"1990","Fresno St. (CA)","8","2","1","0.77273","346","230","116"
"1991","Fresno St. (CA)","10","2","0","0.83333","507","235","272"
"1992","Fresno St. (CA)","9","4","0","0.69231","510","364","146"
"1993","Fresno St. (CA)","8","4","0","0.66667","467","350","117"
"1994","Fresno St. (CA)","5","7","1","0.42308","376","426","-50"
"1995","Fresno St. (CA)","5","7","0","0.41667","371","387","-16"
"1996","Fresno St. (CA)","4","7","0","0.36364","267","344","-77"
"1976","Washington St.","3","8","0","0.27273","240","331","-91"
"1977","Pittsburgh (PA)","9","2","1","0.79167","428","134","294"
"1978","Pittsburgh (PA)","8","4","0","0.66667","263","187","76"
"1979","Pittsburgh (PA)","11","1","0","0.91667","291","116","175"
"1980","Pittsburgh (PA)","11","1","0","0.91667","380","130","250"
"1981","Pittsburgh (PA)","11","1","0","0.91667","385","160","225"
"1982","Texas A&M","5","6","0","0.45455","286","314","-28"
"1983","Texas A&M","5","5","1","0.50000","218","174","44"
"1984","Texas A&M","6","5","0","0.54545","245","217","28"
"1985","Texas A&M","10","2","0","0.83333","375","196","179"
"1986","Texas A&M","9","3","0","0.75000","372","215","157"
"1987","Texas A&M","10","2","0","0.83333","313","168","145"
"1988","Texas A&M","7","5","0","0.58333","293","253","40"
"1991","Mississippi St.","7","5","0","0.58333","291","194","97"
"1992","Mississippi St.","7","5","0","0.58333","252","197","55"
"1993","Mississippi St.","4","5","2","0.45455","241","245","-4"
"1994","Mississippi St.","8","4","0","0.66667","373","262","111"
"1995","Mississippi St.","3","8","0","0.27273","261","357","-96"
"1996","Mississippi St.","5","6","0","0.45455","249","229","20"
"1997","Mississippi St.","7","4","0","0.63636","226","215","11"
"1998","Mississippi St.","8","5","0","0.61538","350","256","94"
"1999","Mississippi St.","10","2","0","0.83333","255","156","99"
"2000","Mississippi St.","8","4","0","0.66667","390","306","84"
"2001","Mississippi St.","3","8","0","0.27273","196","288","-92"
"2002","Mississippi St.","3","9","0","0.25000","227","339","-112"
"2003","Mississippi St.","2","10","0","0.16667","225","471","-246"
"1977","Washington St.","7","4","0","0.63636","263","236","27"
"1978","Missouri","8","4","0","0.66667","368","236","132"
"1979","Missouri","7","5","0","0.58333","260","166","94"
"1980","Missouri","8","4","0","0.66667","332","175","157"
"1981","Missouri","8","4","0","0.66667","276","159","117"
"1982","Missouri","5","4","2","0.54545","207","196","11"
"1983","Missouri","7","5","0","0.58333","292","202","90"
"1984","Missouri","3","7","1","0.31818","310","301","9"
"1978","Washington St.","4","6","1","0.40909","276","296","-20"
"1979","Washington St.","5","6","0","0.45455","241","366","-125"
"1980","Washington St.","4","7","0","0.36364","287","271","16"
"1981","Washington St.","8","3","1","0.70833","297","197","100"
"1982","Washington St.","3","7","1","0.31818","170","255","-85"
"1983","Washington St.","7","4","0","0.63636","237","211","26"
"1984","Washington St.","6","5","0","0.54545","317","319","-2"
"1985","Washington St.","4","7","0","0.36364","313","282","31"
"1986","Washington St.","3","7","1","0.31818","221","312","-91"
"1987","Iowa St.","3","8","0","0.27273","195","417","-222"
"1988","Iowa St.","5","6","0","0.45455","195","258","-63"
"1989","Iowa St.","6","5","0","0.54545","294","305","-11"
"1990","Iowa St.","4","6","1","0.40909","270","307","-37"
"1991","Iowa St.","3","7","1","0.31818","157","266","-109"
"1992","Iowa St.","4","7","0","0.36364","231","242","-11"
"1993","Iowa St.","3","8","0","0.27273","251","324","-73"
"1994","Iowa St.","0","10","1","0.04545","192","363","-171"
"1982","Idaho","9","4","0","0.69231","397","299","98"
"1983","Idaho","8","3","0","0.72727","347","257","90"
"1984","Idaho","6","5","0","0.54545","363","283","80"
"1985","Idaho","9","3","0","0.75000","441","247","194"
"1986","Wyoming","6","6","0","0.50000","299","272","27"
"1987","Washington St.","3","7","1","0.31818","238","356","-118"
"1988","Washington St.","9","3","0","0.75000","415","303","112"
"1989","Miami (FL)","11","1","0","0.91667","426","127","299"
"1990","Miami (FL)","10","2","0","0.83333","447","184","263"
"1991","Miami (FL)","12","0","0","1.00000","386","100","286"
"1992","Miami (FL)","11","1","0","0.91667","369","161","208"
"1993","Miami (FL)","9","3","0","0.75000","331","167","164"
"1994","Miami (FL)","10","2","0","0.83333","365","143","222"
"1999","Oregon St.","7","5","0","0.58333","347","277","70"
"2000","Oregon St.","11","1","0","0.91667","400","212","188"
"2001","Oregon St.","5","6","0","0.45455","287","259","28"
"2002","Oregon St.","8","5","0","0.61538","414","267","147"
"2006","Idaho","4","8","0","0.33333","203","417","-214"
"2007","Arizona St.","10","3","0","0.76923","420","292","128"
"2008","Arizona St.","5","7","0","0.41667","274","272","2"
"2009","Arizona St.","4","8","0","0.33333","268","253","15"
"2010","Arizona St.","6","6","0","0.50000","387","300","87"
"2011","Arizona St.","6","7","0","0.46154","431","372","59"
"1981","Weber St. (UT)","7","4","0","0.63636","271","228","43"
"1982","Weber St. (UT)","4","7","0","0.36364","261","312","-51"
"1983","Weber St. (UT)","6","5","0","0.54545","290","279","11"
"1984","Weber St. (UT)","5","6","0","0.45455","287","312","-25"
"1985","Weber St. (UT)","6","5","0","0.54545","411","333","78"
"1986","Weber St. (UT)","3","8","0","0.27273","332","351","-19"
"1987","Weber St. (UT)","10","3","0","0.76923","489","382","107"
"1988","Weber St. (UT)","5","6","0","0.45455","360","341","19"
"1989","Washington St.","6","5","0","0.54545","351","268","83"
"1990","Washington St.","3","8","0","0.27273","286","381","-95"
"1991","Washington St.","4","7","0","0.36364","280","340","-60"
"1992","Washington St.","9","3","0","0.75000","337","281","56"
"1993","Washington St.","5","6","0","0.45455","271","248","23"
"1994","Washington St.","8","4","0","0.66667","192","136","56"
"1995","Washington St.","3","8","0","0.27273","236","274","-38"
"1996","Washington St.","5","6","0","0.45455","314","317","-3"
"1997","Washington St.","10","2","0","0.83333","483","296","187"
"1998","Washington St.","3","8","0","0.27273","223","349","-126"
"1999","Washington St.","3","9","0","0.25000","248","327","-79"
"2000","Washington St.","4","7","0","0.36364","281","354","-73"
"2001","Washington St.","10","2","0","0.83333","420","269","151"
"2002","Washington St.","10","3","0","0.76923","431","296","135"
"2004","Texas-El Paso","8","4","0","0.66667","429","301","128"
"2005","Texas-El Paso","8","4","0","0.66667","382","311","71"
"2006","Texas-El Paso","5","7","0","0.41667","328","375","-47"
"2007","Texas-El Paso","4","8","0","0.33333","403","445","-42"
"2008","Texas-El Paso","5","7","0","0.41667","395","444","-49"
"2009","Texas-El Paso","4","8","0","0.33333","358","402","-44"
"2010","Texas-El Paso","6","7","0","0.46154","338","357","-19"
"2011","Texas-El Paso","5","7","0","0.41667","319","364","-45"
"2012","Texas-El Paso","3","9","0","0.25000","254","357","-103"
"2003","Washington St.","10","3","0","0.76923","394","257","137"
"2004","Washington St.","5","6","0","0.45455","275","307","-32"
"2005","Washington St.","4","7","0","0.36364","368","346","22"
"2006","Washington St.","6","6","0","0.50000","295","277","18"
"2007","Washington St.","5","7","0","0.41667","308","389","-81"
"2000","Eastern Washington","6","5","0","0.54545","288","243","45"
"2001","Eastern Washington","7","4","0","0.63636","461","349","112"
"2002","Eastern Washington","6","5","0","0.54545","365","276","89"
"2003","Eastern Washington","6","5","0","0.54545","344","321","23"
"2004","Eastern Washington","9","4","0","0.69231","488","323","165"
"2005","Eastern Washington","7","5","0","0.58333","420","281","139"
"2006","Eastern Washington","3","8","0","0.27273","214","296","-82"
"2007","Eastern Washington","9","4","0","0.69231","437","288","149"
"2008","Washington St.","2","11","0","0.15385","165","570","-405"
"2009","Washington St.","1","11","0","0.08333","144","462","-318"
"2010","Washington St.","2","10","0","0.16667","235","430","-195"
"2011","Washington St.","4","8","0","0.33333","358","381","-23"
"2000","Texas Tech","7","6","0","0.53846","330","278","52"
"2001","Texas Tech","7","5","0","0.58333","402","281","121"
"2002","Texas Tech","9","5","0","0.64286","537","439","98"
"2003","Texas Tech","8","5","0","0.61538","552","442","110"
"2004","Texas Tech","8","4","0","0.66667","434","314","120"
"2005","Texas Tech","9","3","0","0.75000","473","226","247"
"2006","Texas Tech","8","5","0","0.61538","422","326","96"
"2007","Texas Tech","9","4","0","0.69231","532","337","195"
"2008","Texas Tech","11","2","0","0.84615","569","362","207"
"2009","Texas Tech","8","4","0","0.66667","440","261","179"
"2012","Washington St.","3","9","0","0.25000","245","404","-159"
"2013","Washington St.","6","7","0","0.46154","403","423","-20"
"1891","West Virginia","0","1","0","0.00000","0","72","-72"
"1893","West Virginia","2","1","0","0.66667","24","60","-36"
"1894","West Virginia","2","2","0","0.50000","28","52","-24"
"1895","West Virginia","5","1","0","0.83333","58","10","48"
"1895","North Carolina","7","1","1","0.83333","146","17","129"
"1896","West Virginia","3","7","2","0.33333","14","101","-87"
"1897","Pittsburgh (PA)","1","3","0","0.25000","13","91","-78"
"1913","North Carolina","5","4","0","0.55556","91","76","15"
"1914","North Carolina","10","1","0","0.90909","359","52","307"
"1915","North Carolina","4","3","1","0.56250","105","98","7"
"1897","West Virginia","5","4","1","0.55000","96","45","51"
"1898","West Virginia","6","1","0","0.85714","64","23","41"
"1899","West Virginia","2","3","0","0.40000","28","78","-50"
"1901","West Virginia","3","2","0","0.60000","73","34","39"
"1902","West Virginia","7","4","0","0.63636","217","87","130"
"1900","West Virginia","4","3","0","0.57143","53","104","-51"
"1903","West Virginia","7","1","0","0.87500","145","61","84"
"1900","Wabash (IN)","5","4","0","0.55556","80","94","-14"
"1901","DePauw (IN)","8","3","0","0.72727","197","73","124"
"1902","Cincinnati (OH)","4","2","2","0.62500","58","45","13"
"1903","Cincinnati (OH)","1","8","0","0.11111","39","141","-102"
"1904","West Virginia","6","3","0","0.66667","99","233","-134"
"1905","West Virginia","8","1","0","0.88889","204","22","182"
"1906","West Virginia","5","5","0","0.50000","192","74","118"
"1907","West Virginia","6","4","0","0.60000","236","38","198"
"1914","New Mexico St.","4","2","1","0.64286","80","29","51"
"1915","New Mexico St.","5","2","0","0.71429","85","19","66"
"1916","New Mexico St.","2","4","1","0.35714","64","153","-89"
"1903","Virginia Tech","5","1","0","0.83333","108","21","87"
"1908","West Virginia","5","3","0","0.62500","101","29","72"
"1909","West Virginia","4","3","2","0.55556","118","81","37"
"1910","West Virginia","2","4","1","0.35714","20","95","-75"
"1911","West Virginia","6","3","0","0.66667","91","67","24"
"1912","West Virginia","6","3","0","0.66667","131","106","25"
"1899","Hamilton (NY)","8","2","1","0.77273","282","67","215"
"1900","Syracuse (NY)","7","2","1","0.75000","208","60","148"
"1901","Syracuse (NY)","7","1","0","0.87500","185","27","158"
"1902","Syracuse (NY)","6","2","1","0.72222","172","93","79"
"1903","Hamilton (NY)","6","3","0","0.66667","136","91","45"
"1904","Ohio St.","6","5","0","0.54545","219","123","96"
"1905","Ohio St.","8","2","2","0.75000","197","63","134"
"1908","Colgate (NY)","4","3","0","0.57143","78","25","53"
"1909","Kentucky","9","1","0","0.90000","261","29","232"
"1910","Kentucky","7","2","0","0.77778","140","29","111"
"1911","Miami (OH)","2","4","2","0.37500","57","45","12"
"1912","Kentucky","7","2","0","0.77778","250","41","209"
"1913","West Virginia","3","4","2","0.44444","109","137","-28"
"1914","Tulane (LA)","3","3","1","0.50000","145","147","-2"
"1904","Baylor (TX)","2","5","1","0.31250","34","106","-72"
"1908","Pennsylvania","11","0","1","0.95833","215","28","187"
"1909","Oregon St.","4","2","1","0.64286","54","41","13"
"1914","West Virginia","5","4","0","0.55556","159","96","63"
"1915","West Virginia","5","2","1","0.68750","208","20","188"
"1920","South Carolina","5","4","0","0.55556","82","140","-58"
"1921","South Carolina","5","1","2","0.75000","116","28","88"
"1922","South Carolina","5","4","0","0.55556","93","69","24"
"1923","South Carolina","4","6","0","0.40000","104","77","27"
"1924","South Carolina","7","3","0","0.70000","120","48","72"
"1916","West Virginia","5","2","2","0.66667","198","38","160"
"1917","West Virginia","6","3","1","0.65000","161","50","111"
"1919","West Virginia","8","2","0","0.80000","326","47","279"
"1920","West Virginia","5","4","1","0.55000","169","113","56"
"1917","Dartmouth (NH)","5","3","0","0.62500","83","68","15"
"1918","Dartmouth (NH)","3","3","0","0.50000","78","83","-5"
"1919","Dartmouth (NH)","6","1","1","0.81250","141","53","88"
"1920","Dartmouth (NH)","7","2","0","0.77778","199","68","131"
"1921","West Virginia","5","4","1","0.55000","161","82","79"
"1922","West Virginia","10","0","1","0.95455","267","34","233"
"1923","West Virginia","7","1","1","0.83333","297","41","256"
"1924","West Virginia","8","1","0","0.88889","282","47","235"
"1925","Minnesota","5","2","1","0.68750","176","91","85"
"1926","Minnesota","5","3","0","0.62500","269","57","212"
"1927","Minnesota","6","0","2","0.87500","209","51","158"
"1928","Minnesota","6","2","0","0.75000","182","36","146"
"1929","Minnesota","6","2","0","0.75000","179","55","124"
"1930","Oregon","7","2","0","0.77778","131","35","96"
"1931","Oregon","6","2","2","0.70000","90","87","3"
"1932","Wisconsin","6","1","1","0.81250","151","48","103"
"1933","Wisconsin","2","5","1","0.31250","54","79","-25"
"1934","Wisconsin","4","4","0","0.50000","48","84","-36"
"1935","Wisconsin","1","7","0","0.12500","53","171","-118"
"1936","Toledo (OH)","2","6","0","0.25000","94","58","36"
"1937","Toledo (OH)","6","3","0","0.66667","128","96","32"
"1938","Toledo (OH)","6","3","1","0.65000","156","83","73"
"1939","Toledo (OH)","7","3","0","0.70000","180","59","121"
"1940","Toledo (OH)","6","3","0","0.66667","146","78","68"
"1941","Toledo (OH)","7","4","0","0.63636","195","122","73"
"1942","Toledo (OH)","4","4","1","0.50000","91","114","-23"
"1943","Maryland","4","5","0","0.44444","105","194","-89"
"1944","Maryland","1","7","1","0.16667","46","170","-124"
"1925","West Virginia","8","1","0","0.88889","175","18","157"
"1926","West Virginia","6","4","0","0.60000","141","93","48"
"1927","West Virginia","2","4","3","0.38889","68","129","-61"
"1928","West Virginia","8","2","0","0.80000","152","38","114"
"1929","West Virginia","4","3","3","0.55000","77","96","-19"
"1930","West Virginia","5","5","0","0.50000","111","103","8"
"1943","West Virginia","4","3","0","0.57143","124","79","45"
"1944","West Virginia","5","3","1","0.61111","191","130","61"
"1945","West Virginia","2","6","1","0.27778","122","126","-4"
"1916","West Virginia Wesleyan","5","6","0","0.45455","233","199","34"
"1917","West Virginia Wesleyan","5","2","0","0.71429","141","30","111"
"1923","Virginia","3","5","1","0.38889","87","81","6"
"1924","Virginia","5","4","0","0.55556","72","83","-11"
"1925","Virginia","7","1","1","0.83333","144","31","113"
"1926","Virginia","6","2","2","0.70000","161","53","108"
"1927","Virginia","5","4","0","0.55556","117","122","-5"
"1928","Virginia","2","6","1","0.27778","121","142","-21"
"1931","West Virginia","4","6","0","0.40000","91","122","-31"
"1932","West Virginia","5","5","0","0.50000","137","115","22"
"1933","West Virginia","3","5","3","0.40909","87","145","-58"
"1925","Marshall (WV)","4","1","4","0.66667","138","29","109"
"1926","Marshall (WV)","5","4","1","0.55000","150","99","51"
"1927","Marshall (WV)","5","3","1","0.61111","194","75","119"
"1928","Marshall (WV)","8","1","1","0.85000","175","33","142"
"1934","West Virginia","6","4","0","0.60000","117","113","4"
"1935","West Virginia","3","4","2","0.44444","129","96","33"
"1936","West Virginia","6","4","0","0.60000","151","122","29"
"1937","West Virginia","8","1","1","0.85000","183","39","144"
"1938","West Virginia","4","5","1","0.45000","98","116","-18"
"1939","West Virginia","2","6","1","0.27778","70","94","-24"
"1940","West Virginia","4","4","1","0.50000","127","94","33"
"1941","West Virginia","4","6","0","0.40000","85","126","-41"
"1942","West Virginia","5","4","0","0.55556","119","91","28"
"1946","West Virginia","5","5","0","0.50000","120","99","21"
"1947","West Virginia","6","4","0","0.60000","252","84","168"
"1932","San Jose St. (CA)","7","0","2","0.88889","116","27","89"
"1933","San Jose St. (CA)","4","4","0","0.50000","102","78","24"
"1934","San Jose St. (CA)","3","3","4","0.50000","90","126","-36"
"1935","San Jose St. (CA)","5","5","1","0.50000","116","101","15"
"1936","San Jose St. (CA)","5","4","0","0.55556","136","93","43"
"1937","San Jose St. (CA)","11","2","1","0.82143","296","79","217"
"1938","San Jose St. (CA)","11","1","0","0.91667","322","56","266"
"1939","San Jose St. (CA)","13","0","0","1.00000","324","29","295"
"1948","West Virginia","9","3","0","0.75000","257","140","117"
"1949","West Virginia","4","6","1","0.40909","227","275","-48"
"1950","New Mexico","2","8","0","0.20000","160","337","-177"
"1951","New Mexico","4","7","0","0.36364","213","262","-49"
"1952","New Mexico","7","2","0","0.77778","119","46","73"
"1950","West Virginia","2","8","0","0.20000","163","259","-96"
"1951","West Virginia","5","5","0","0.50000","225","190","35"
"1952","West Virginia","7","2","0","0.77778","234","116","118"
"1953","West Virginia","8","2","0","0.80000","309","154","155"
"1954","West Virginia","8","1","0","0.88889","209","74","135"
"1955","West Virginia","8","2","0","0.80000","285","104","181"
"1956","West Virginia","6","4","0","0.60000","130","106","24"
"1957","West Virginia","7","2","1","0.75000","179","118","61"
"1958","West Virginia","4","5","1","0.45000","268","200","68"
"1959","West Virginia","3","7","0","0.30000","74","204","-130"
"1960","West Virginia","0","8","2","0.10000","40","259","-219"
"1961","West Virginia","4","6","0","0.40000","134","145","-11"
"1962","West Virginia","8","2","0","0.80000","211","137","74"
"1963","West Virginia","4","6","0","0.40000","154","201","-47"
"1964","West Virginia","7","4","0","0.63636","162","211","-49"
"1965","West Virginia","6","4","0","0.60000","279","264","15"
"1966","West Virginia","3","5","2","0.40000","158","197","-39"
"1967","West Virginia","5","4","1","0.55000","188","117","71"
"1968","West Virginia","7","3","0","0.70000","207","141","66"
"1969","West Virginia","10","1","0","0.90909","302","113","189"
"1970","Texas Tech","8","4","0","0.66667","222","165","57"
"1971","Texas Tech","4","7","0","0.36364","131","138","-7"
"1972","Texas Tech","8","4","0","0.66667","282","188","94"
"1973","Texas Tech","11","1","0","0.91667","342","187","155"
"1974","Texas Tech","6","4","2","0.58333","193","158","35"
"1975","South Carolina","7","5","0","0.58333","328","274","54"
"1976","South Carolina","6","5","0","0.54545","195","143","52"
"1977","South Carolina","5","7","0","0.41667","215","202","13"
"1978","South Carolina","5","5","1","0.50000","238","181","57"
"1979","South Carolina","8","4","0","0.66667","246","205","41"
"1980","South Carolina","8","4","0","0.66667","348","200","148"
"1981","South Carolina","6","6","0","0.50000","225","222","3"
"1959","Samford (AL)","9","1","0","0.90000","226","79","147"
"1960","Samford (AL)","8","1","0","0.88889","297","58","239"
"1961","Samford (AL)","7","2","0","0.77778","320","76","244"
"1962","Samford (AL)","7","2","0","0.77778","214","98","116"
"1970","West Virginia","8","3","0","0.72727","311","200","111"
"1971","West Virginia","7","4","0","0.63636","280","220","60"
"1972","West Virginia","8","4","0","0.66667","415","289","126"
"1973","West Virginia","6","5","0","0.54545","212","266","-54"
"1974","West Virginia","4","7","0","0.36364","210","224","-14"
"1975","West Virginia","9","3","0","0.75000","283","189","94"
"1976","Florida St.","5","6","0","0.45455","205","258","-53"
"1977","Florida St.","10","2","0","0.83333","314","170","144"
"1978","Florida St.","8","3","0","0.72727","312","208","104"
"1979","Florida St.","11","1","0","0.91667","326","160","166"
"1980","Florida St.","10","2","0","0.83333","369","103","266"
"1981","Florida St.","6","5","0","0.54545","240","286","-46"
"1982","Florida St.","9","3","0","0.75000","419","254","165"
"1983","Florida St.","8","4","0","0.66667","381","312","69"
"1984","Florida St.","7","3","2","0.66667","406","254","152"
"1985","Florida St.","9","3","0","0.75000","402","258","144"
"1986","Florida St.","7","4","1","0.62500","393","218","175"
"1987","Florida St.","11","1","0","0.91667","481","163","318"
"1988","Florida St.","11","1","0","0.91667","455","172","283"
"1989","Florida St.","10","2","0","0.83333","424","199","225"
"1990","Florida St.","10","2","0","0.83333","459","206","253"
"1991","Florida St.","11","2","0","0.84615","449","188","261"
"1992","Florida St.","11","1","0","0.91667","446","186","260"
"1993","Florida St.","12","1","0","0.92308","536","129","407"
"1994","Florida St.","10","1","1","0.87500","428","200","228"
"1995","Florida St.","10","2","0","0.83333","563","246","317"
"1996","Florida St.","11","1","0","0.91667","446","174","272"
"1997","Florida St.","11","1","0","0.91667","468","181","287"
"1998","Florida St.","11","2","0","0.84615","401","161","240"
"1999","Florida St.","12","0","0","1.00000","458","203","255"
"2000","Florida St.","11","2","0","0.84615","511","136","375"
"2001","Florida St.","8","4","0","0.66667","403","304","99"
"2002","Florida St.","9","5","0","0.64286","428","301","127"
"2003","Florida St.","10","3","0","0.76923","419","217","202"
"2004","Florida St.","9","3","0","0.75000","302","169","133"
"2005","Florida St.","8","5","0","0.61538","376","286","90"
"2006","Florida St.","2","6","0","0.25000","345","258","87"
"2007","Florida St.","0","6","0","0.00000","303","298","5"
"2008","Florida St.","9","4","0","0.69231","434","262","172"
"2009","Florida St.","7","6","0","0.53846","391","390","1"
"1976","West Virginia","5","6","0","0.45455","184","202","-18"
"1977","West Virginia","5","6","0","0.45455","244","264","-20"
"1978","West Virginia","2","9","0","0.18182","167","364","-197"
"1979","West Virginia","5","6","0","0.45455","185","279","-94"
"1986","Indiana (PA)","9","2","0","0.81818","301","148","153"
"1987","Indiana (PA)","10","2","0","0.83333","255","126","129"
"1988","Indiana (PA)","8","3","0","0.72727","342","147","195"
"1989","Indiana (PA)","11","2","0","0.84615","434","154","280"
"1990","Indiana (PA)","12","2","0","0.85714","542","195","347"
"1991","Indiana (PA)","12","1","0","0.92308","497","120","377"
"1992","Indiana (PA)","8","1","1","0.85000","336","196","140"
"1993","Indiana (PA)","13","1","0","0.92857","538","240","298"
"1994","Indiana (PA)","10","3","0","0.76923","462","274","188"
"1995","Indiana (PA)","8","3","0","0.72727","389","164","225"
"1996","Indiana (PA)","8","3","0","0.72727","309","260","49"
"1997","Indiana (PA)","5","5","0","0.50000","244","233","11"
"1998","Indiana (PA)","10","2","0","0.83333","357","179","178"
"1999","Indiana (PA)","9","4","0","0.69231","298","201","97"
"2000","Indiana (PA)","8","3","0","0.72727","231","155","76"
"2001","Indiana (PA)","8","2","0","0.80000","311","139","172"
"2002","Indiana (PA)","11","2","0","0.84615","431","298","133"
"2003","Indiana (PA)","10","1","0","0.90909","323","182","141"
"2004","Indiana (PA)","7","3","0","0.70000","294","230","64"
"2005","Indiana (PA)","5","5","0","0.50000","197","224","-27"
"1968","Bowling Green (OH)","6","3","1","0.65000","267","147","120"
"1969","Bowling Green (OH)","6","4","0","0.60000","179","146","33"
"1970","Bowling Green (OH)","2","6","1","0.27778","118","178","-60"
"1971","Bowling Green (OH)","6","4","0","0.60000","263","207","56"
"1972","Bowling Green (OH)","6","3","1","0.65000","184","127","57"
"1973","Bowling Green (OH)","7","3","0","0.70000","266","209","57"
"1974","Bowling Green (OH)","6","4","1","0.59091","249","203","46"
"1975","Bowling Green (OH)","8","3","0","0.72727","278","166","112"
"1976","Bowling Green (OH)","6","5","0","0.54545","292","249","43"
"1980","West Virginia","6","6","0","0.50000","305","289","16"
"1981","West Virginia","9","3","0","0.75000","284","155","129"
"1982","West Virginia","9","3","0","0.75000","284","182","102"
"1983","West Virginia","9","3","0","0.75000","322","189","133"
"1984","West Virginia","8","4","0","0.66667","259","170","89"
"1985","West Virginia","7","3","1","0.68182","189","158","31"
"1986","West Virginia","4","7","0","0.36364","210","286","-76"
"1987","West Virginia","6","6","0","0.50000","330","212","118"
"1988","West Virginia","11","1","0","0.91667","493","208","285"
"1989","West Virginia","8","3","1","0.70833","339","221","118"
"1990","West Virginia","4","7","0","0.36364","217","238","-21"
"1991","West Virginia","6","5","0","0.54545","187","224","-37"
"1992","West Virginia","5","4","2","0.54545","286","238","48"
"1993","West Virginia","11","1","0","0.91667","408","212","196"
"1994","West Virginia","7","6","0","0.53846","296","286","10"
"1995","West Virginia","5","6","0","0.45455","253","210","43"
"1996","West Virginia","8","4","0","0.66667","271","156","115"
"1997","West Virginia","7","5","0","0.58333","360","285","75"
"1998","West Virginia","8","4","0","0.66667","410","267","143"
"1999","West Virginia","4","7","0","0.36364","292","289","3"
"2000","West Virginia","7","5","0","0.58333","356","363","-7"
"1990","Glenville St. (WV)","1","7","1","0.16667","147","310","-163"
"1991","Glenville St. (WV)","4","5","1","0.45000","253","231","22"
"1992","Glenville St. (WV)","6","4","0","0.60000","334","199","135"
"1993","Glenville St. (WV)","10","3","0","0.76923","426","177","249"
"1994","Glenville St. (WV)","8","3","0","0.72727","416","291","125"
"1995","Glenville St. (WV)","8","2","0","0.80000","345","123","222"
"1996","Glenville St. (WV)","6","4","0","0.60000","348","309","39"
"2001","West Virginia","3","8","0","0.27273","235","268","-33"
"2002","West Virginia","9","4","0","0.69231","396","302","94"
"2003","West Virginia","8","5","0","0.61538","376","297","79"
"2004","West Virginia","8","4","0","0.66667","361","246","115"
"2005","West Virginia","11","1","0","0.91667","385","214","171"
"2006","West Virginia","11","2","0","0.84615","505","282","223"
"2007","West Virginia","10","2","0","0.83333","467","207","260"
"2008","Michigan","3","9","0","0.25000","243","347","-104"
"2009","Michigan","5","7","0","0.41667","354","330","24"
"2010","Michigan","7","6","0","0.53846","426","458","-32"
"2012","Arizona","8","5","0","0.61538","496","459","37"
"2013","Arizona","8","5","0","0.61538","435","315","120"
"1994","Virginia Military Institute","1","10","0","0.09091","153","437","-284"
"1995","Virginia Military Institute","4","7","0","0.36364","269","350","-81"
"1996","Virginia Military Institute","3","8","0","0.27273","189","296","-107"
"2007","West Virginia","1","0","0","1.00000","48","28","20"
"2008","West Virginia","9","4","0","0.69231","319","221","98"
"2009","West Virginia","9","4","0","0.69231","340","282","58"
"2010","West Virginia","9","4","0","0.69231","327","176","151"
"2011","West Virginia","10","3","0","0.76923","489","348","141"
"2012","West Virginia","7","6","0","0.53846","513","495","18"
"2013","West Virginia","4","8","0","0.33333","316","400","-84"
"1913","Western Kentucky","1","0","0","1.00000","20","0","20"
"1914","Western Kentucky","1","2","0","0.33333","24","81","-57"
"1915","Western Kentucky","1","3","2","0.33333","20","111","-91"
"1916","Western Kentucky","3","2","0","0.60000","28","29","-1"
"1920","Western Kentucky","0","1","0","0.00000","0","13","-13"
"1921","Western Kentucky","2","4","1","0.35714","47","86","-39"
"1922","Western Kentucky","9","1","1","0.86364","284","38","246"
"1923","Western Kentucky","5","5","0","0.50000","126","186","-60"
"1924","Western Kentucky","4","5","0","0.44444","224","119","105"
"1925","Western Kentucky","3","5","1","0.38889","52","91","-39"
"1926","Western Kentucky","4","4","1","0.50000","155","69","86"
"1927","Western Kentucky","5","4","0","0.55556","140","94","46"
"1928","Western Kentucky","8","1","0","0.88889","171","7","164"
"1930","Western Kentucky","8","1","1","0.85000","184","58","126"
"1931","Western Kentucky","8","4","0","0.66667","172","126","46"
"1927","Kentucky Wesleyan","6","3","0","0.66667","143","50","93"
"1932","Western Kentucky","7","1","0","0.87500","220","40","180"
"1929","Western Kentucky","7","3","0","0.70000","185","32","153"
"1934","Western Kentucky","4","2","2","0.62500","128","43","85"
"1935","Western Kentucky","7","3","0","0.70000","194","57","137"
"1936","Western Kentucky","6","3","0","0.66667","123","55","68"
"1937","Western Kentucky","7","1","1","0.83333","146","20","126"
"1951","Howard Payne (TX)","4","4","0","0.50000","199","187","12"
"1952","Howard Payne (TX)","3","6","0","0.33333","127","281","-154"
"1938","Western Kentucky","7","2","0","0.77778","217","46","171"
"1939","Western Kentucky","7","1","1","0.83333","132","52","80"
"1940","Western Kentucky","7","1","1","0.83333","115","20","95"
"1941","Western Kentucky","4","5","1","0.45000","128","149","-21"
"1946","San Diego St. (CA)","6","4","0","0.60000","152","105","47"
"1942","Western Kentucky","3","4","1","0.43750","70","167","-97"
"1933","Western Kentucky","6","2","0","0.75000","181","39","142"
"1946","Western Kentucky","2","6","0","0.25000","85","213","-128"
"1947","Western Kentucky","3","4","2","0.44444","82","145","-63"
"1948","Western Kentucky","5","4","0","0.55556","152","130","22"
"1949","Western Kentucky","5","4","0","0.55556","103","121","-18"
"1950","Western Kentucky","6","2","2","0.70000","199","176","23"
"1951","Western Kentucky","4","5","0","0.44444","204","161","43"
"1952","Western Kentucky","9","1","0","0.90000","336","119","217"
"1953","Western Kentucky","6","4","0","0.60000","203","130","73"
"1954","Western Kentucky","7","3","0","0.70000","171","125","46"
"1955","Western Kentucky","3","6","0","0.33333","119","140","-21"
"1956","Western Kentucky","5","4","0","0.55556","120","151","-31"
"1957","Northwestern St. (LA)","7","2","0","0.77778","175","101","74"
"1958","Northwestern St. (LA)","8","2","0","0.80000","275","89","186"
"1959","Northwestern St. (LA)","4","5","1","0.45000","152","152","0"
"1960","Northwestern St. (LA)","3","6","0","0.33333","82","91","-9"
"1961","Northwestern St. (LA)","7","3","0","0.70000","249","156","93"
"1962","Northwestern St. (LA)","7","2","1","0.75000","209","97","112"
"1963","Northwestern St. (LA)","4","6","0","0.40000","170","178","-8"
"1964","Northwestern St. (LA)","4","5","0","0.44444","206","162","44"
"1965","Northwestern St. (LA)","5","4","0","0.55556","171","189","-18"
"1966","Northwestern St. (LA)","9","0","0","1.00000","236","79","157"
"1957","Western Kentucky","5","3","1","0.61111","123","139","-16"
"1958","Western Kentucky","4","5","0","0.44444","104","87","17"
"1959","Western Kentucky","5","4","0","0.55556","123","145","-22"
"1960","Western Kentucky","2","6","1","0.27778","107","163","-56"
"1961","Western Kentucky","6","3","0","0.66667","126","88","38"
"1962","Western Kentucky","5","3","0","0.62500","108","92","16"
"1963","Western Kentucky","10","0","1","0.95455","309","79","230"
"1964","Western Kentucky","6","3","1","0.65000","169","79","90"
"1965","Western Kentucky","2","6","2","0.30000","119","236","-117"
"1966","Western Kentucky","5","5","0","0.50000","208","185","23"
"1967","Western Kentucky","7","1","1","0.83333","276","98","178"
"1968","Western Kentucky","7","2","1","0.75000","281","70","211"
"1969","Western Kentucky","6","3","1","0.65000","253","140","113"
"1970","Western Kentucky","8","1","1","0.85000","244","76","168"
"1971","Western Kentucky","8","2","0","0.80000","262","100","162"
"1972","Western Kentucky","7","3","0","0.70000","194","97","97"
"1973","Western Kentucky","12","1","0","0.92308","430","132","298"
"1974","Western Kentucky","7","3","0","0.70000","260","95","165"
"1975","Western Kentucky","11","2","0","0.84615","245","112","133"
"1976","Western Kentucky","4","5","1","0.45000","130","153","-23"
"1977","Western Kentucky","1","8","1","0.15000","124","252","-128"
"1978","Western Kentucky","8","2","0","0.80000","254","157","97"
"1979","Western Kentucky","5","5","0","0.50000","223","217","6"
"1980","Western Kentucky","9","1","0","0.90000","228","157","71"
"1981","Western Kentucky","6","5","0","0.54545","241","204","37"
"1982","Western Kentucky","5","5","0","0.50000","186","200","-14"
"1983","Western Kentucky","2","8","1","0.22727","147","203","-56"
"1984","Western Kentucky","2","9","0","0.18182","193","345","-152"
"1985","Western Kentucky","4","7","0","0.36364","232","313","-81"
"1986","Western Kentucky","4","6","1","0.40909","228","258","-30"
"1987","Western Kentucky","7","4","0","0.63636","263","217","46"
"1988","Western Kentucky","9","4","0","0.69231","311","220","91"
"1989","Louisiana-Monroe","5","5","1","0.50000","201","257","-56"
"1990","Louisiana-Monroe","7","5","0","0.58333","208","218","-10"
"1991","Louisiana-Monroe","7","3","1","0.68182","237","175","62"
"1992","Louisiana-Monroe","10","3","0","0.76923","490","295","195"
"1993","Louisiana-Monroe","9","3","0","0.75000","462","275","187"
"1997","Baylor (TX)","2","9","0","0.18182","200","375","-175"
"1998","Baylor (TX)","2","9","0","0.18182","195","323","-128"
"1982","Western Michigan","7","2","2","0.72727","186","78","108"
"1983","Western Michigan","6","5","0","0.54545","179","208","-29"
"1984","Western Michigan","5","6","0","0.45455","234","213","21"
"1985","Western Michigan","4","6","1","0.40909","182","212","-30"
"1986","Western Michigan","4","7","0","0.36364","183","257","-74"
"1989","Western Kentucky","6","5","0","0.54545","279","238","41"
"1990","Western Kentucky","2","8","0","0.20000","159","234","-75"
"1991","Western Kentucky","3","8","0","0.27273","235","301","-66"
"1992","Western Kentucky","4","6","0","0.40000","243","258","-15"
"1993","Western Kentucky","8","3","0","0.72727","310","228","82"
"1994","Western Kentucky","5","6","0","0.45455","255","291","-36"
"1995","Western Kentucky","2","8","0","0.20000","229","341","-112"
"1996","Western Kentucky","7","4","0","0.63636","304","251","53"
"1997","Western Kentucky","10","2","0","0.83333","429","243","186"
"1998","Western Kentucky","7","4","0","0.63636","396","310","86"
"1999","Western Kentucky","6","5","0","0.54545","270","245","25"
"2000","Western Kentucky","11","2","0","0.84615","404","145","259"
"2001","Western Kentucky","8","4","0","0.66667","318","146","172"
"2002","Western Kentucky","12","3","0","0.80000","432","246","186"
"2003","Western Kentucky","9","4","0","0.69231","427","219","208"
"2004","Western Kentucky","9","3","0","0.75000","350","227","123"
"2005","Western Kentucky","6","5","0","0.54545","339","292","47"
"2006","Western Kentucky","6","5","0","0.54545","258","263","-5"
"2007","Western Kentucky","7","5","0","0.58333","398","250","148"
"2008","Western Kentucky","2","10","0","0.16667","210","326","-116"
"2009","Western Kentucky","0","12","0","0.00000","245","475","-230"
"2010","Miami (OH)","1","0","0","1.00000","35","21","14"
"2012","Western Kentucky","0","1","0","0.00000","21","24","-3"
"2010","Western Kentucky","2","10","0","0.16667","274","398","-124"
"2011","Western Kentucky","7","5","0","0.58333","275","298","-23"
"2012","Western Kentucky","7","5","0","0.58333","345","307","38"
"2013","South Florida","2","10","0","0.16667","165","343","-178"
"2003","Louisville (KY)","9","4","0","0.69231","450","361","89"
"2004","Louisville (KY)","11","1","0","0.91667","597","236","361"
"2005","Louisville (KY)","9","3","0","0.75000","521","285","236"
"2006","Louisville (KY)","12","1","0","0.92308","491","212","279"
"2008","Arkansas","5","7","0","0.41667","263","374","-111"
"2009","Arkansas","8","5","0","0.61538","468","326","142"
"2010","Arkansas","10","3","0","0.76923","474","304","170"
"2011","Arkansas","11","2","0","0.84615","478","289","189"
"2013","Western Kentucky","8","4","0","0.66667","370","295","75"
"1872","Stevens Tech (NJ)","0","1","0","0.00000","0","6","-6"
"1873","New York (NY)","3","3","0","0.50000","15","13","2"
"1874","Stevens Tech (NJ)","2","3","0","0.40000","10","20","-10"
"1875","Stevens Tech (NJ)","4","4","0","0.50000","21","20","1"
"1876","New York (NY)","2","3","1","0.41667","16","19","-3"
"1877","Stevens Tech (NJ)","3","1","2","0.66667","9","14","-5"
"1878","Stevens Tech (NJ)","3","3","3","0.50000","3","9","-6"
"1879","Stevens Tech (NJ)","2","3","5","0.45000","8","14","-6"
"1880","Stevens Tech (NJ)","1","5","0","0.16667","3","16","-13"
"1881","Stevens Tech (NJ)","3","8","3","0.32143","16","29","-13"
"1882","Lawrence (WI)","7","8","1","0.46875","17","25","-8"
"1883","Stevens Tech (NJ)","7","6","1","0.53571","187","128","59"
"1884","Fordham (NY)","9","10","0","0.47368","221","261","-40"
"1885","Georgetown (DC)","5","17","1","0.23913","359","612","-253"
"1886","New York (NY)","9","15","2","0.38462","180","565","-385"
"1887","Fordham (NY)","8","12","1","0.40476","157","445","-288"
"1888","Amherst (MA)","6","17","3","0.28846","192","791","-599"
"1889","New York (NY)","8","21","4","0.30303","278","647","-369"
"1890","New York (NY)","25","14","2","0.63415","727","538","189"
"1891","Delaware","32","30","7","0.51449","966","971","-5"
"1892","Beloit (WI)","29","31","3","0.48413","726","797","-71"
"1893","Marquette (WI)","39","34","3","0.53289","1091","885","206"
"1894","Manhattan (NY)","32","29","7","0.52206","853","692","161"
"1895","Delaware","44","35","6","0.55294","889","813","76"
"1896","Manhattan (NY)","51","49","6","0.50943","949","1164","-215"
"1897","Stevens Tech (NJ)","37","50","4","0.42857","661","1048","-387"
"1898","Manhattan (NY)","37","43","9","0.46629","781","1050","-269"
"1899","Manhattan (NY)","34","40","6","0.46250","594","1063","-469"
"1900","Manhattan (NY)","43","47","11","0.48020","991","1049","-58"
"1901","Ferris St. (MI)","51","44","7","0.53431","906","852","54"
"1902","Indiana St.","56","48","5","0.53670","1053","927","126"
"1903","Manhattan (NY)","30","49","7","0.38953","762","1319","-557"
"1904","Saint Francis (NY)","44","53","9","0.45755","787","1363","-576"
"1905","Bluffton (OH)","38","59","5","0.39706","850","1433","-583"
"1906","Ferris St. (MI)","32","43","12","0.43678","677","854","-177"
"1907","Ferris St. (MI)","32","48","10","0.41111","722","1208","-486"
"1908","Western Illinois","36","45","10","0.45055","760","1069","-309"
"1909","Delaware Valley (PA)","27","52","2","0.34568","682","1287","-605"
"1910","East Stroudsburg (PA)","23","31","3","0.42982","583","738","-155"
"1911","Western Illinois","32","44","7","0.42771","661","902","-241"
"1912","Indiana (PA)","36","56","7","0.39899","1134","1463","-329"
"1913","Saint Francis (NY)","52","67","8","0.44094","1672","2360","-688"
"1914","Delaware Valley (PA)","41","50","6","0.45361","1217","1585","-368"
"1915","Western Illinois","34","35","11","0.49375","932","1217","-285"
"1916","Morgan St. (MD)","44","43","7","0.50532","1493","1270","223"
"1917","Morgan St. (MD)","21","21","2","0.50000","408","883","-475"
"1918","Oklahoma Baptist University","7","16","2","0.32000","258","358","-100"
"1919","Western Illinois","53","41","8","0.55882","1478","1056","422"
"1920","Virginia Union","28","39","2","0.42029","506","893","-387"
"1921","Cooper Union (NY)","19","34","3","0.36607","441","1112","-671"
"1922","Cooper Union (NY)","27","34","6","0.44776","703","832","-129"
"1923","Cooper Union (NY)","31","45","2","0.41026","718","1112","-394"
"1924","East Stroudsburg (PA)","34","40","6","0.46250","946","1175","-229"
"1925","Saint Anselm (NH)","32","28","10","0.52857","847","802","45"
"1926","Saint Anselm (NH)","22","30","4","0.42857","515","702","-187"
"1927","Bethune-Cookman (FL)","20","29","8","0.42105","674","783","-109"
"1928","Saint Anselm (NH)","28","24","7","0.53390","564","1095","-531"
"1929","Saint Anselm (NH)","25","32","5","0.44355","616","843","-227"
"1930","Saint Anselm (NH)","31","27","10","0.52941","643","549","94"
"1931","Campbell (NC)","21","17","4","0.54762","465","428","37"
"1932","Campbell (NC)","7","30","3","0.21250","254","760","-506"
"1933","Campbell (NC)","11","13","3","0.46296","262","324","-62"
"1934","Bowie St. (MD)","4","7","2","0.38462","116","94","22"
"1935","Florida Southern","7","12","1","0.37500","170","162","8"
"1936","Bowie St. (MD)","5","2","1","0.68750","154","97","57"
"1937","Bowie St. (MD)","6","3","0","0.66667","98","87","11"
"1938","West Alabama","7","5","0","0.58333","151","88","63"
"1939","Elizabeth City St. (NC)","7","13","0","0.35000","150","307","-157"
"1940","Elizabeth City St. (NC)","6","5","4","0.53333","128","67","61"
"1941","Arkansas-Pine Bluff","3","9","5","0.32353","178","223","-45"
"1942","Brevard College (NC)","10","6","2","0.61111","225","189","36"
"1943","Clark Atlanta (GA)","6","8","0","0.42857","127","206","-79"
"1944","Abilene Christian (TX)","9","11","1","0.45238","158","255","-97"
"1945","Benedict (SC)","10","15","2","0.40741","299","296","3"
"1946","Elizabeth City St. (NC)","7","20","3","0.28333","144","540","-396"
"1947","Clark Atlanta (GA)","3","6","2","0.36364","49","230","-181"
"1948","Virginia-Lynchburg","4","6","1","0.40909","77","302","-225"
"1949","Virginia-Lynchburg","0","3","1","0.12500","7","70","-63"
"1950","Virginia-Lynchburg","2","3","0","0.40000","53","98","-45"
"1951","Lane (TN)","8","6","0","0.57143","295","234","61"
"1952","Lane (TN)","9","5","1","0.63333","220","206","14"
"1953","Lane (TN)","1","7","0","0.12500","58","215","-157"
"1954","Lane (TN)","2","6","0","0.25000","105","135","-30"
"1955","Lane (TN)","2","4","0","0.33333","83","129","-46"
"1957","Louisiana College","2","7","0","0.22222","106","179","-73"
"1959","Azusa Pacific (CA)","2","3","0","0.40000","117","90","27"
"1960","Azusa Pacific (CA)","4","3","1","0.56250","103","76","27"
"1961","Azusa Pacific (CA)","3","3","0","0.50000","123","147","-24"
"1963","San Francisco (CA)","2","5","0","0.28571","58","98","-40"
"1964","New York (NY)","0","2","0","0.00000","20","48","-28"
"1965","Adelphi (NY)","4","8","0","0.33333","198","216","-18"
"1966","Fairfield (CT)","18","22","2","0.45238","545","652","-107"
"1967","La Salle (PA)","25","31","0","0.44643","846","1080","-234"
"1968","Centenary (LA)","17","42","2","0.29508","726","1393","-667"
"1969","Bluffton (OH)","33","43","0","0.43421","1058","1548","-490"
"1970","Saint John's (NY)","35","54","1","0.39444","1379","1783","-404"
"1971","Bluffton (OH)","43","45","1","0.48876","1360","1384","-24"
"1972","Marquette (WI)","39","44","2","0.47059","1217","1351","-134"
"1973","Brooklyn (NY)","30","52","1","0.36747","1007","1611","-604"
"1974","Marquette (WI)","33","36","3","0.47917","959","1169","-210"
"1975","Marquette (WI)","31","22","4","0.57895","1042","932","110"
"1976","Bluffton (OH)","23","33","1","0.41228","862","1186","-324"
"1977","Manhattan (NY)","14","28","1","0.33721","568","923","-355"
"1978","Fairfield (CT)","5","7","1","0.42308","194","203","-9"
"1979","Fairfield (CT)","7","8","0","0.46667","247","260","-13"
"1980","Westfield St. (MA)","6","5","4","0.53333","184","196","-12"
"1981","San Francisco (CA)","17","14","0","0.54839","567","498","69"
"1982","Manhattan (NY)","18","16","0","0.52941","580","644","-64"
"1983","SUNY-Stony Brook (NY)","15","11","0","0.57692","474","453","21"
"1984","Stonehill (MA)","7","12","0","0.36842","231","439","-208"
"1985","Manhattan (NY)","10","10","0","0.50000","313","316","-3"
"1986","Marquette (WI)","13","17","0","0.43333","497","564","-67"
"1987","Marquette (WI)","10","17","0","0.37037","389","487","-98"
"1988","Marquette (WI)","1","5","0","0.16667","80","125","-45"
"1989","Marquette (WI)","4","4","0","0.50000","209","151","58"
"1990","Marquette (WI)","1","7","0","0.12500","80","180","-100"
"1991","Marquette (WI)","1","5","0","0.16667","106","182","-76"
"1992","Marquette (WI)","2","5","0","0.28571","81","129","-48"
"1993","Marquette (WI)","7","1","0","0.87500","212","126","86"
"1994","Marquette (WI)","1","6","0","0.14286","125","184","-59"
"1995","Marquette (WI)","3","4","0","0.42857","141","191","-50"
"1996","Marquette (WI)","3","5","0","0.37500","139","182","-43"
"1998","Madison College (WI)","2","15","0","0.11765","221","613","-392"
"1999","Marquette (WI)","0","7","0","0.00000","110","298","-188"
"2000","Marquette (WI)","1","5","0","0.16667","60","96","-36"
"2001","Marquette (WI)","2","6","0","0.25000","144","179","-35"
"2002","Marquette (WI)","3","4","0","0.42857","127","208","-81"
"2003","Marquette (WI)","1","6","0","0.14286","71","151","-80"
"2004","Marquette (WI)","0","6","0","0.00000","53","238","-185"
"2005","Marquette (WI)","2","5","0","0.28571","92","226","-134"
"2006","Marquette (WI)","1","6","0","0.14286","62","206","-144"
"2007","Marquette (WI)","2","5","0","0.28571","140","215","-75"
"2008","Marquette (WI)","0","7","0","0.00000","61","304","-243"
"2009","Marquette (WI)","0","1","0","0.00000","0","22","-22"
"1906","Western Michigan","1","3","0","0.25000","26","40","-14"
"1907","Western Michigan","3","2","1","0.58333","44","8","36"
"1908","Western Michigan","3","3","0","0.50000","33","98","-65"
"1909","Western Michigan","7","0","0","1.00000","194","9","185"
"1910","Western Michigan","4","1","1","0.75000","75","20","55"
"1911","Western Michigan","2","3","0","0.40000","110","59","51"
"1912","Western Michigan","3","2","1","0.58333","86","50","36"
"1913","Western Michigan","4","0","0","1.00000","59","15","44"
"1914","Western Michigan","6","0","0","1.00000","180","7","173"
"1915","Western Michigan","5","1","0","0.83333","291","43","248"
"1916","Western Michigan","5","1","0","0.83333","389","38","351"
"1917","Western Michigan","4","3","0","0.57143","203","105","98"
"1918","Western Michigan","3","2","0","0.60000","223","30","193"
"1919","Western Michigan","4","1","0","0.80000","156","91","65"
"1920","Western Michigan","3","4","0","0.42857","119","133","-14"
"1921","Western Michigan","6","2","0","0.75000","262","40","222"
"1922","Minnesota","3","3","1","0.50000","79","65","14"
"1923","Minnesota","5","1","1","0.78571","114","60","54"
"1924","Minnesota","3","3","2","0.50000","68","63","5"
"1925","UCLA","5","3","1","0.61111","91","130","-39"
"1926","UCLA","5","3","0","0.62500","153","67","86"
"1927","UCLA","6","2","1","0.72222","144","54","90"
"1928","UCLA","4","4","1","0.50000","171","136","35"
"1929","UCLA","4","4","0","0.50000","121","190","-69"
"1930","UCLA","3","5","0","0.37500","77","125","-48"
"1931","UCLA","3","4","1","0.43750","83","57","26"
"1932","UCLA","6","4","0","0.60000","149","61","88"
"1933","UCLA","5","4","1","0.55000","89","62","27"
"1934","UCLA","7","3","0","0.70000","146","69","77"
"1935","UCLA","8","2","0","0.80000","160","79","81"
"1936","UCLA","6","3","1","0.65000","143","91","52"
"1937","UCLA","2","6","1","0.27778","93","133","-40"
"1938","UCLA","7","4","1","0.62500","217","106","111"
"1922","Western Michigan","6","0","0","1.00000","160","0","160"
"1923","Western Michigan","6","1","1","0.81250","159","21","138"
"1924","Western Michigan","5","1","1","0.78571","101","46","55"
"1925","Western Michigan","6","2","1","0.72222","125","47","78"
"1926","Western Michigan","7","1","0","0.87500","132","20","112"
"1927","Western Michigan","3","4","0","0.42857","100","75","25"
"1928","Western Michigan","5","2","0","0.71429","119","32","87"
"1929","Western Michigan","5","2","1","0.68750","161","44","117"
"1930","Western Michigan","5","1","1","0.78571","192","25","167"
"1931","Western Michigan","5","2","0","0.71429","86","51","35"
"1932","Western Michigan","6","0","1","0.92857","174","6","168"
"1933","Western Michigan","3","3","1","0.50000","66","64","2"
"1934","Western Michigan","7","1","0","0.87500","104","52","52"
"1935","Western Michigan","5","3","0","0.62500","78","91","-13"
"1936","Western Michigan","2","5","0","0.28571","60","90","-30"
"1937","Western Michigan","5","3","0","0.62500","92","65","27"
"1938","Western Michigan","4","3","0","0.57143","102","26","76"
"1939","Western Michigan","2","6","1","0.27778","51","85","-34"
"1940","Western Michigan","2","5","0","0.28571","77","117","-40"
"1941","Western Michigan","8","0","0","1.00000","183","27","156"
"1942","Western Michigan","5","1","0","0.83333","66","36","30"
"1943","Western Michigan","4","2","0","0.66667","151","89","62"
"1944","Western Michigan","4","3","0","0.57143","162","123","39"
"1945","Western Michigan","4","3","0","0.57143","147","105","42"
"1946","Western Michigan","5","2","1","0.68750","158","100","58"
"1947","Western Michigan","5","4","0","0.55556","139","147","-8"
"1948","Western Michigan","6","3","0","0.66667","199","106","93"
"1949","Western Michigan","4","4","0","0.50000","148","123","25"
"1950","Western Michigan","5","4","0","0.55556","188","163","25"
"1951","Western Michigan","4","4","0","0.50000","164","160","4"
"1952","Western Michigan","4","4","0","0.50000","154","159","-5"
"1953","Western Michigan","1","6","1","0.18750","66","238","-172"
"1954","Western Michigan","4","5","0","0.44444","136","186","-50"
"1955","Western Michigan","1","7","1","0.16667","80","200","-120"
"1956","Western Michigan","2","7","0","0.22222","114","168","-54"
"1957","Western Michigan","4","4","1","0.50000","150","127","23"
"1958","Western Michigan","4","5","0","0.44444","188","200","-12"
"1959","Western Michigan","4","5","0","0.44444","184","116","68"
"1960","Western Michigan","4","4","1","0.50000","173","106","67"
"1961","Western Michigan","5","4","1","0.55000","142","179","-37"
"1962","Western Michigan","5","4","0","0.55556","158","112","46"
"1963","Western Michigan","2","7","0","0.22222","111","201","-90"
"1964","Western Michigan","3","6","0","0.33333","77","185","-108"
"1965","Western Michigan","6","2","1","0.72222","128","127","1"
"1966","Western Michigan","7","3","0","0.70000","175","194","-19"
"1967","Western Michigan","5","4","0","0.55556","156","164","-8"
"1968","Western Michigan","3","6","0","0.33333","160","191","-31"
"1969","Western Michigan","4","6","0","0.40000","216","203","13"
"1970","Western Michigan","7","3","0","0.70000","277","132","145"
"1971","Western Michigan","7","3","0","0.70000","228","124","104"
"1972","Western Michigan","7","3","1","0.68182","229","201","28"
"1973","Western Michigan","6","5","0","0.54545","190","218","-28"
"1974","Western Michigan","3","8","0","0.27273","187","269","-82"
"1975","Western Michigan","1","10","0","0.09091","119","297","-178"
"1976","Western Michigan","7","4","0","0.63636","270","202","68"
"1977","Western Michigan","4","7","0","0.36364","254","231","23"
"1978","Western Michigan","7","4","0","0.63636","220","152","68"
"1979","Western Michigan","6","5","0","0.54545","186","127","59"
"1980","Western Michigan","7","4","0","0.63636","233","179","54"
"1981","Western Michigan","6","5","0","0.54545","206","170","36"
"1987","Navy (MD)","2","9","0","0.18182","160","317","-157"
"1988","Navy (MD)","3","8","0","0.27273","221","274","-53"
"1989","Navy (MD)","3","8","0","0.27273","145","272","-127"
"1982","Western Michigan","7","2","2","0.72727","186","78","108"
"1983","Western Michigan","6","5","0","0.54545","179","208","-29"
"1984","Western Michigan","5","6","0","0.45455","234","213","21"
"1985","Western Michigan","4","6","1","0.40909","182","212","-30"
"1986","Western Michigan","4","7","0","0.36364","183","257","-74"
"1989","Western Kentucky","6","5","0","0.54545","279","238","41"
"1990","Western Kentucky","2","8","0","0.20000","159","234","-75"
"1991","Western Kentucky","3","8","0","0.27273","235","301","-66"
"1992","Western Kentucky","4","6","0","0.40000","243","258","-15"
"1993","Western Kentucky","8","3","0","0.72727","310","228","82"
"1994","Western Kentucky","5","6","0","0.45455","255","291","-36"
"1995","Western Kentucky","2","8","0","0.20000","229","341","-112"
"1996","Western Kentucky","7","4","0","0.63636","304","251","53"
"1997","Western Kentucky","10","2","0","0.83333","429","243","186"
"1998","Western Kentucky","7","4","0","0.63636","396","310","86"
"1999","Western Kentucky","6","5","0","0.54545","270","245","25"
"2000","Western Kentucky","11","2","0","0.84615","404","145","259"
"2001","Western Kentucky","8","4","0","0.66667","318","146","172"
"2002","Western Kentucky","12","3","0","0.80000","432","246","186"
"1980","Central Missouri St.","6","3","1","0.65000","203","131","72"
"1981","Central Missouri St.","4","3","3","0.55000","128","102","26"
"1982","Central Missouri St.","7","3","0","0.70000","237","147","90"
"1983","Eastern Illinois","9","3","0","0.75000","265","122","143"
"1984","Eastern Illinois","6","5","0","0.54545","326","258","68"
"1985","Eastern Illinois","6","5","0","0.54545","261","272","-11"
"1986","Eastern Illinois","11","2","0","0.84615","459","227","232"
"1987","Western Michigan","5","6","0","0.45455","218","240","-22"
"1988","Western Michigan","9","3","0","0.75000","354","237","117"
"1989","Western Michigan","5","6","0","0.45455","210","210","0"
"1990","Western Michigan","7","4","0","0.63636","249","235","14"
"1991","Western Michigan","6","5","0","0.54545","218","253","-35"
"1992","Western Michigan","7","3","1","0.68182","197","177","20"
"1993","Western Michigan","7","3","1","0.68182","236","187","49"
"1994","Western Michigan","7","4","0","0.63636","274","189","85"
"1995","Western Michigan","7","4","0","0.63636","253","190","63"
"1996","Western Michigan","2","9","0","0.18182","208","304","-96"
"1983","Tennessee Tech","2","8","0","0.20000","97","226","-129"
"1984","Tennessee Tech","0","11","0","0.00000","78","329","-251"
"1985","Tennessee Tech","1","10","0","0.09091","177","314","-137"
"1989","Florida","3","4","0","0.42857","140","145","-5"
"1997","Western Michigan","8","3","0","0.72727","301","265","36"
"1998","Western Michigan","7","4","0","0.63636","360","312","48"
"1999","Western Michigan","7","5","0","0.58333","373","342","31"
"2000","Western Michigan","9","3","0","0.75000","359","139","220"
"2001","Western Michigan","5","6","0","0.45455","277","266","11"
"2002","Western Michigan","4","8","0","0.33333","303","330","-27"
"2003","Western Michigan","5","7","0","0.41667","331","370","-39"
"2004","Western Michigan","1","10","0","0.09091","248","436","-188"
"2007","Texas A&M","0","1","0","0.00000","17","24","-7"
"2005","Western Michigan","7","4","0","0.63636","354","342","12"
"2006","Western Michigan","8","5","0","0.61538","299","259","40"
"2007","Western Michigan","5","7","0","0.41667","323","347","-24"
"2008","Western Michigan","9","4","0","0.69231","372","324","48"
"2009","Western Michigan","5","7","0","0.41667","296","330","-34"
"2010","Western Michigan","6","6","0","0.50000","388","286","102"
"2011","Western Michigan","7","6","0","0.53846","459","373","86"
"2012","Western Michigan","4","8","0","0.33333","352","356","-4"
"2013","Western Michigan","1","11","0","0.08333","206","425","-219"
"1889","Wisconsin","0","2","0","0.00000","0","31","-31"
"1890","Wisconsin","1","3","0","0.25000","122","101","21"
"1891","Wisconsin","3","1","1","0.70000","98","30","68"
"1892","Wisconsin","4","4","0","0.50000","102","96","6"
"1893","Nebraska","3","2","1","0.58333","80","80","0"
"1894","Nebraska","7","2","0","0.77778","120","42","78"
"1895","Texas","5","0","0","1.00000","96","0","96"
"1893","Wisconsin","4","2","0","0.66667","112","110","2"
"1894","Amherst (MA)","7","5","1","0.57692","110","126","-16"
"1895","Lafayette (PA)","6","2","0","0.75000","162","62","100"
"1896","Lafayette (PA)","11","0","1","0.95833","240","10","230"
"1897","Lafayette (PA)","9","2","1","0.79167","256","113","143"
"1894","Wisconsin","5","2","0","0.71429","158","20","138"
"1895","Wisconsin","5","2","1","0.68750","144","71","73"
"1896","Wisconsin","7","1","1","0.83333","206","30","176"
"1897","Wisconsin","9","1","0","0.90000","210","14","196"
"1898","Wisconsin","9","1","0","0.90000","318","17","301"
"1899","Wisconsin","10","2","0","0.83333","299","33","266"
"1900","Wisconsin","8","1","0","0.88889","300","11","289"
"1901","Wisconsin","9","0","0","1.00000","316","5","311"
"1902","Wisconsin","6","3","0","0.66667","228","39","189"
"1903","Georgetown (DC)","7","3","0","0.70000","195","50","145"
"1905","Wisconsin","8","2","0","0.80000","226","28","198"
"1902","Kansas","6","4","0","0.60000","108","93","15"
"1903","Wisconsin","6","3","1","0.65000","305","67","238"
"1904","Wisconsin","5","3","0","0.62500","265","74","191"
"1904","Syracuse (NY)","6","3","0","0.66667","405","57","348"
"1905","Syracuse (NY)","8","3","0","0.72727","224","69","155"
"1906","Wisconsin","5","0","0","1.00000","78","15","63"
"1907","Wisconsin","3","1","1","0.70000","50","51","-1"
"1906","Notre Dame (IN)","6","1","0","0.85714","107","12","95"
"1907","Notre Dame (IN)","6","0","1","0.92857","137","20","117"
"1908","Wisconsin","5","1","0","0.83333","101","39","62"
"1909","Wisconsin","3","1","1","0.70000","61","54","7"
"1910","Wisconsin","1","2","2","0.40000","19","46","-27"
"1911","Denver (CO)","5","2","1","0.68750","81","22","59"
"1911","Wisconsin","5","1","1","0.78571","111","14","97"
"1912","Ohio St.","6","3","0","0.66667","244","122","122"
"1917","Wisconsin","4","2","1","0.64286","85","30","55"
"1919","Wisconsin","5","2","0","0.71429","91","41","50"
"1920","Wisconsin","6","1","0","0.85714","141","29","112"
"1921","Wisconsin","5","1","1","0.78571","141","13","128"
"1922","Wisconsin","4","2","1","0.64286","101","22","79"
"1906","South Dakota St.","3","1","0","0.75000","52","34","18"
"1907","South Dakota St.","5","2","0","0.71429","108","42","66"
"1908","Marquette (WI)","7","5","2","0.57143","238","77","161"
"1909","Marquette (WI)","2","2","1","0.50000","38","16","22"
"1910","Marquette (WI)","6","1","2","0.77778","267","11","256"
"1911","Marquette (WI)","7","0","2","0.88889","168","31","137"
"1912","Wisconsin","7","0","0","1.00000","246","29","217"
"1913","Wisconsin","3","3","1","0.50000","100","66","34"
"1914","Wisconsin","4","2","1","0.64286","102","51","51"
"1915","Wisconsin","4","3","0","0.57143","235","54","181"
"1917","Texas","4","4","0","0.50000","89","40","49"
"1918","Texas","9","0","0","1.00000","194","14","180"
"1919","Texas","6","3","0","0.66667","181","63","118"
"1920","Kentucky","3","4","1","0.43750","113","109","4"
"1921","Kentucky","4","3","1","0.56250","157","89","68"
"1922","Kentucky","6","3","0","0.66667","167","56","111"
"1916","Wisconsin","4","2","1","0.64286","104","78","26"
"1924","Columbia (NY)","1","2","1","0.37500","60","37","23"
"1910","Alabama","4","4","0","0.50000","65","107","-42"
"1911","Kansas St.","5","4","1","0.55000","47","87","-40"
"1912","Kansas St.","8","2","0","0.80000","204","103","101"
"1913","Kansas St.","3","4","1","0.43750","97","122","-25"
"1914","Kansas St.","1","5","1","0.21429","44","150","-106"
"1918","Wisconsin","3","3","0","0.50000","42","44","-2"
"1917","Marquette (WI)","8","0","1","0.94444","341","7","334"
"1918","Marquette (WI)","2","0","1","0.83333","20","18","2"
"1919","Marquette (WI)","5","1","2","0.75000","131","19","112"
"1920","Marquette (WI)","7","2","0","0.77778","211","64","147"
"1921","Marquette (WI)","6","2","1","0.72222","138","29","109"
"1923","Wisconsin","3","3","1","0.50000","89","32","57"
"1924","Wisconsin","2","3","3","0.43750","66","94","-28"
"1914","Cincinnati (OH)","6","3","0","0.66667","164","44","120"
"1915","Cincinnati (OH)","4","5","0","0.44444","110","158","-48"
"1916","Miami (OH)","7","0","1","0.93750","238","12","226"
"1919","Miami (OH)","7","1","0","0.87500","147","32","115"
"1920","Miami (OH)","5","2","1","0.68750","114","38","76"
"1921","Miami (OH)","8","0","0","1.00000","238","13","225"
"1924","Michigan","6","2","0","0.75000","155","54","101"
"1925","Wisconsin","6","1","1","0.81250","131","50","81"
"1926","Wisconsin","5","2","1","0.68750","122","72","50"
"1922","Northwestern (IL)","3","3","1","0.50000","119","92","27"
"1923","Northwestern (IL)","2","6","0","0.25000","90","112","-22"
"1924","Northwestern (IL)","4","4","0","0.50000","109","66","43"
"1925","Northwestern (IL)","5","3","0","0.62500","81","69","12"
"1926","Northwestern (IL)","7","1","0","0.87500","179","22","157"
"1927","Wisconsin","4","4","0","0.50000","96","75","21"
"1928","Wisconsin","7","1","1","0.83333","163","38","125"
"1929","Wisconsin","4","5","0","0.44444","88","78","10"
"1930","Wisconsin","6","2","1","0.72222","227","40","187"
"1931","Wisconsin","5","4","1","0.55000","105","110","-5"
"1934","Richmond (VA)","8","1","0","0.88889","126","32","94"
"1935","Richmond (VA)","3","3","3","0.50000","64","65","-1"
"1936","Richmond (VA)","4","4","2","0.50000","61","81","-20"
"1937","Richmond (VA)","5","4","1","0.55000","78","103","-25"
"1938","Richmond (VA)","6","3","1","0.65000","91","59","32"
"1939","Richmond (VA)","7","1","2","0.80000","155","20","135"
"1940","Richmond (VA)","6","3","0","0.66667","141","80","61"
"1941","Richmond (VA)","2","7","0","0.22222","57","184","-127"
"1917","Dartmouth (NH)","5","3","0","0.62500","83","68","15"
"1918","Dartmouth (NH)","3","3","0","0.50000","78","83","-5"
"1919","Dartmouth (NH)","6","1","1","0.81250","141","53","88"
"1920","Dartmouth (NH)","7","2","0","0.77778","199","68","131"
"1921","West Virginia","5","4","1","0.55000","161","82","79"
"1922","West Virginia","10","0","1","0.95455","267","34","233"
"1923","West Virginia","7","1","1","0.83333","297","41","256"
"1924","West Virginia","8","1","0","0.88889","282","47","235"
"1925","Minnesota","5","2","1","0.68750","176","91","85"
"1926","Minnesota","5","3","0","0.62500","269","57","212"
"1927","Minnesota","6","0","2","0.87500","209","51","158"
"1928","Minnesota","6","2","0","0.75000","182","36","146"
"1929","Minnesota","6","2","0","0.75000","179","55","124"
"1930","Oregon","7","2","0","0.77778","131","35","96"
"1931","Oregon","6","2","2","0.70000","90","87","3"
"1932","Wisconsin","6","1","1","0.81250","151","48","103"
"1933","Wisconsin","2","5","1","0.31250","54","79","-25"
"1934","Wisconsin","4","4","0","0.50000","48","84","-36"
"1935","Wisconsin","1","7","0","0.12500","53","171","-118"
"1936","Toledo (OH)","2","6","0","0.25000","94","58","36"
"1937","Toledo (OH)","6","3","0","0.66667","128","96","32"
"1938","Toledo (OH)","6","3","1","0.65000","156","83","73"
"1939","Toledo (OH)","7","3","0","0.70000","180","59","121"
"1940","Toledo (OH)","6","3","0","0.66667","146","78","68"
"1941","Toledo (OH)","7","4","0","0.63636","195","122","73"
"1942","Toledo (OH)","4","4","1","0.50000","91","114","-23"
"1943","Maryland","4","5","0","0.44444","105","194","-89"
"1944","Maryland","1","7","1","0.16667","46","170","-124"
"1925","Villanova (PA)","6","2","1","0.72222","107","40","67"
"1926","Villanova (PA)","6","2","1","0.72222","219","76","143"
"1927","Villanova (PA)","6","1","0","0.85714","181","56","125"
"1928","Villanova (PA)","7","0","1","0.93750","133","34","99"
"1929","Villanova (PA)","7","2","1","0.75000","187","73","114"
"1930","Villanova (PA)","5","5","0","0.50000","86","81","5"
"1931","Villanova (PA)","4","3","2","0.55556","131","62","69"
"1932","Villanova (PA)","7","2","0","0.77778","192","53","139"
"1933","Villanova (PA)","7","2","1","0.75000","234","54","180"
"1934","Villanova (PA)","3","4","2","0.44444","100","54","46"
"1935","Villanova (PA)","7","2","0","0.77778","199","67","132"
"1936","Wisconsin","2","6","0","0.25000","95","144","-49"
"1937","Wisconsin","4","3","1","0.56250","103","61","42"
"1938","Wisconsin","5","3","0","0.62500","111","93","18"
"1939","Wisconsin","1","6","1","0.18750","54","113","-59"
"1940","Wisconsin","4","4","0","0.50000","125","134","-9"
"1941","Wisconsin","3","5","0","0.37500","144","208","-64"
"1942","Wisconsin","8","1","1","0.85000","149","68","81"
"1943","Wisconsin","1","9","0","0.10000","41","282","-241"
"1944","Wisconsin","3","6","0","0.33333","112","180","-68"
"1945","Wisconsin","3","4","2","0.44444","128","128","0"
"1946","Wisconsin","4","5","0","0.44444","140","144","-4"
"1947","Wisconsin","5","3","1","0.61111","171","156","15"
"1948","Wisconsin","2","7","0","0.22222","126","193","-67"
"1947","Lafayette (PA)","6","3","0","0.66667","89","156","-67"
"1948","Lafayette (PA)","7","2","0","0.77778","277","171","106"
"1949","Wisconsin","5","3","1","0.61111","207","129","78"
"1950","Wisconsin","6","3","0","0.66667","137","97","40"
"1951","Wisconsin","7","1","1","0.83333","196","53","143"
"1952","Wisconsin","6","3","1","0.65000","228","150","78"
"1953","Wisconsin","6","2","1","0.72222","179","110","69"
"1954","Wisconsin","7","2","0","0.77778","200","98","102"
"1955","Wisconsin","4","5","0","0.44444","172","166","6"
"1956","Wisconsin","1","5","3","0.27778","93","129","-36"
"1957","Wisconsin","6","3","0","0.66667","234","122","112"
"1958","Wisconsin","7","1","1","0.83333","201","77","124"
"1959","Wisconsin","7","3","0","0.70000","165","149","16"
"1960","Wisconsin","4","5","0","0.44444","148","183","-35"
"1961","Wisconsin","6","3","0","0.66667","179","158","21"
"1962","Wisconsin","8","2","0","0.80000","322","130","192"
"1963","Wisconsin","5","4","0","0.55556","150","124","26"
"1964","Wisconsin","3","6","0","0.33333","98","190","-92"
"1965","Wisconsin","2","7","1","0.25000","81","291","-210"
"1966","Wisconsin","3","6","1","0.35000","87","212","-125"
"1967","Wisconsin","0","9","1","0.05000","120","224","-104"
"1968","Wisconsin","0","10","0","0.00000","86","310","-224"
"1969","Wisconsin","3","7","0","0.30000","196","349","-153"
"1970","Wisconsin","4","5","1","0.45000","198","195","3"
"1971","Wisconsin","4","6","1","0.40909","240","258","-18"
"1972","Wisconsin","4","7","0","0.36364","152","229","-77"
"1973","Wisconsin","4","7","0","0.36364","216","237","-21"
"1974","Wisconsin","7","4","0","0.63636","341","243","98"
"1975","Wisconsin","4","6","1","0.40909","174","269","-95"
"1976","Wisconsin","5","6","0","0.45455","298","266","32"
"1977","Wisconsin","5","6","0","0.45455","133","200","-67"
"1971","Ball St. (IN)","4","5","1","0.45000","136","155","-19"
"1972","Ball St. (IN)","5","4","1","0.55000","235","180","55"
"1973","Ball St. (IN)","5","5","1","0.50000","226","201","25"
"1974","Ball St. (IN)","6","4","0","0.60000","265","177","88"
"1975","Ball St. (IN)","9","2","0","0.81818","244","171","73"
"1976","Ball St. (IN)","8","3","0","0.72727","257","124","133"
"1977","Ball St. (IN)","9","2","0","0.81818","377","169","208"
"1978","Wisconsin","5","4","2","0.54545","223","277","-54"
"1979","Wisconsin","4","7","0","0.36364","208","311","-103"
"1980","Wisconsin","4","7","0","0.36364","138","211","-73"
"1981","Wisconsin","7","5","0","0.58333","268","219","49"
"1982","Wisconsin","7","5","0","0.58333","287","252","35"
"1983","Wisconsin","7","4","0","0.63636","359","242","117"
"1984","Wisconsin","7","4","1","0.62500","242","206","36"
"1985","Wisconsin","5","6","0","0.45455","231","263","-32"
"1986","Wisconsin","3","9","0","0.25000","201","266","-65"
"1979","North Dakota St.","6","4","0","0.60000","217","164","53"
"1980","North Dakota St.","6","4","0","0.60000","204","163","41"
"1981","North Dakota St.","10","3","0","0.76923","322","185","137"
"1982","North Dakota St.","12","1","0","0.92308","294","130","164"
"1983","North Dakota St.","12","1","0","0.92308","326","171","155"
"1984","North Dakota St.","11","2","0","0.84615","463","225","238"
"1985","Tulsa (OK)","6","5","0","0.54545","274","328","-54"
"1986","Tulsa (OK)","7","4","0","0.63636","293","186","107"
"1987","Wisconsin","3","8","0","0.27273","202","299","-97"
"1988","Wisconsin","1","10","0","0.09091","106","314","-208"
"1989","Wisconsin","2","9","0","0.18182","172","341","-169"
"1990","Wisconsin","1","10","0","0.09091","133","285","-152"
"1991","Wisconsin","5","6","0","0.45455","172","194","-22"
"1992","Wisconsin","5","6","0","0.45455","212","199","13"
"1993","Wisconsin","10","1","1","0.87500","354","195","159"
"1994","Wisconsin","8","3","1","0.70833","357","238","119"
"1995","Wisconsin","4","5","2","0.45455","235","253","-18"
"1996","Wisconsin","8","5","0","0.61538","377","243","134"
"1997","Wisconsin","8","5","0","0.61538","291","306","-15"
"1998","Wisconsin","11","1","0","0.91667","382","143","239"
"1999","Wisconsin","10","2","0","0.83333","409","154","255"
"2000","Wisconsin","9","4","0","0.69231","328","265","63"
"2001","Wisconsin","5","7","0","0.41667","313","346","-33"
"2002","Wisconsin","8","6","0","0.57143","372","322","50"
"2003","Wisconsin","7","6","0","0.53846","355","306","49"
"2004","Wisconsin","9","3","0","0.75000","249","185","64"
"2005","Wisconsin","10","3","0","0.76923","446","309","137"
"2012","Wisconsin","0","1","0","0.00000","14","20","-6"
"2006","Wisconsin","12","1","0","0.92308","380","157","223"
"2007","Wisconsin","9","4","0","0.69231","383","301","82"
"2008","Wisconsin","7","6","0","0.53846","357","345","12"
"2009","Wisconsin","10","3","0","0.76923","413","283","130"
"2010","Wisconsin","11","2","0","0.84615","539","267","272"
"2011","Wisconsin","11","3","0","0.78571","618","266","352"
"2012","Wisconsin","8","5","0","0.61538","400","248","152"
"2013","Arkansas","3","9","0","0.25000","248","369","-121"
"2003","Southern Utah","4","7","0","0.36364","240","283","-43"
"2009","Utah St.","4","8","0","0.33333","349","408","-59"
"2010","Utah St.","4","8","0","0.33333","264","405","-141"
"2011","Utah St.","7","6","0","0.53846","437","363","74"
"2012","Utah St.","11","2","0","0.84615","454","200","254"
"2013","Wisconsin","9","4","0","0.69231","453","212","241"
"1894","Wyoming","3","0","0","1.00000","46","6","40"
"1895","Wyoming","1","0","0","1.00000","34","0","34"
"1896","Wyoming","2","0","0","1.00000","28","20","8"
"1897","Wyoming","2","0","0","1.00000","20","0","20"
"1899","Wyoming","0","1","1","0.25000","5","17","-12"
"1893","Wyoming","1","0","0","1.00000","14","0","14"
"1898","Wyoming","0","4","0","0.00000","8","95","-87"
"1900","Wyoming","3","3","0","0.50000","104","59","45"
"1901","Wyoming","1","0","0","1.00000","38","0","38"
"1902","Wyoming","1","0","0","1.00000","18","0","18"
"1903","Wyoming","3","2","0","0.60000","32","63","-31"
"1904","Wyoming","4","1","1","0.75000","97","35","62"
"1905","Wyoming","3","4","0","0.42857","63","162","-99"
"1906","Wyoming","1","1","0","0.50000","12","35","-23"
"1907","Wyoming","2","1","0","0.66667","68","77","-9"
"1908","Wyoming","1","2","0","0.33333","66","95","-29"
"1909","Wyoming","2","5","0","0.28571","68","170","-102"
"1910","Wyoming","4","4","0","0.50000","107","74","33"
"1911","Wyoming","4","3","1","0.56250","139","53","86"
"1912","Wyoming","2","7","0","0.22222","64","291","-227"
"1907","Central Michigan","2","4","0","0.33333","18","164","-146"
"1913","Wyoming","0","5","0","0.00000","0","183","-183"
"1914","Wyoming","1","5","0","0.16667","31","158","-127"
"1915","Lake Forest (IL)","2","4","0","0.33333","77","86","-9"
"1898","Holy Cross (MA)","1","0","0","1.00000","23","0","23"
"1915","Wyoming","2","6","0","0.25000","46","213","-167"
"1916","Wyoming","1","4","0","0.20000","50","115","-65"
"1917","Wyoming","3","4","0","0.42857","24","140","-116"
"1919","Wyoming","3","5","0","0.37500","68","115","-47"
"1920","Wyoming","4","5","1","0.45000","58","106","-48"
"1921","Wyoming","1","4","2","0.28571","39","92","-53"
"1922","Wyoming","1","8","0","0.11111","13","256","-243"
"1923","Wyoming","0","8","0","0.00000","16","265","-249"
"1915","Washington St.","7","0","0","1.00000","204","10","194"
"1916","Washington St.","4","2","0","0.66667","136","25","111"
"1917","Washington St.","6","0","1","0.92857","112","3","109"
"1921","Purdue (IN)","1","6","0","0.14286","9","95","-86"
"1922","Louisiana Tech","5","1","1","0.78571","290","26","264"
"1923","Louisiana Tech","6","2","0","0.75000","194","63","131"
"1924","Wyoming","2","6","0","0.25000","59","133","-74"
"1925","Wyoming","6","3","0","0.66667","147","83","64"
"1926","Wyoming","2","4","2","0.37500","152","91","61"
"1919","Emporia St. (KS)","1","6","2","0.22222","60","101","-41"
"1920","Arkansas","3","2","2","0.57143","42","22","20"
"1921","Arkansas","5","3","1","0.61111","144","48","96"
"1922","Cincinnati (OH)","1","7","1","0.16667","35","175","-140"
"1923","Cincinnati (OH)","6","3","0","0.66667","157","71","86"
"1924","Cincinnati (OH)","2","6","1","0.27778","54","164","-110"
"1925","Cincinnati (OH)","4","5","0","0.44444","65","122","-57"
"1926","Cincinnati (OH)","3","5","1","0.38889","96","152","-56"
"1927","Wyoming","4","5","0","0.44444","122","105","17"
"1928","Wyoming","2","7","0","0.22222","106","224","-118"
"1929","Wyoming","1","7","0","0.12500","33","160","-127"
"1930","Wyoming","2","5","1","0.31250","86","161","-75"
"1931","Wyoming","6","4","0","0.60000","168","76","92"
"1932","Wyoming","2","6","1","0.27778","53","137","-84"
"1933","Wyoming","2","6","1","0.27778","54","114","-60"
"1934","Wyoming","3","5","0","0.37500","78","109","-31"
"1935","Wyoming","4","4","0","0.50000","76","59","17"
"1936","Wyoming","2","5","1","0.31250","74","159","-85"
"1937","Wyoming","3","5","0","0.37500","86","92","-6"
"1938","Wyoming","2","5","1","0.31250","66","147","-81"
"1938","Georgia","5","4","1","0.55000","145","143","2"
"1939","Wyoming","0","7","1","0.06250","47","241","-194"
"1940","Wyoming","1","7","1","0.16667","32","190","-158"
"1931","Montana","1","6","0","0.14286","56","155","-99"
"1932","Montana","2","7","0","0.22222","84","224","-140"
"1933","Montana","3","4","0","0.42857","91","85","6"
"1934","Montana","2","5","1","0.31250","90","82","8"
"1935","Colorado","5","4","0","0.55556","140","47","93"
"1936","Colorado","4","3","0","0.57143","99","43","56"
"1937","Colorado","8","1","0","0.88889","262","54","208"
"1938","Colorado","3","4","1","0.43750","78","78","0"
"1939","Colorado","5","3","0","0.62500","106","110","-4"
"1941","Wyoming","2","7","1","0.25000","44","233","-189"
"1942","Wyoming","3","5","0","0.37500","106","115","-9"
"1946","Wyoming","1","8","1","0.15000","44","192","-148"
"1947","Wyoming","4","5","0","0.44444","175","168","7"
"1948","Wyoming","4","5","0","0.44444","270","145","125"
"1949","Wyoming","9","1","0","0.90000","381","65","316"
"1950","Wyoming","10","0","0","1.00000","363","59","304"
"1951","Wyoming","7","2","1","0.75000","220","82","138"
"1952","Wyoming","5","4","0","0.55556","114","102","12"
"1953","Arkansas","3","7","0","0.30000","116","161","-45"
"1954","Arkansas","8","3","0","0.72727","195","104","91"
"1955","Tennessee","6","3","1","0.65000","188","92","96"
"1956","Tennessee","10","1","0","0.90909","275","88","187"
"1957","Tennessee","8","3","0","0.72727","164","75","89"
"1958","Tennessee","4","6","0","0.40000","77","122","-45"
"1959","Tennessee","5","4","1","0.55000","112","118","-6"
"1960","Tennessee","6","2","2","0.70000","209","79","130"
"1961","Tennessee","6","4","0","0.60000","221","149","72"
"1962","Tennessee","4","6","0","0.40000","179","134","45"
"1947","Wofford (SC)","6","5","0","0.54545","142","98","44"
"1948","Wofford (SC)","4","0","5","0.72222","102","45","57"
"1949","Wofford (SC)","11","1","0","0.91667","353","86","267"
"1950","Wofford (SC)","7","2","1","0.75000","212","95","117"
"1951","Wofford (SC)","6","3","1","0.65000","177","140","37"
"1952","Wofford (SC)","6","5","0","0.54545","189","259","-70"
"1953","Wyoming","5","4","1","0.55000","195","110","85"
"1954","Wyoming","6","4","0","0.60000","215","171","44"
"1955","Wyoming","8","3","0","0.72727","225","137","88"
"1956","Wyoming","10","0","0","1.00000","252","112","140"
"1958","Indiana","5","3","1","0.61111","81","141","-60"
"1959","Indiana","4","4","1","0.50000","142","105","37"
"1960","Indiana","1","8","0","0.11111","69","243","-174"
"1961","Indiana","2","7","0","0.22222","96","162","-66"
"1962","Indiana","3","6","0","0.33333","126","140","-14"
"1963","Indiana","3","6","0","0.33333","151","188","-37"
"1964","Indiana","2","7","0","0.22222","154","188","-34"
"1957","Wyoming","4","3","3","0.55000","139","135","4"
"1958","Wyoming","8","3","0","0.72727","205","136","69"
"1959","Wyoming","9","1","0","0.90000","287","62","225"
"1960","Wyoming","8","2","0","0.80000","212","71","141"
"1961","Wyoming","6","1","2","0.77778","171","74","97"
"1962","Nebraska","9","2","0","0.81818","293","161","132"
"1963","Nebraska","10","1","0","0.90909","273","114","159"
"1964","Nebraska","9","2","0","0.81818","256","85","171"
"1965","Nebraska","10","1","0","0.90909","349","129","220"
"1966","Nebraska","9","2","0","0.81818","223","118","105"
"1967","Nebraska","6","4","0","0.60000","127","83","44"
"1968","Nebraska","6","4","0","0.60000","155","161","-6"
"1969","Nebraska","9","2","0","0.81818","254","119","135"
"1970","Nebraska","11","0","1","0.95833","426","189","237"
"1971","Nebraska","13","0","0","1.00000","507","104","403"
"1972","Nebraska","9","2","1","0.79167","501","97","404"
"1949","Alma (MI)","5","2","1","0.68750","138","91","47"
"1950","Alma (MI)","6","2","1","0.72222","122","72","50"
"1951","Alma (MI)","7","2","0","0.77778","248","71","177"
"1952","Alma (MI)","4","4","0","0.50000","123","90","33"
"1953","Alma (MI)","7","2","0","0.77778","170","98","72"
"1954","Alma (MI)","6","4","0","0.60000","227","142","85"
"1955","Alma (MI)","5","4","0","0.55556","187","141","46"
"1962","Wyoming","5","5","0","0.50000","165","143","22"
"1963","Wyoming","6","4","0","0.60000","191","152","39"
"1964","Wyoming","6","2","2","0.70000","181","117","64"
"1965","Wyoming","6","4","0","0.60000","201","182","19"
"1966","Wyoming","10","1","0","0.90909","355","89","266"
"1967","Wyoming","10","1","0","0.90909","289","119","170"
"1968","Wyoming","7","3","0","0.70000","242","118","124"
"1969","Wyoming","6","4","0","0.60000","232","187","45"
"1970","Wyoming","1","9","0","0.10000","110","314","-204"
"1971","Wyoming","5","6","0","0.45455","222","309","-87"
"1972","Wyoming","4","7","0","0.36364","223","309","-86"
"1973","Wyoming","4","7","0","0.36364","248","290","-42"
"1974","Wyoming","2","9","0","0.18182","150","283","-133"
"1975","Wyoming","2","9","0","0.18182","174","219","-45"
"1976","Wyoming","8","4","0","0.66667","278","250","28"
"1977","Texas","11","1","0","0.91667","441","152","289"
"1978","Texas","9","3","0","0.75000","287","136","151"
"1979","Texas","9","3","0","0.75000","221","104","117"
"1980","Texas","7","5","0","0.58333","267","214","53"
"1981","Texas","10","1","1","0.87500","262","158","104"
"1982","Texas","9","3","0","0.75000","357","170","187"
"1983","Texas","11","1","0","0.91667","289","114","175"
"1984","Texas","7","4","1","0.62500","264","261","3"
"1985","Texas","8","4","0","0.66667","270","259","11"
"1986","Texas","5","6","0","0.45455","229","245","-16"
"1987","Purdue (IN)","3","7","1","0.31818","197","285","-88"
"1988","Purdue (IN)","4","7","0","0.36364","124","303","-179"
"1989","Purdue (IN)","3","8","0","0.27273","172","281","-109"
"1990","Purdue (IN)","2","9","0","0.18182","177","337","-160"
"1977","Wyoming","4","6","1","0.40909","166","273","-107"
"1978","Wyoming","5","7","0","0.41667","253","245","8"
"1979","Wyoming","4","8","0","0.33333","186","276","-90"
"1989","East Carolina (NC)","6","5","0","0.54545","301","286","15"
"1990","East Carolina (NC)","5","6","0","0.45455","254","267","-13"
"1991","East Carolina (NC)","11","1","0","0.91667","409","277","132"
"1992","Georgia Tech","5","6","0","0.45455","237","286","-49"
"1993","Georgia Tech","5","6","0","0.45455","260","286","-26"
"1994","Georgia Tech","1","7","0","0.12500","152","231","-79"
"1974","East Carolina (NC)","7","4","0","0.63636","250","167","83"
"1975","East Carolina (NC)","8","3","0","0.72727","296","154","142"
"1976","East Carolina (NC)","9","2","0","0.81818","278","116","162"
"1977","East Carolina (NC)","8","3","0","0.72727","268","154","114"
"1978","East Carolina (NC)","9","3","0","0.75000","287","136","151"
"1979","East Carolina (NC)","7","3","1","0.68182","380","193","187"
"1980","Wyoming","6","5","0","0.54545","316","243","73"
"1981","Auburn (AL)","5","6","0","0.45455","186","166","20"
"1982","Auburn (AL)","9","3","0","0.75000","274","197","77"
"1983","Auburn (AL)","11","1","0","0.91667","311","186","125"
"1984","Auburn (AL)","9","4","0","0.69231","360","254","106"
"1985","Auburn (AL)","8","4","0","0.66667","344","208","136"
"1986","Auburn (AL)","10","2","0","0.83333","395","122","273"
"1987","Auburn (AL)","9","1","2","0.83333","314","132","182"
"1988","Auburn (AL)","10","2","0","0.83333","338","92","246"
"1989","Auburn (AL)","10","2","0","0.83333","284","131","153"
"1990","Auburn (AL)","8","3","1","0.70833","283","216","67"
"1991","Auburn (AL)","5","6","0","0.45455","233","214","19"
"1992","Auburn (AL)","5","5","1","0.50000","228","205","23"
"1981","Wyoming","8","3","0","0.72727","344","203","141"
"1982","Wyoming","5","7","0","0.41667","267","280","-13"
"1983","Wyoming","7","5","0","0.58333","341","327","14"
"1984","Wyoming","6","6","0","0.50000","334","342","-8"
"1985","Wyoming","3","8","0","0.27273","210","371","-161"
"1990","Arkansas St.","3","7","1","0.31818","200","313","-113"
"1991","Arkansas St.","1","10","0","0.09091","189","361","-172"
"1982","Idaho","9","4","0","0.69231","397","299","98"
"1983","Idaho","8","3","0","0.72727","347","257","90"
"1984","Idaho","6","5","0","0.54545","363","283","80"
"1985","Idaho","9","3","0","0.75000","441","247","194"
"1986","Wyoming","6","6","0","0.50000","299","272","27"
"1987","Washington St.","3","7","1","0.31818","238","356","-118"
"1988","Washington St.","9","3","0","0.75000","415","303","112"
"1989","Miami (FL)","11","1","0","0.91667","426","127","299"
"1990","Miami (FL)","10","2","0","0.83333","447","184","263"
"1991","Miami (FL)","12","0","0","1.00000","386","100","286"
"1992","Miami (FL)","11","1","0","0.91667","369","161","208"
"1993","Miami (FL)","9","3","0","0.75000","331","167","164"
"1994","Miami (FL)","10","2","0","0.83333","365","143","222"
"1999","Oregon St.","7","5","0","0.58333","347","277","70"
"2000","Oregon St.","11","1","0","0.91667","400","212","188"
"2001","Oregon St.","5","6","0","0.45455","287","259","28"
"2002","Oregon St.","8","5","0","0.61538","414","267","147"
"2006","Idaho","4","8","0","0.33333","203","417","-214"
"2007","Arizona St.","10","3","0","0.76923","420","292","128"
"2008","Arizona St.","5","7","0","0.41667","274","272","2"
"2009","Arizona St.","4","8","0","0.33333","268","253","15"
"2010","Arizona St.","6","6","0","0.50000","387","300","87"
"2011","Arizona St.","6","7","0","0.46154","431","372","59"
"1987","Wyoming","10","3","0","0.76923","426","271","155"
"1988","Wyoming","11","2","0","0.84615","511","280","231"
"1989","Wyoming","5","6","0","0.45455","281","299","-18"
"1990","Wyoming","9","4","0","0.69231","327","297","30"
"1991","Wyoming","4","6","1","0.40909","305","357","-52"
"1992","Wyoming","5","7","0","0.41667","302","341","-39"
"1993","Wyoming","8","4","0","0.66667","357","329","28"
"1994","Wyoming","6","6","0","0.50000","319","341","-22"
"1995","Wyoming","6","5","0","0.54545","322","264","58"
"1996","Wyoming","10","2","0","0.83333","464","284","180"
"1997","Purdue (IN)","9","3","0","0.75000","396","267","129"
"1998","Purdue (IN)","9","4","0","0.69231","444","276","168"
"1999","Purdue (IN)","7","5","0","0.58333","384","305","79"
"2000","Purdue (IN)","8","4","0","0.66667","381","266","115"
"2001","Purdue (IN)","6","6","0","0.50000","250","278","-28"
"2002","Purdue (IN)","7","6","0","0.53846","386","288","98"
"2003","Purdue (IN)","9","4","0","0.69231","349","226","123"
"2004","Purdue (IN)","7","5","0","0.58333","381","206","175"
"2005","Purdue (IN)","5","6","0","0.45455","330","309","21"
"2006","Purdue (IN)","8","6","0","0.57143","364","374","-10"
"2007","Purdue (IN)","8","5","0","0.61538","446","345","101"
"2008","Purdue (IN)","4","8","0","0.33333","296","301","-5"
"1997","Wyoming","7","6","0","0.53846","322","227","95"
"1998","Wyoming","8","3","0","0.72727","222","215","7"
"1999","Wyoming","7","4","0","0.63636","302","270","32"
"2000","Houston (TX)","3","8","0","0.27273","211","370","-159"
"2001","Houston (TX)","0","11","0","0.00000","190","432","-242"
"2002","Houston (TX)","5","7","0","0.41667","320","393","-73"
"2000","Wyoming","1","10","0","0.09091","170","393","-223"
"2001","Wyoming","2","9","0","0.18182","229","368","-139"
"2002","Wyoming","2","10","0","0.16667","288","432","-144"
"2011","Illinois","1","0","0","1.00000","20","14","6"
"1976","Doane (NE)","5","5","0","0.50000","201","144","57"
"1977","Doane (NE)","5","5","0","0.50000","176","151","25"
"1978","Doane (NE)","6","4","0","0.60000","190","165","25"
"1979","Doane (NE)","5","4","1","0.55000","207","153","54"
"1989","Northern Colorado","6","4","0","0.60000","209","208","1"
"1990","Northern Colorado","8","3","0","0.72727","253","198","55"
"1991","Northern Colorado","8","3","0","0.72727","295","156","139"
"1992","Northern Colorado","6","5","0","0.54545","195","191","4"
"1993","Northern Colorado","8","3","0","0.72727","324","143","181"
"1994","Northern Colorado","7","4","0","0.63636","265","204","61"
"1995","Northern Colorado","9","3","0","0.75000","396","248","148"
"1996","Northern Colorado","12","3","0","0.80000","435","254","181"
"1997","Northern Colorado","13","2","0","0.86667","489","249","240"
"1998","Northern Colorado","11","2","0","0.84615","506","252","254"
"1999","Northern Colorado","11","2","0","0.84615","503","329","174"
"2000","Montana","13","2","0","0.86667","475","288","187"
"2001","Montana","15","1","0","0.93750","533","293","240"
"2002","Montana","11","3","0","0.78571","441","260","181"
"2003","Wyoming","4","8","0","0.33333","286","360","-74"
"2004","Wyoming","7","5","0","0.58333","318","297","21"
"2005","Wyoming","4","7","0","0.36364","271","297","-26"
"2006","Wyoming","6","6","0","0.50000","258","264","-6"
"2007","Wyoming","5","7","0","0.41667","233","311","-78"
"2008","Wyoming","4","8","0","0.33333","152","333","-181"
"2012","South Dakota","1","10","0","0.09091","187","346","-159"
"2013","South Dakota","4","8","0","0.33333","209","309","-100"
"2009","Wyoming","7","6","0","0.53846","238","355","-117"
"2010","Wyoming","3","9","0","0.25000","230","364","-134"
"2011","Wyoming","8","5","0","0.61538","339","361","-22"
"2012","Wyoming","4","7","0","0.36364","308","356","-48"
"2013","Wyoming","5","7","0","0.41667","375","440","-65"
"2012","Wyoming","0","1","0","0.00000","14","45","-31"
